السنة,الربع ,المنطقة ,النشاط الاقتصادي ,عدد المنشآت متناهية الصغر ,عدد المنشآت الصغيرة ,عدد المنشآت المتوسطة ,عدد المنشآت الكبيرة ,عدد المنشآت 
2022,1,مكتب المنطقة الشرقية,أبحاث الإعلان والسوق,124,30,1,0,155
2022,1,مكتب المنطقة الشرقية,إصلاح أجهزة الحاسوب والسلع الشخصية والمنزلية,302,74,9,1,386
2022,1,مكتب المنطقة الشرقية,إصلاح وتركيب الآلات والمعدات,201,72,6,1,280
2022,1,مكتب المنطقة الشرقية,أنشطة أنتاج الأفلام والبرامج التلفزيونية والتسجيلات الصوتية و نشرالموسيقى,30,4,0,0,34
2022,1,مكتب المنطقة الشرقية,أنشطة الأمن والتحقيقات,22,17,11,4,54
2022,1,مكتب المنطقة الشرقية,أنشطة الاستخدام,83,23,2,6,114
2022,1,مكتب المنطقة الشرقية,أنشطة الاسر المعيشية التي تستخدم أفراداً للعمل المنزلي,2,0,0,0,2
2022,1,مكتب المنطقة الشرقية,أنشطة البرمجة الحاسوبية والخبرة الاستشارية وما يتصل بها من أنشطة,147,51,9,2,209
2022,1,مكتب المنطقة الشرقية,أنشطة البرمجة والإذاعة,1,1,0,0,2
2022,1,مكتب المنطقة الشرقية,أنشطة البريد ونقل الرسائل والطرود بواسطة مندوبين,16,3,0,0,19
2022,1,مكتب المنطقة الشرقية,أنشطة التشييد المتخصصة,2474,981,124,15,3594
2022,1,مكتب المنطقة الشرقية,أنشطة الخدمات الشخصية الأخرى,2149,421,28,3,2601
2022,1,مكتب المنطقة الشرقية,أنشطة الخدمات المالية ، فيما عدا تمويل التأمين وصناديق المعاشات,39,15,5,1,60
2022,1,مكتب المنطقة الشرقية,أنشطة العمل الاجتماعي، دون إقامة، لكبار السن وذوي الإعاقة,66,75,3,0,144
2022,1,مكتب المنطقة الشرقية,أنشطة المعالجة وخدمات إدارة النفايات الأخرى,3,1,1,0,5
2022,1,مكتب المنطقة الشرقية,أنشطة المعمارية والهندسية ، والاختبارات الفنية والتحليل,191,165,42,16,414
2022,1,مكتب المنطقة الشرقية,أنشطة المكاتب الرئيسية ، وألأنشطة الاستشارية في مجال الإدارة,152,57,9,1,219
2022,1,مكتب المنطقة الشرقية,أنشطة المكتبات ودور المحفوظات، والمتاحف والأنشطة الثقافية الأخرى,52,25,0,0,77
2022,1,مكتب المنطقة الشرقية,أنشطة المنظمات الدولية,0,1,0,0,1
2022,1,مكتب المنطقة الشرقية,أنشطة المنظمات ذات العضوية,19,4,1,0,24
2022,1,مكتب المنطقة الشرقية,أنشطة النشر,30,11,0,0,41
2022,1,مكتب المنطقة الشرقية,أنشطة تقديم الخدمات للمباني وتجميل المواقع,1415,780,127,39,2361
2022,1,مكتب المنطقة الشرقية,أنشطة جمع النفايات ومعالجتها وتصريفها ، واسترجاع المواد,11,12,1,1,25
2022,1,مكتب المنطقة الشرقية,أنشطة خدمات الأطعمة والمشروبات,3298,1559,182,23,5062
2022,1,مكتب المنطقة الشرقية,أنشطة خدمات المعلومات,50,19,1,0,70
2022,1,مكتب المنطقة الشرقية,أنشطة خدمات دعم التعدين,129,124,64,43,360
2022,1,مكتب المنطقة الشرقية,أنشطة زراعة المحاصيل والإنتاج الحيواني والصيد والخدمات المتصلة,373,64,8,0,445
2022,1,مكتب المنطقة الشرقية,استخراج النفط الخام والغاز الطبيعي,1,1,1,0,3
2022,1,مكتب المنطقة الشرقية,الإدارة العامة والدفاع ؛ والضمان الاجتماعي الإلزامي,188,125,31,4,348
2022,1,مكتب المنطقة الشرقية,الإقامة,157,148,24,1,330
2022,1,مكتب المنطقة الشرقية,الأنشطة الإبداعية والفنون وأنشطة الترفيه,17,1,0,0,18
2022,1,مكتب المنطقة الشرقية,الأنشطة الأخرى للتعدين واستغلال المحاجر,39,25,10,1,75
2022,1,مكتب المنطقة الشرقية,الأنشطة الإدارية للمكاتب ، وأنشطة الدعم للمكاتب وغير ذلك من أنشطة الدعم للأعمال,173,31,2,1,207
2022,1,مكتب المنطقة الشرقية,الأنشطة الإيجارية,622,144,24,6,796
2022,1,مكتب المنطقة الشرقية,الأنشطة البيطرية,6,10,2,0,18
2022,1,مكتب المنطقة الشرقية,الأنشطة الرياضية وأنشطة التسلية والترفيه,152,70,3,1,226
2022,1,مكتب المنطقة الشرقية,الأنشطة العقارية,263,127,12,2,404
2022,1,مكتب المنطقة الشرقية,الأنشطة القانونية وأنشطة المحاسبة,95,41,2,0,138
2022,1,مكتب المنطقة الشرقية,الأنشطة المساعدة لأنشطة الخدمات المالية وأنشطة التأمين,12,12,1,1,26
2022,1,مكتب المنطقة الشرقية,الأنشطة المهنية والعلمية والتقنية الأخرى,85,17,0,0,102
2022,1,مكتب المنطقة الشرقية,الأنشطة غير المتميزة لإنتاج السلع والخدمات التي تقوم بها الأسر المعيشية الخاصة لإستعمالها الخاص,1,1,0,0,2
2022,1,مكتب المنطقة الشرقية,الاتصالات,64,19,0,0,83
2022,1,مكتب المنطقة الشرقية,البحث والتطوير في المجال العلمي,6,3,1,0,10
2022,1,مكتب المنطقة الشرقية,التخزين وأنشطة الدعم للنقل,263,124,30,6,423
2022,1,مكتب المنطقة الشرقية,التعليم,147,169,51,13,380
2022,1,مكتب المنطقة الشرقية,الحراجة وقطع الأخشاب,1,1,0,0,2
2022,1,مكتب المنطقة الشرقية,الرعاية مع الإقامة,9,6,1,0,16
2022,1,مكتب المنطقة الشرقية,الصحة البشرية,85,148,63,24,320
2022,1,مكتب المنطقة الشرقية,الصرف الصحي,9,7,1,1,18
2022,1,مكتب المنطقة الشرقية,الصناعة التحويلية الأخرى,65,36,4,0,105
2022,1,مكتب المنطقة الشرقية,الطباعة واستنساخ وسائط الأعلام المسجّلة,112,76,7,0,195
2022,1,مكتب المنطقة الشرقية,النقل البري و النقل عبر الأنابيب,969,286,66,18,1339
2022,1,مكتب المنطقة الشرقية,النقل الجوي,78,73,37,7,195
2022,1,مكتب المنطقة الشرقية,النقل المائي,28,17,7,0,52
2022,1,مكتب المنطقة الشرقية,الهندسة المدنية,107,48,9,2,166
2022,1,مكتب المنطقة الشرقية,تجارة التجزئة، باستثناء المركبات ذات المحركات والدراجات النارية,5224,1982,217,39,7462
2022,1,مكتب المنطقة الشرقية,تجارة الجملة ، باستثناء المركبات ذات المحركات والدراجات النارية,2507,1408,236,50,4201
2022,1,مكتب المنطقة الشرقية,تجارة الجملة والتجزئة ، وإصلاح المركبات ذات المحركات والدراجات النارية,2131,735,31,6,2903
2022,1,مكتب المنطقة الشرقية,تجميع المياه ومعالجتها وتوصيلها,24,15,1,1,41
2022,1,مكتب المنطقة الشرقية,تشييد المباني,4167,2636,547,205,7555
2022,1,مكتب المنطقة الشرقية,تعدين الفحم والليغنيت,5,0,0,0,5
2022,1,مكتب المنطقة الشرقية,تعدين ركازات الفلزات,84,86,11,2,183
2022,1,مكتب المنطقة الشرقية,تمويل التأمين وإعادة التأمين وصناديق المعاشات التقاعدية باستثناء الضمان الاجتماعي الإلزامي,5,13,3,4,25
2022,1,مكتب المنطقة الشرقية,توصيل الكهرباء والغاز والبخار وتكييف الهواء,32,54,16,4,106
2022,1,مكتب المنطقة الشرقية,صناعة الآلات والمعدات غير المصنفة في موضع أخر,47,36,7,2,92
2022,1,مكتب المنطقة الشرقية,صناعة المركبات ذات المحركات والمركبات المقطورة ونصف المقطورة,19,10,0,0,29
2022,1,مكتب المنطقة الشرقية,صناعة معدات النقل الأخرى,19,13,7,2,41
2022,1,مكتب المنطقة الشرقية,صنع الأثاث,292,113,8,1,414
2022,1,مكتب المنطقة الشرقية,صنع الحواسيب والمنتجات الإلكترونية والبصرية,106,49,12,3,170
2022,1,مكتب المنطقة الشرقية,صُنع الخشب ومنتجات الخشب والفلين ، باستثناء الأثاث ، صُنع أصناف من القش ومواد الضفر,239,164,21,7,431
2022,1,مكتب المنطقة الشرقية,صنع الفلزات القاعدية,113,114,48,9,284
2022,1,مكتب المنطقة الشرقية,صُنع المشروبات,18,13,3,1,35
2022,1,مكتب المنطقة الشرقية,صنع المعدات الكهربائية,172,83,16,2,273
2022,1,مكتب المنطقة الشرقية,صُنع الملبوسات,750,173,7,0,930
2022,1,مكتب المنطقة الشرقية,صُنع المنتجات الجلدية والمنتجات ذات الصلة,4,1,0,0,5
2022,1,مكتب المنطقة الشرقية,صنع المنتجات الصيدلانية الأساسية والمستحضرات الصيدلانية,4,4,2,0,10
2022,1,مكتب المنطقة الشرقية,صُنع المنتجات الغذائية,410,208,53,9,680
2022,1,مكتب المنطقة الشرقية,صُنع المنسوجات,136,85,9,0,230
2022,1,مكتب المنطقة الشرقية,صُنع المواد الكيميائية والمنتجات الكيميائية,108,72,18,1,199
2022,1,مكتب المنطقة الشرقية,صُنع الورق ومنتجات الورق,23,16,10,0,49
2022,1,مكتب المنطقة الشرقية,صنع فحم الكوك والمنتجات النفطية المكررة,12,16,3,2,33
2022,1,مكتب المنطقة الشرقية,صُنع منتجات التبغ,2,1,0,0,3
2022,1,مكتب المنطقة الشرقية,صنع منتجات المطاط واللدائن,47,81,63,10,201
2022,1,مكتب المنطقة الشرقية,صنع منتجات المعادن اللافلزية الأخرى,150,100,32,7,289
2022,1,مكتب المنطقة الشرقية,صنع منتجات المعادن المشكلة ( باستثناء الآلات والمعدات ),341,242,70,20,673
2022,1,مكتب المنطقة الشرقية,صيد الأسماك وتربية المائيات,224,175,5,0,404
2022,1,مكتب المنطقة الشرقية,وكالات السفر ومشغّلو الجولات السياحية وخدمات الحجز والأنشطة المتصلة بها,74,34,6,0,114
2022,1,مكتب محافظة الأحساء,أبحاث الإعلان والسوق,19,3,0,0,22
2022,1,مكتب محافظة الأحساء,إصلاح أجهزة الحاسوب والسلع الشخصية والمنزلية,124,20,2,0,146
2022,1,مكتب محافظة الأحساء,إصلاح وتركيب الآلات والمعدات,55,4,0,0,59
2022,1,مكتب محافظة الأحساء,أنشطة أنتاج الأفلام والبرامج التلفزيونية والتسجيلات الصوتية و نشرالموسيقى,7,0,0,0,7
2022,1,مكتب محافظة الأحساء,أنشطة الأمن والتحقيقات,2,1,2,0,5
2022,1,مكتب محافظة الأحساء,أنشطة الاستخدام,25,5,0,0,30
2022,1,مكتب محافظة الأحساء,أنشطة الاسر المعيشية التي تستخدم أفراداً للعمل المنزلي,1,0,0,0,1
2022,1,مكتب محافظة الأحساء,أنشطة البرمجة الحاسوبية والخبرة الاستشارية وما يتصل بها من أنشطة,10,3,0,0,13
2022,1,مكتب محافظة الأحساء,أنشطة البرمجة والإذاعة,1,0,0,0,1
2022,1,مكتب محافظة الأحساء,أنشطة البريد ونقل الرسائل والطرود بواسطة مندوبين,1,2,0,0,3
2022,1,مكتب محافظة الأحساء,أنشطة التشييد المتخصصة,870,220,10,2,1102
2022,1,مكتب محافظة الأحساء,أنشطة الخدمات الشخصية الأخرى,921,129,3,1,1054
2022,1,مكتب محافظة الأحساء,أنشطة الخدمات المالية ، فيما عدا تمويل التأمين وصناديق المعاشات,21,2,1,0,24
2022,1,مكتب محافظة الأحساء,أنشطة العمل الاجتماعي، دون إقامة، لكبار السن وذوي الإعاقة,20,23,2,0,45
2022,1,مكتب محافظة الأحساء,أنشطة المعالجة وخدمات إدارة النفايات الأخرى,0,1,0,0,1
2022,1,مكتب محافظة الأحساء,أنشطة المعمارية والهندسية ، والاختبارات الفنية والتحليل,30,30,4,0,64
2022,1,مكتب محافظة الأحساء,أنشطة المكاتب الرئيسية ، وألأنشطة الاستشارية في مجال الإدارة,25,4,0,0,29
2022,1,مكتب محافظة الأحساء,أنشطة المكتبات ودور المحفوظات، والمتاحف والأنشطة الثقافية الأخرى,32,9,0,0,41
2022,1,مكتب محافظة الأحساء,أنشطة المنظمات ذات العضوية,6,2,1,0,9
2022,1,مكتب محافظة الأحساء,أنشطة النشر,2,1,0,0,3
2022,1,مكتب محافظة الأحساء,أنشطة تقديم الخدمات للمباني وتجميل المواقع,182,53,4,0,239
2022,1,مكتب محافظة الأحساء,أنشطة جمع النفايات ومعالجتها وتصريفها ، واسترجاع المواد,2,2,0,0,4
2022,1,مكتب محافظة الأحساء,أنشطة خدمات الأطعمة والمشروبات,1231,564,34,2,1831
2022,1,مكتب محافظة الأحساء,أنشطة خدمات المعلومات,8,2,0,0,10
2022,1,مكتب محافظة الأحساء,أنشطة خدمات دعم التعدين,7,14,0,0,21
2022,1,مكتب محافظة الأحساء,أنشطة زراعة المحاصيل والإنتاج الحيواني والصيد والخدمات المتصلة,269,50,7,0,326
2022,1,مكتب محافظة الأحساء,الإدارة العامة والدفاع ؛ والضمان الاجتماعي الإلزامي,25,14,1,0,40
2022,1,مكتب محافظة الأحساء,الإقامة,47,26,4,0,77
2022,1,مكتب محافظة الأحساء,الأنشطة الإبداعية والفنون وأنشطة الترفيه,5,1,0,0,6
2022,1,مكتب محافظة الأحساء,الأنشطة الأخرى للتعدين واستغلال المحاجر,18,3,0,0,21
2022,1,مكتب محافظة الأحساء,الأنشطة الإدارية للمكاتب ، وأنشطة الدعم للمكاتب وغير ذلك من أنشطة الدعم للأعمال,32,8,0,0,40
2022,1,مكتب محافظة الأحساء,الأنشطة الإيجارية,305,43,5,2,355
2022,1,مكتب محافظة الأحساء,الأنشطة البيطرية,5,1,0,0,6
2022,1,مكتب محافظة الأحساء,الأنشطة الرياضية وأنشطة التسلية والترفيه,33,15,1,0,49
2022,1,مكتب محافظة الأحساء,الأنشطة العقارية,37,9,1,0,47
2022,1,مكتب محافظة الأحساء,الأنشطة القانونية وأنشطة المحاسبة,14,1,1,0,16
2022,1,مكتب محافظة الأحساء,الأنشطة المساعدة لأنشطة الخدمات المالية وأنشطة التأمين,2,0,0,0,2
2022,1,مكتب محافظة الأحساء,الأنشطة المهنية والعلمية والتقنية الأخرى,34,1,0,0,35
2022,1,مكتب محافظة الأحساء,الاتصالات,18,6,0,0,24
2022,1,مكتب محافظة الأحساء,التخزين وأنشطة الدعم للنقل,63,14,0,1,78
2022,1,مكتب محافظة الأحساء,التعليم,40,28,12,0,80
2022,1,مكتب محافظة الأحساء,الرعاية مع الإقامة,3,0,1,0,4
2022,1,مكتب محافظة الأحساء,الصحة البشرية,30,60,14,6,110
2022,1,مكتب محافظة الأحساء,الصرف الصحي,2,0,0,0,2
2022,1,مكتب محافظة الأحساء,الصناعة التحويلية الأخرى,20,5,0,0,25
2022,1,مكتب محافظة الأحساء,الطباعة واستنساخ وسائط الأعلام المسجّلة,34,9,1,0,44
2022,1,مكتب محافظة الأحساء,النقل البري و النقل عبر الأنابيب,230,44,5,2,281
2022,1,مكتب محافظة الأحساء,النقل الجوي,10,4,1,0,15
2022,1,مكتب محافظة الأحساء,النقل المائي,3,0,0,0,3
2022,1,مكتب محافظة الأحساء,الهندسة المدنية,18,4,0,0,22
2022,1,مكتب محافظة الأحساء,تجارة التجزئة، باستثناء المركبات ذات المحركات والدراجات النارية,1876,479,36,3,2394
2022,1,مكتب محافظة الأحساء,تجارة الجملة ، باستثناء المركبات ذات المحركات والدراجات النارية,532,150,10,4,696
2022,1,مكتب محافظة الأحساء,تجارة الجملة والتجزئة ، وإصلاح المركبات ذات المحركات والدراجات النارية,759,190,6,0,955
2022,1,مكتب محافظة الأحساء,تجميع المياه ومعالجتها وتوصيلها,9,7,0,0,16
2022,1,مكتب محافظة الأحساء,تشييد المباني,1566,665,62,16,2309
2022,1,مكتب محافظة الأحساء,تعدين الفحم والليغنيت,2,1,0,0,3
2022,1,مكتب محافظة الأحساء,تعدين ركازات الفلزات,26,9,1,1,37
2022,1,مكتب محافظة الأحساء,تمويل التأمين وإعادة التأمين وصناديق المعاشات التقاعدية باستثناء الضمان الاجتماعي الإلزامي,0,1,0,0,1
2022,1,مكتب محافظة الأحساء,توصيل الكهرباء والغاز والبخار وتكييف الهواء,9,4,0,0,13
2022,1,مكتب محافظة الأحساء,صناعة الآلات والمعدات غير المصنفة في موضع أخر,15,6,1,0,22
2022,1,مكتب محافظة الأحساء,صناعة المركبات ذات المحركات والمركبات المقطورة ونصف المقطورة,8,1,0,0,9
2022,1,مكتب محافظة الأحساء,صناعة معدات النقل الأخرى,14,1,0,0,15
2022,1,مكتب محافظة الأحساء,صنع الأثاث,138,48,1,0,187
2022,1,مكتب محافظة الأحساء,صنع الحواسيب والمنتجات الإلكترونية والبصرية,90,21,1,0,112
2022,1,مكتب محافظة الأحساء,صُنع الخشب ومنتجات الخشب والفلين ، باستثناء الأثاث ، صُنع أصناف من القش ومواد الضفر,55,20,1,1,77
2022,1,مكتب محافظة الأحساء,صنع الفلزات القاعدية,53,16,0,0,69
2022,1,مكتب محافظة الأحساء,صُنع المشروبات,7,9,0,0,16
2022,1,مكتب محافظة الأحساء,صنع المعدات الكهربائية,47,24,1,0,72
2022,1,مكتب محافظة الأحساء,صُنع الملبوسات,500,70,2,0,572
2022,1,مكتب محافظة الأحساء,صُنع المنتجات الجلدية والمنتجات ذات الصلة,6,1,0,0,7
2022,1,مكتب محافظة الأحساء,صنع المنتجات الصيدلانية الأساسية والمستحضرات الصيدلانية,1,3,0,0,4
2022,1,مكتب محافظة الأحساء,صُنع المنتجات الغذائية,236,80,16,4,336
2022,1,مكتب محافظة الأحساء,صُنع المنسوجات,36,8,1,0,45
2022,1,مكتب محافظة الأحساء,صُنع المواد الكيميائية والمنتجات الكيميائية,28,7,3,0,38
2022,1,مكتب محافظة الأحساء,صُنع الورق ومنتجات الورق,2,2,0,1,5
2022,1,مكتب محافظة الأحساء,صنع فحم الكوك والمنتجات النفطية المكررة,1,0,1,0,2
2022,1,مكتب محافظة الأحساء,صُنع منتجات التبغ,3,1,0,0,4
2022,1,مكتب محافظة الأحساء,صنع منتجات المطاط واللدائن,7,6,4,1,18
2022,1,مكتب محافظة الأحساء,صنع منتجات المعادن اللافلزية الأخرى,54,38,11,0,103
2022,1,مكتب محافظة الأحساء,صنع منتجات المعادن المشكلة ( باستثناء الآلات والمعدات ),99,55,6,1,161
2022,1,مكتب محافظة الأحساء,صيد الأسماك وتربية المائيات,9,4,1,0,14
2022,1,مكتب محافظة الأحساء,وكالات السفر ومشغّلو الجولات السياحية وخدمات الحجز والأنشطة المتصلة بها,19,4,0,0,23
2022,1,مكتب محافظة الجبيل,أبحاث الإعلان والسوق,21,5,0,0,26
2022,1,مكتب محافظة الجبيل,إصلاح أجهزة الحاسوب والسلع الشخصية والمنزلية,45,15,3,0,63
2022,1,مكتب محافظة الجبيل,إصلاح وتركيب الآلات والمعدات,43,27,5,0,75
2022,1,مكتب محافظة الجبيل,أنشطة أنتاج الأفلام والبرامج التلفزيونية والتسجيلات الصوتية و نشرالموسيقى,1,0,0,0,1
2022,1,مكتب محافظة الجبيل,أنشطة الأمن والتحقيقات,6,0,2,0,8
2022,1,مكتب محافظة الجبيل,أنشطة الاستخدام,9,1,0,1,11
2022,1,مكتب محافظة الجبيل,أنشطة الاسر المعيشية التي تستخدم أفراداً للعمل المنزلي,1,0,0,0,1
2022,1,مكتب محافظة الجبيل,أنشطة البرمجة الحاسوبية والخبرة الاستشارية وما يتصل بها من أنشطة,8,6,0,0,14
2022,1,مكتب محافظة الجبيل,أنشطة البريد ونقل الرسائل والطرود بواسطة مندوبين,2,0,0,0,2
2022,1,مكتب محافظة الجبيل,أنشطة التشييد المتخصصة,727,305,34,19,1085
2022,1,مكتب محافظة الجبيل,أنشطة الخدمات الشخصية الأخرى,466,91,6,0,563
2022,1,مكتب محافظة الجبيل,أنشطة الخدمات المالية ، فيما عدا تمويل التأمين وصناديق المعاشات,8,2,1,0,11
2022,1,مكتب محافظة الجبيل,أنشطة العمل الاجتماعي، دون إقامة، لكبار السن وذوي الإعاقة,8,7,1,0,16
2022,1,مكتب محافظة الجبيل,أنشطة المعالجة وخدمات إدارة النفايات الأخرى,1,2,0,0,3
2022,1,مكتب محافظة الجبيل,أنشطة المعمارية والهندسية ، والاختبارات الفنية والتحليل,41,15,1,3,60
2022,1,مكتب محافظة الجبيل,أنشطة المكاتب الرئيسية ، وألأنشطة الاستشارية في مجال الإدارة,17,4,0,0,21
2022,1,مكتب محافظة الجبيل,أنشطة المكتبات ودور المحفوظات، والمتاحف والأنشطة الثقافية الأخرى,12,2,1,0,15
2022,1,مكتب محافظة الجبيل,أنشطة المنظمات الدولية,1,0,0,0,1
2022,1,مكتب محافظة الجبيل,أنشطة المنظمات ذات العضوية,1,4,1,0,6
2022,1,مكتب محافظة الجبيل,أنشطة النشر,30,3,1,0,34
2022,1,مكتب محافظة الجبيل,أنشطة تقديم الخدمات للمباني وتجميل المواقع,248,123,28,5,404
2022,1,مكتب محافظة الجبيل,أنشطة جمع النفايات ومعالجتها وتصريفها ، واسترجاع المواد,2,1,1,1,5
2022,1,مكتب محافظة الجبيل,أنشطة خدمات الأطعمة والمشروبات,840,328,19,2,1189
2022,1,مكتب محافظة الجبيل,أنشطة خدمات المعلومات,4,2,0,0,6
2022,1,مكتب محافظة الجبيل,أنشطة خدمات دعم التعدين,24,20,11,11,66
2022,1,مكتب محافظة الجبيل,أنشطة زراعة المحاصيل والإنتاج الحيواني والصيد والخدمات المتصلة,253,26,2,0,281
2022,1,مكتب محافظة الجبيل,الإدارة العامة والدفاع ؛ والضمان الاجتماعي الإلزامي,15,6,3,0,24
2022,1,مكتب محافظة الجبيل,الإقامة,41,25,6,0,72
2022,1,مكتب محافظة الجبيل,الأنشطة الأخرى للتعدين واستغلال المحاجر,4,5,3,2,14
2022,1,مكتب محافظة الجبيل,الأنشطة الإدارية للمكاتب ، وأنشطة الدعم للمكاتب وغير ذلك من أنشطة الدعم للأعمال,24,2,0,0,26
2022,1,مكتب محافظة الجبيل,الأنشطة الإيجارية,380,41,5,0,426
2022,1,مكتب محافظة الجبيل,الأنشطة البيطرية,5,0,0,0,5
2022,1,مكتب محافظة الجبيل,الأنشطة الرياضية وأنشطة التسلية والترفيه,28,7,0,0,35
2022,1,مكتب محافظة الجبيل,الأنشطة العقارية,32,9,0,0,41
2022,1,مكتب محافظة الجبيل,الأنشطة القانونية وأنشطة المحاسبة,6,3,0,0,9
2022,1,مكتب محافظة الجبيل,الأنشطة المساعدة لأنشطة الخدمات المالية وأنشطة التأمين,2,0,0,0,2
2022,1,مكتب محافظة الجبيل,الأنشطة المهنية والعلمية والتقنية الأخرى,19,3,0,0,22
2022,1,مكتب محافظة الجبيل,الاتصالات,21,4,0,0,25
2022,1,مكتب محافظة الجبيل,البحث والتطوير في المجال العلمي,1,1,0,0,2
2022,1,مكتب محافظة الجبيل,التخزين وأنشطة الدعم للنقل,58,16,4,0,78
2022,1,مكتب محافظة الجبيل,التعليم,30,14,13,0,57
2022,1,مكتب محافظة الجبيل,الحراجة وقطع الأخشاب,2,0,0,0,2
2022,1,مكتب محافظة الجبيل,الرعاية مع الإقامة,2,3,0,0,5
2022,1,مكتب محافظة الجبيل,الصحة البشرية,18,17,14,6,55
2022,1,مكتب محافظة الجبيل,الصرف الصحي,3,2,1,1,7
2022,1,مكتب محافظة الجبيل,الصناعة التحويلية الأخرى,7,5,0,0,12
2022,1,مكتب محافظة الجبيل,الطباعة واستنساخ وسائط الأعلام المسجّلة,16,9,1,0,26
2022,1,مكتب محافظة الجبيل,النقل البري و النقل عبر الأنابيب,229,63,4,0,296
2022,1,مكتب محافظة الجبيل,النقل الجوي,10,7,0,2,19
2022,1,مكتب محافظة الجبيل,النقل المائي,7,1,0,0,8
2022,1,مكتب محافظة الجبيل,الهندسة المدنية,27,19,2,0,48
2022,1,مكتب محافظة الجبيل,تجارة التجزئة، باستثناء المركبات ذات المحركات والدراجات النارية,1061,251,20,2,1334
2022,1,مكتب محافظة الجبيل,تجارة الجملة ، باستثناء المركبات ذات المحركات والدراجات النارية,527,184,21,7,739
2022,1,مكتب محافظة الجبيل,تجارة الجملة والتجزئة ، وإصلاح المركبات ذات المحركات والدراجات النارية,566,115,6,0,687
2022,1,مكتب محافظة الجبيل,تجميع المياه ومعالجتها وتوصيلها,3,6,0,0,9
2022,1,مكتب محافظة الجبيل,تشييد المباني,1220,684,142,41,2087
2022,1,مكتب محافظة الجبيل,تعدين الفحم والليغنيت,0,2,0,0,2
2022,1,مكتب محافظة الجبيل,تعدين ركازات الفلزات,48,12,2,1,63
2022,1,مكتب محافظة الجبيل,تمويل التأمين وإعادة التأمين وصناديق المعاشات التقاعدية باستثناء الضمان الاجتماعي الإلزامي,0,1,0,0,1
2022,1,مكتب محافظة الجبيل,توصيل الكهرباء والغاز والبخار وتكييف الهواء,13,10,3,1,27
2022,1,مكتب محافظة الجبيل,صناعة الآلات والمعدات غير المصنفة في موضع أخر,15,14,4,0,33
2022,1,مكتب محافظة الجبيل,صناعة المركبات ذات المحركات والمركبات المقطورة ونصف المقطورة,10,2,0,0,12
2022,1,مكتب محافظة الجبيل,صناعة معدات النقل الأخرى,14,5,1,0,20
2022,1,مكتب محافظة الجبيل,صنع الأثاث,36,6,0,0,42
2022,1,مكتب محافظة الجبيل,صنع الحواسيب والمنتجات الإلكترونية والبصرية,27,7,4,2,40
2022,1,مكتب محافظة الجبيل,صُنع الخشب ومنتجات الخشب والفلين ، باستثناء الأثاث ، صُنع أصناف من القش ومواد الضفر,69,13,4,0,86
2022,1,مكتب محافظة الجبيل,صنع الفلزات القاعدية,68,25,13,5,111
2022,1,مكتب محافظة الجبيل,صُنع المشروبات,3,2,0,0,5
2022,1,مكتب محافظة الجبيل,صنع المعدات الكهربائية,61,20,4,1,86
2022,1,مكتب محافظة الجبيل,صُنع الملبوسات,169,24,1,0,194
2022,1,مكتب محافظة الجبيل,صُنع المنتجات الجلدية والمنتجات ذات الصلة,0,1,0,0,1
2022,1,مكتب محافظة الجبيل,صنع المنتجات الصيدلانية الأساسية والمستحضرات الصيدلانية,1,0,0,0,1
2022,1,مكتب محافظة الجبيل,صُنع المنتجات الغذائية,121,40,3,1,165
2022,1,مكتب محافظة الجبيل,صُنع المنسوجات,43,14,1,0,58
2022,1,مكتب محافظة الجبيل,صُنع المواد الكيميائية والمنتجات الكيميائية,25,18,19,3,65
2022,1,مكتب محافظة الجبيل,صُنع الورق ومنتجات الورق,1,0,0,0,1
2022,1,مكتب محافظة الجبيل,صنع فحم الكوك والمنتجات النفطية المكررة,2,4,0,1,7
2022,1,مكتب محافظة الجبيل,صُنع منتجات التبغ,2,0,0,0,2
2022,1,مكتب محافظة الجبيل,صنع منتجات المطاط واللدائن,12,23,10,10,55
2022,1,مكتب محافظة الجبيل,صنع منتجات المعادن اللافلزية الأخرى,47,26,10,2,85
2022,1,مكتب محافظة الجبيل,صنع منتجات المعادن المشكلة ( باستثناء الآلات والمعدات ),145,46,21,6,218
2022,1,مكتب محافظة الجبيل,صيد الأسماك وتربية المائيات,66,88,1,0,155
2022,1,مكتب محافظة الجبيل,وكالات السفر ومشغّلو الجولات السياحية وخدمات الحجز والأنشطة المتصلة بها,5,3,0,0,8
2022,1,مكتب محافظة الخرج,أبحاث الإعلان والسوق,14,4,0,0,18
2022,1,مكتب محافظة الخرج,إصلاح أجهزة الحاسوب والسلع الشخصية والمنزلية,86,11,0,0,97
2022,1,مكتب محافظة الخرج,إصلاح وتركيب الآلات والمعدات,35,2,1,0,38
2022,1,مكتب محافظة الخرج,أنشطة أنتاج الأفلام والبرامج التلفزيونية والتسجيلات الصوتية و نشرالموسيقى,2,0,0,0,2
2022,1,مكتب محافظة الخرج,أنشطة الأمن والتحقيقات,2,1,0,0,3
2022,1,مكتب محافظة الخرج,أنشطة الاستخدام,17,5,0,1,23
2022,1,مكتب محافظة الخرج,أنشطة البرمجة الحاسوبية والخبرة الاستشارية وما يتصل بها من أنشطة,3,2,0,0,5
2022,1,مكتب محافظة الخرج,أنشطة البرمجة والإذاعة,2,0,0,0,2
2022,1,مكتب محافظة الخرج,أنشطة البريد ونقل الرسائل والطرود بواسطة مندوبين,2,0,0,0,2
2022,1,مكتب محافظة الخرج,أنشطة التشييد المتخصصة,1019,199,9,1,1228
2022,1,مكتب محافظة الخرج,أنشطة الخدمات الشخصية الأخرى,598,57,1,0,656
2022,1,مكتب محافظة الخرج,أنشطة الخدمات المالية ، فيما عدا تمويل التأمين وصناديق المعاشات,27,8,0,0,35
2022,1,مكتب محافظة الخرج,أنشطة العمل الاجتماعي، دون إقامة، لكبار السن وذوي الإعاقة,17,17,0,0,34
2022,1,مكتب محافظة الخرج,أنشطة المعمارية والهندسية ، والاختبارات الفنية والتحليل,26,8,2,1,37
2022,1,مكتب محافظة الخرج,أنشطة المكاتب الرئيسية ، وألأنشطة الاستشارية في مجال الإدارة,20,1,0,0,21
2022,1,مكتب محافظة الخرج,أنشطة المكتبات ودور المحفوظات، والمتاحف والأنشطة الثقافية الأخرى,23,1,0,0,24
2022,1,مكتب محافظة الخرج,أنشطة المنظمات ذات العضوية,13,3,0,0,16
2022,1,مكتب محافظة الخرج,أنشطة النشر,10,3,0,0,13
2022,1,مكتب محافظة الخرج,أنشطة تقديم الخدمات للمباني وتجميل المواقع,209,53,7,0,269
2022,1,مكتب محافظة الخرج,أنشطة جمع النفايات ومعالجتها وتصريفها ، واسترجاع المواد,1,1,1,0,3
2022,1,مكتب محافظة الخرج,أنشطة خدمات الأطعمة والمشروبات,1007,249,11,0,1267
2022,1,مكتب محافظة الخرج,أنشطة خدمات المعلومات,10,0,0,0,10
2022,1,مكتب محافظة الخرج,أنشطة خدمات دعم التعدين,10,3,0,0,13
2022,1,مكتب محافظة الخرج,أنشطة زراعة المحاصيل والإنتاج الحيواني والصيد والخدمات المتصلة,1255,108,15,1,1379
2022,1,مكتب محافظة الخرج,الإدارة العامة والدفاع ؛ والضمان الاجتماعي الإلزامي,13,10,0,0,23
2022,1,مكتب محافظة الخرج,الإقامة,52,12,0,0,64
2022,1,مكتب محافظة الخرج,الأنشطة الإبداعية والفنون وأنشطة الترفيه,5,0,1,0,6
2022,1,مكتب محافظة الخرج,الأنشطة الأخرى للتعدين واستغلال المحاجر,14,3,0,0,17
2022,1,مكتب محافظة الخرج,الأنشطة الإدارية للمكاتب ، وأنشطة الدعم للمكاتب وغير ذلك من أنشطة الدعم للأعمال,39,6,0,0,45
2022,1,مكتب محافظة الخرج,الأنشطة الإيجارية,606,31,1,0,638
2022,1,مكتب محافظة الخرج,الأنشطة البيطرية,9,3,0,0,12
2022,1,مكتب محافظة الخرج,الأنشطة الرياضية وأنشطة التسلية والترفيه,31,12,0,0,43
2022,1,مكتب محافظة الخرج,الأنشطة العقارية,86,19,0,1,106
2022,1,مكتب محافظة الخرج,الأنشطة القانونية وأنشطة المحاسبة,5,0,0,0,5
2022,1,مكتب محافظة الخرج,الأنشطة المساعدة لأنشطة الخدمات المالية وأنشطة التأمين,2,0,0,0,2
2022,1,مكتب محافظة الخرج,الأنشطة المهنية والعلمية والتقنية الأخرى,11,1,0,0,12
2022,1,مكتب محافظة الخرج,الاتصالات,14,2,1,0,17
2022,1,مكتب محافظة الخرج,التخزين وأنشطة الدعم للنقل,76,9,0,0,85
2022,1,مكتب محافظة الخرج,التعليم,28,11,7,0,46
2022,1,مكتب محافظة الخرج,الحراجة وقطع الأخشاب,2,0,0,0,2
2022,1,مكتب محافظة الخرج,الرعاية مع الإقامة,1,2,0,0,3
2022,1,مكتب محافظة الخرج,الصحة البشرية,16,23,8,2,49
2022,1,مكتب محافظة الخرج,الصرف الصحي,0,1,0,0,1
2022,1,مكتب محافظة الخرج,الصناعة التحويلية الأخرى,9,7,1,0,17
2022,1,مكتب محافظة الخرج,الطباعة واستنساخ وسائط الأعلام المسجّلة,16,4,0,0,20
2022,1,مكتب محافظة الخرج,النقل البري و النقل عبر الأنابيب,909,106,5,1,1021
2022,1,مكتب محافظة الخرج,النقل الجوي,16,5,0,0,21
2022,1,مكتب محافظة الخرج,النقل المائي,12,0,0,0,12
2022,1,مكتب محافظة الخرج,الهندسة المدنية,8,7,1,1,17
2022,1,مكتب محافظة الخرج,تجارة التجزئة، باستثناء المركبات ذات المحركات والدراجات النارية,1567,283,17,1,1868
2022,1,مكتب محافظة الخرج,تجارة الجملة ، باستثناء المركبات ذات المحركات والدراجات النارية,741,220,16,0,977
2022,1,مكتب محافظة الخرج,تجارة الجملة والتجزئة ، وإصلاح المركبات ذات المحركات والدراجات النارية,781,127,3,0,911
2022,1,مكتب محافظة الخرج,تجميع المياه ومعالجتها وتوصيلها,10,0,0,1,11
2022,1,مكتب محافظة الخرج,تشييد المباني,1652,476,40,5,2173
2022,1,مكتب محافظة الخرج,تعدين ركازات الفلزات,14,1,0,0,15
2022,1,مكتب محافظة الخرج,توصيل الكهرباء والغاز والبخار وتكييف الهواء,7,5,1,0,13
2022,1,مكتب محافظة الخرج,صناعة الآلات والمعدات غير المصنفة في موضع أخر,18,8,1,0,27
2022,1,مكتب محافظة الخرج,صناعة المركبات ذات المحركات والمركبات المقطورة ونصف المقطورة,21,5,0,0,26
2022,1,مكتب محافظة الخرج,صناعة معدات النقل الأخرى,7,3,1,0,11
2022,1,مكتب محافظة الخرج,صنع الأثاث,58,18,1,1,78
2022,1,مكتب محافظة الخرج,صنع الحواسيب والمنتجات الإلكترونية والبصرية,34,4,0,0,38
2022,1,مكتب محافظة الخرج,صُنع الخشب ومنتجات الخشب والفلين ، باستثناء الأثاث ، صُنع أصناف من القش ومواد الضفر,70,18,1,0,89
2022,1,مكتب محافظة الخرج,صنع الفلزات القاعدية,105,28,3,0,136
2022,1,مكتب محافظة الخرج,صُنع المشروبات,8,5,6,6,25
2022,1,مكتب محافظة الخرج,صنع المعدات الكهربائية,43,13,1,0,57
2022,1,مكتب محافظة الخرج,صُنع الملبوسات,330,36,1,0,367
2022,1,مكتب محافظة الخرج,صُنع المنتجات الجلدية والمنتجات ذات الصلة,4,1,0,0,5
2022,1,مكتب محافظة الخرج,صنع المنتجات الصيدلانية الأساسية والمستحضرات الصيدلانية,3,5,0,0,8
2022,1,مكتب محافظة الخرج,صُنع المنتجات الغذائية,162,59,9,0,230
2022,1,مكتب محافظة الخرج,صُنع المنسوجات,27,9,1,0,37
2022,1,مكتب محافظة الخرج,صُنع المواد الكيميائية والمنتجات الكيميائية,50,17,3,0,70
2022,1,مكتب محافظة الخرج,صُنع الورق ومنتجات الورق,6,3,5,0,14
2022,1,مكتب محافظة الخرج,صنع فحم الكوك والمنتجات النفطية المكررة,0,1,0,0,1
2022,1,مكتب محافظة الخرج,صُنع منتجات التبغ,0,1,0,0,1
2022,1,مكتب محافظة الخرج,صنع منتجات المطاط واللدائن,19,15,5,1,40
2022,1,مكتب محافظة الخرج,صنع منتجات المعادن اللافلزية الأخرى,48,36,11,0,95
2022,1,مكتب محافظة الخرج,صنع منتجات المعادن المشكلة ( باستثناء الآلات والمعدات ),110,27,4,1,142
2022,1,مكتب محافظة الخرج,صيد الأسماك وتربية المائيات,5,0,0,0,5
2022,1,مكتب محافظة الخرج,وكالات السفر ومشغّلو الجولات السياحية وخدمات الحجز والأنشطة المتصلة بها,5,1,0,0,6
2022,1,مكتب محافظة الدوادمي,أبحاث الإعلان والسوق,4,0,0,0,4
2022,1,مكتب محافظة الدوادمي,إصلاح أجهزة الحاسوب والسلع الشخصية والمنزلية,35,10,0,0,45
2022,1,مكتب محافظة الدوادمي,إصلاح وتركيب الآلات والمعدات,13,3,0,0,16
2022,1,مكتب محافظة الدوادمي,أنشطة أنتاج الأفلام والبرامج التلفزيونية والتسجيلات الصوتية و نشرالموسيقى,2,0,0,0,2
2022,1,مكتب محافظة الدوادمي,أنشطة الأمن والتحقيقات,1,0,0,0,1
2022,1,مكتب محافظة الدوادمي,أنشطة الاستخدام,8,0,0,0,8
2022,1,مكتب محافظة الدوادمي,أنشطة الاسر المعيشية التي تستخدم أفراداً للعمل المنزلي,3,0,0,0,3
2022,1,مكتب محافظة الدوادمي,أنشطة البرمجة الحاسوبية والخبرة الاستشارية وما يتصل بها من أنشطة,4,0,0,0,4
2022,1,مكتب محافظة الدوادمي,أنشطة البرمجة والإذاعة,1,1,0,0,2
2022,1,مكتب محافظة الدوادمي,أنشطة البريد ونقل الرسائل والطرود بواسطة مندوبين,1,3,0,0,4
2022,1,مكتب محافظة الدوادمي,أنشطة التشييد المتخصصة,705,118,6,2,831
2022,1,مكتب محافظة الدوادمي,أنشطة الخدمات الشخصية الأخرى,353,32,2,0,387
2022,1,مكتب محافظة الدوادمي,أنشطة الخدمات المالية ، فيما عدا تمويل التأمين وصناديق المعاشات,20,1,0,0,21
2022,1,مكتب محافظة الدوادمي,أنشطة العمل الاجتماعي، دون إقامة، لكبار السن وذوي الإعاقة,14,1,1,0,16
2022,1,مكتب محافظة الدوادمي,أنشطة المعمارية والهندسية ، والاختبارات الفنية والتحليل,22,6,0,0,28
2022,1,مكتب محافظة الدوادمي,أنشطة المكاتب الرئيسية ، وألأنشطة الاستشارية في مجال الإدارة,8,0,0,0,8
2022,1,مكتب محافظة الدوادمي,أنشطة المكتبات ودور المحفوظات، والمتاحف والأنشطة الثقافية الأخرى,6,1,0,0,7
2022,1,مكتب محافظة الدوادمي,أنشطة المنظمات ذات العضوية,4,0,0,0,4
2022,1,مكتب محافظة الدوادمي,أنشطة النشر,2,0,0,0,2
2022,1,مكتب محافظة الدوادمي,أنشطة تقديم الخدمات للمباني وتجميل المواقع,712,161,10,1,884
2022,1,مكتب محافظة الدوادمي,أنشطة جمع النفايات ومعالجتها وتصريفها ، واسترجاع المواد,1,0,0,0,1
2022,1,مكتب محافظة الدوادمي,أنشطة خدمات الأطعمة والمشروبات,592,76,5,0,673
2022,1,مكتب محافظة الدوادمي,أنشطة خدمات المعلومات,4,1,0,0,5
2022,1,مكتب محافظة الدوادمي,أنشطة خدمات دعم التعدين,0,2,0,0,2
2022,1,مكتب محافظة الدوادمي,أنشطة زراعة المحاصيل والإنتاج الحيواني والصيد والخدمات المتصلة,1028,36,0,0,1064
2022,1,مكتب محافظة الدوادمي,الإدارة العامة والدفاع ؛ والضمان الاجتماعي الإلزامي,6,3,0,0,9
2022,1,مكتب محافظة الدوادمي,الإقامة,35,7,1,0,43
2022,1,مكتب محافظة الدوادمي,الأنشطة الإبداعية والفنون وأنشطة الترفيه,4,0,0,0,4
2022,1,مكتب محافظة الدوادمي,الأنشطة الأخرى للتعدين واستغلال المحاجر,2,2,0,0,4
2022,1,مكتب محافظة الدوادمي,الأنشطة الإدارية للمكاتب ، وأنشطة الدعم للمكاتب وغير ذلك من أنشطة الدعم للأعمال,13,0,0,0,13
2022,1,مكتب محافظة الدوادمي,الأنشطة الإيجارية,990,20,1,1,1012
2022,1,مكتب محافظة الدوادمي,الأنشطة البيطرية,8,0,0,0,8
2022,1,مكتب محافظة الدوادمي,الأنشطة الرياضية وأنشطة التسلية والترفيه,21,5,0,0,26
2022,1,مكتب محافظة الدوادمي,الأنشطة العقارية,29,6,0,0,35
2022,1,مكتب محافظة الدوادمي,الأنشطة القانونية وأنشطة المحاسبة,1,0,0,0,1
2022,1,مكتب محافظة الدوادمي,الأنشطة المساعدة لأنشطة الخدمات المالية وأنشطة التأمين,1,0,0,0,1
2022,1,مكتب محافظة الدوادمي,الأنشطة المهنية والعلمية والتقنية الأخرى,6,1,0,0,7
2022,1,مكتب محافظة الدوادمي,الاتصالات,5,0,0,0,5
2022,1,مكتب محافظة الدوادمي,التخزين وأنشطة الدعم للنقل,57,4,0,0,61
2022,1,مكتب محافظة الدوادمي,التعليم,16,12,2,0,30
2022,1,مكتب محافظة الدوادمي,الحراجة وقطع الأخشاب,1,0,0,0,1
2022,1,مكتب محافظة الدوادمي,الصحة البشرية,16,7,2,0,25
2022,1,مكتب محافظة الدوادمي,الصرف الصحي,1,0,0,0,1
2022,1,مكتب محافظة الدوادمي,الصناعة التحويلية الأخرى,11,1,0,0,12
2022,1,مكتب محافظة الدوادمي,الطباعة واستنساخ وسائط الأعلام المسجّلة,7,0,0,0,7
2022,1,مكتب محافظة الدوادمي,النقل البري و النقل عبر الأنابيب,696,65,4,0,765
2022,1,مكتب محافظة الدوادمي,النقل الجوي,11,3,0,0,14
2022,1,مكتب محافظة الدوادمي,النقل المائي,2,0,0,0,2
2022,1,مكتب محافظة الدوادمي,الهندسة المدنية,2,0,1,0,3
2022,1,مكتب محافظة الدوادمي,تجارة التجزئة، باستثناء المركبات ذات المحركات والدراجات النارية,616,81,2,0,699
2022,1,مكتب محافظة الدوادمي,تجارة الجملة ، باستثناء المركبات ذات المحركات والدراجات النارية,294,67,4,0,365
2022,1,مكتب محافظة الدوادمي,تجارة الجملة والتجزئة ، وإصلاح المركبات ذات المحركات والدراجات النارية,575,60,5,1,641
2022,1,مكتب محافظة الدوادمي,تجميع المياه ومعالجتها وتوصيلها,5,2,1,0,8
2022,1,مكتب محافظة الدوادمي,تشييد المباني,785,176,21,3,985
2022,1,مكتب محافظة الدوادمي,تعدين ركازات الفلزات,5,0,0,0,5
2022,1,مكتب محافظة الدوادمي,توصيل الكهرباء والغاز والبخار وتكييف الهواء,5,0,1,0,6
2022,1,مكتب محافظة الدوادمي,صناعة الآلات والمعدات غير المصنفة في موضع أخر,6,0,0,0,6
2022,1,مكتب محافظة الدوادمي,صناعة المركبات ذات المحركات والمركبات المقطورة ونصف المقطورة,12,0,0,0,12
2022,1,مكتب محافظة الدوادمي,صناعة معدات النقل الأخرى,4,1,0,0,5
2022,1,مكتب محافظة الدوادمي,صنع الأثاث,44,8,0,0,52
2022,1,مكتب محافظة الدوادمي,صنع الحواسيب والمنتجات الإلكترونية والبصرية,11,0,0,0,11
2022,1,مكتب محافظة الدوادمي,صُنع الخشب ومنتجات الخشب والفلين ، باستثناء الأثاث ، صُنع أصناف من القش ومواد الضفر,57,9,1,0,67
2022,1,مكتب محافظة الدوادمي,صنع الفلزات القاعدية,59,8,0,0,67
2022,1,مكتب محافظة الدوادمي,صُنع المشروبات,5,0,0,0,5
2022,1,مكتب محافظة الدوادمي,صنع المعدات الكهربائية,23,4,0,0,27
2022,1,مكتب محافظة الدوادمي,صُنع الملبوسات,173,21,1,0,195
2022,1,مكتب محافظة الدوادمي,صُنع المنتجات الجلدية والمنتجات ذات الصلة,4,0,0,0,4
2022,1,مكتب محافظة الدوادمي,صنع المنتجات الصيدلانية الأساسية والمستحضرات الصيدلانية,0,1,0,0,1
2022,1,مكتب محافظة الدوادمي,صُنع المنتجات الغذائية,88,12,0,0,100
2022,1,مكتب محافظة الدوادمي,صُنع المنسوجات,22,4,1,0,27
2022,1,مكتب محافظة الدوادمي,صُنع المواد الكيميائية والمنتجات الكيميائية,13,1,0,0,14
2022,1,مكتب محافظة الدوادمي,صُنع الورق ومنتجات الورق,1,0,0,0,1
2022,1,مكتب محافظة الدوادمي,صنع منتجات المطاط واللدائن,5,3,0,0,8
2022,1,مكتب محافظة الدوادمي,صنع منتجات المعادن اللافلزية الأخرى,46,21,1,0,68
2022,1,مكتب محافظة الدوادمي,صنع منتجات المعادن المشكلة ( باستثناء الآلات والمعدات ),80,10,0,0,90
2022,1,مكتب محافظة الدوادمي,صيد الأسماك وتربية المائيات,3,0,0,0,3
2022,1,مكتب محافظة الدوادمي,وكالات السفر ومشغّلو الجولات السياحية وخدمات الحجز والأنشطة المتصلة بها,2,0,0,0,2
2022,1,مكتب محافظة الطائف,أبحاث الإعلان والسوق,23,1,0,0,24
2022,1,مكتب محافظة الطائف,إصلاح أجهزة الحاسوب والسلع الشخصية والمنزلية,160,16,0,0,176
2022,1,مكتب محافظة الطائف,إصلاح وتركيب الآلات والمعدات,60,4,0,0,64
2022,1,مكتب محافظة الطائف,أنشطة أنتاج الأفلام والبرامج التلفزيونية والتسجيلات الصوتية و نشرالموسيقى,20,2,0,0,22
2022,1,مكتب محافظة الطائف,أنشطة الأمن والتحقيقات,10,1,0,0,11
2022,1,مكتب محافظة الطائف,أنشطة الاستخدام,18,3,0,0,21
2022,1,مكتب محافظة الطائف,أنشطة الاسر المعيشية التي تستخدم أفراداً للعمل المنزلي,2,1,0,0,3
2022,1,مكتب محافظة الطائف,أنشطة البرمجة الحاسوبية والخبرة الاستشارية وما يتصل بها من أنشطة,9,3,0,0,12
2022,1,مكتب محافظة الطائف,أنشطة البرمجة والإذاعة,0,0,1,0,1
2022,1,مكتب محافظة الطائف,أنشطة البريد ونقل الرسائل والطرود بواسطة مندوبين,1,0,0,0,1
2022,1,مكتب محافظة الطائف,أنشطة التشييد المتخصصة,1176,179,1,0,1356
2022,1,مكتب محافظة الطائف,أنشطة الخدمات الشخصية الأخرى,1151,90,0,0,1241
2022,1,مكتب محافظة الطائف,أنشطة الخدمات المالية ، فيما عدا تمويل التأمين وصناديق المعاشات,14,0,0,0,14
2022,1,مكتب محافظة الطائف,أنشطة العمل الاجتماعي، دون إقامة، لكبار السن وذوي الإعاقة,32,31,1,0,64
2022,1,مكتب محافظة الطائف,أنشطة المعالجة وخدمات إدارة النفايات الأخرى,0,1,0,0,1
2022,1,مكتب محافظة الطائف,أنشطة المعمارية والهندسية ، والاختبارات الفنية والتحليل,180,78,3,0,261
2022,1,مكتب محافظة الطائف,أنشطة المكاتب الرئيسية ، وألأنشطة الاستشارية في مجال الإدارة,13,4,0,0,17
2022,1,مكتب محافظة الطائف,أنشطة المكتبات ودور المحفوظات، والمتاحف والأنشطة الثقافية الأخرى,37,8,2,0,47
2022,1,مكتب محافظة الطائف,أنشطة المنظمات الدولية,0,1,0,0,1
2022,1,مكتب محافظة الطائف,أنشطة المنظمات ذات العضوية,15,2,1,0,18
2022,1,مكتب محافظة الطائف,أنشطة النشر,10,5,0,0,15
2022,1,مكتب محافظة الطائف,أنشطة تقديم الخدمات للمباني وتجميل المواقع,274,50,7,2,333
2022,1,مكتب محافظة الطائف,أنشطة جمع النفايات ومعالجتها وتصريفها ، واسترجاع المواد,4,0,0,0,4
2022,1,مكتب محافظة الطائف,أنشطة خدمات الأطعمة والمشروبات,2334,527,34,0,2895
2022,1,مكتب محافظة الطائف,أنشطة خدمات المعلومات,9,1,0,0,10
2022,1,مكتب محافظة الطائف,أنشطة خدمات دعم التعدين,19,7,1,0,27
2022,1,مكتب محافظة الطائف,أنشطة زراعة المحاصيل والإنتاج الحيواني والصيد والخدمات المتصلة,579,24,2,0,605
2022,1,مكتب محافظة الطائف,الإدارة العامة والدفاع ؛ والضمان الاجتماعي الإلزامي,18,6,5,0,29
2022,1,مكتب محافظة الطائف,الإقامة,156,49,7,0,212
2022,1,مكتب محافظة الطائف,الأنشطة الإبداعية والفنون وأنشطة الترفيه,9,4,0,0,13
2022,1,مكتب محافظة الطائف,الأنشطة الأخرى للتعدين واستغلال المحاجر,8,1,0,0,9
2022,1,مكتب محافظة الطائف,الأنشطة الإدارية للمكاتب ، وأنشطة الدعم للمكاتب وغير ذلك من أنشطة الدعم للأعمال,60,5,0,0,65
2022,1,مكتب محافظة الطائف,الأنشطة الإيجارية,1048,54,2,0,1104
2022,1,مكتب محافظة الطائف,الأنشطة البيطرية,18,4,0,0,22
2022,1,مكتب محافظة الطائف,الأنشطة الرياضية وأنشطة التسلية والترفيه,56,25,0,0,81
2022,1,مكتب محافظة الطائف,الأنشطة العقارية,67,13,2,0,82
2022,1,مكتب محافظة الطائف,الأنشطة القانونية وأنشطة المحاسبة,11,2,0,0,13
2022,1,مكتب محافظة الطائف,الأنشطة المهنية والعلمية والتقنية الأخرى,41,6,0,0,47
2022,1,مكتب محافظة الطائف,الاتصالات,31,0,0,0,31
2022,1,مكتب محافظة الطائف,البحث والتطوير في المجال العلمي,1,0,0,0,1
2022,1,مكتب محافظة الطائف,التخزين وأنشطة الدعم للنقل,82,7,2,0,91
2022,1,مكتب محافظة الطائف,التعليم,35,31,18,0,84
2022,1,مكتب محافظة الطائف,الرعاية مع الإقامة,1,1,0,0,2
2022,1,مكتب محافظة الطائف,الصحة البشرية,25,102,14,2,143
2022,1,مكتب محافظة الطائف,الصناعة التحويلية الأخرى,27,16,1,1,45
2022,1,مكتب محافظة الطائف,الطباعة واستنساخ وسائط الأعلام المسجّلة,28,11,0,0,39
2022,1,مكتب محافظة الطائف,النقل البري و النقل عبر الأنابيب,702,85,1,0,788
2022,1,مكتب محافظة الطائف,النقل الجوي,15,3,0,0,18
2022,1,مكتب محافظة الطائف,النقل المائي,6,2,0,0,8
2022,1,مكتب محافظة الطائف,الهندسة المدنية,15,2,1,0,18
2022,1,مكتب محافظة الطائف,تجارة التجزئة، باستثناء المركبات ذات المحركات والدراجات النارية,2785,436,24,0,3245
2022,1,مكتب محافظة الطائف,تجارة الجملة ، باستثناء المركبات ذات المحركات والدراجات النارية,905,171,18,0,1094
2022,1,مكتب محافظة الطائف,تجارة الجملة والتجزئة ، وإصلاح المركبات ذات المحركات والدراجات النارية,1419,173,5,0,1597
2022,1,مكتب محافظة الطائف,تجميع المياه ومعالجتها وتوصيلها,139,20,2,0,161
2022,1,مكتب محافظة الطائف,تشييد المباني,2298,507,41,2,2848
2022,1,مكتب محافظة الطائف,تعدين الفحم والليغنيت,2,0,0,0,2
2022,1,مكتب محافظة الطائف,تعدين ركازات الفلزات,19,3,0,0,22
2022,1,مكتب محافظة الطائف,تمويل التأمين وإعادة التأمين وصناديق المعاشات التقاعدية باستثناء الضمان الاجتماعي الإلزامي,0,1,0,0,1
2022,1,مكتب محافظة الطائف,توصيل الكهرباء والغاز والبخار وتكييف الهواء,10,1,0,0,11
2022,1,مكتب محافظة الطائف,صناعة الآلات والمعدات غير المصنفة في موضع أخر,18,0,0,0,18
2022,1,مكتب محافظة الطائف,صناعة المركبات ذات المحركات والمركبات المقطورة ونصف المقطورة,33,2,0,0,35
2022,1,مكتب محافظة الطائف,صناعة معدات النقل الأخرى,4,2,0,0,6
2022,1,مكتب محافظة الطائف,صنع الأثاث,172,27,3,0,202
2022,1,مكتب محافظة الطائف,صنع الحواسيب والمنتجات الإلكترونية والبصرية,108,17,0,0,125
2022,1,مكتب محافظة الطائف,صُنع الخشب ومنتجات الخشب والفلين ، باستثناء الأثاث ، صُنع أصناف من القش ومواد الضفر,178,28,0,0,206
2022,1,مكتب محافظة الطائف,صنع الفلزات القاعدية,112,26,2,0,140
2022,1,مكتب محافظة الطائف,صُنع المشروبات,17,6,0,0,23
2022,1,مكتب محافظة الطائف,صنع المعدات الكهربائية,78,14,0,1,93
2022,1,مكتب محافظة الطائف,صُنع الملبوسات,514,48,2,0,564
2022,1,مكتب محافظة الطائف,صُنع المنتجات الجلدية والمنتجات ذات الصلة,8,0,0,0,8
2022,1,مكتب محافظة الطائف,صنع المنتجات الصيدلانية الأساسية والمستحضرات الصيدلانية,1,0,0,0,1
2022,1,مكتب محافظة الطائف,صُنع المنتجات الغذائية,350,95,3,1,449
2022,1,مكتب محافظة الطائف,صُنع المنسوجات,62,23,0,0,85
2022,1,مكتب محافظة الطائف,صُنع المواد الكيميائية والمنتجات الكيميائية,62,12,3,0,77
2022,1,مكتب محافظة الطائف,صُنع الورق ومنتجات الورق,8,2,0,0,10
2022,1,مكتب محافظة الطائف,صُنع منتجات التبغ,1,0,0,0,1
2022,1,مكتب محافظة الطائف,صنع منتجات المطاط واللدائن,17,7,0,0,24
2022,1,مكتب محافظة الطائف,صنع منتجات المعادن اللافلزية الأخرى,78,20,1,1,100
2022,1,مكتب محافظة الطائف,صنع منتجات المعادن المشكلة ( باستثناء الآلات والمعدات ),492,63,0,0,555
2022,1,مكتب محافظة الطائف,صيد الأسماك وتربية المائيات,3,1,0,0,4
2022,1,مكتب محافظة الطائف,وكالات السفر ومشغّلو الجولات السياحية وخدمات الحجز والأنشطة المتصلة بها,16,3,0,0,19
2022,1,مكتب محافظة بيشة,أبحاث الإعلان والسوق,2,0,0,0,2
2022,1,مكتب محافظة بيشة,إصلاح أجهزة الحاسوب والسلع الشخصية والمنزلية,40,6,0,0,46
2022,1,مكتب محافظة بيشة,إصلاح وتركيب الآلات والمعدات,11,0,0,0,11
2022,1,مكتب محافظة بيشة,أنشطة الاستخدام,8,0,0,0,8
2022,1,مكتب محافظة بيشة,أنشطة الاسر المعيشية التي تستخدم أفراداً للعمل المنزلي,1,0,0,0,1
2022,1,مكتب محافظة بيشة,أنشطة البرمجة الحاسوبية والخبرة الاستشارية وما يتصل بها من أنشطة,2,0,1,0,3
2022,1,مكتب محافظة بيشة,أنشطة التشييد المتخصصة,566,72,1,0,639
2022,1,مكتب محافظة بيشة,أنشطة الخدمات الشخصية الأخرى,214,22,0,0,236
2022,1,مكتب محافظة بيشة,أنشطة الخدمات المالية ، فيما عدا تمويل التأمين وصناديق المعاشات,13,2,0,0,15
2022,1,مكتب محافظة بيشة,أنشطة العمل الاجتماعي، دون إقامة، لكبار السن وذوي الإعاقة,28,8,0,0,36
2022,1,مكتب محافظة بيشة,أنشطة المعمارية والهندسية ، والاختبارات الفنية والتحليل,21,4,2,0,27
2022,1,مكتب محافظة بيشة,أنشطة المكاتب الرئيسية ، وألأنشطة الاستشارية في مجال الإدارة,6,1,0,0,7
2022,1,مكتب محافظة بيشة,أنشطة المكتبات ودور المحفوظات، والمتاحف والأنشطة الثقافية الأخرى,8,3,0,0,11
2022,1,مكتب محافظة بيشة,أنشطة المنظمات ذات العضوية,7,1,0,0,8
2022,1,مكتب محافظة بيشة,أنشطة النشر,3,0,0,0,3
2022,1,مكتب محافظة بيشة,أنشطة تقديم الخدمات للمباني وتجميل المواقع,50,10,0,0,60
2022,1,مكتب محافظة بيشة,أنشطة جمع النفايات ومعالجتها وتصريفها ، واسترجاع المواد,2,0,0,0,2
2022,1,مكتب محافظة بيشة,أنشطة خدمات الأطعمة والمشروبات,516,91,4,0,611
2022,1,مكتب محافظة بيشة,أنشطة خدمات المعلومات,1,0,0,0,1
2022,1,مكتب محافظة بيشة,أنشطة خدمات دعم التعدين,7,1,0,0,8
2022,1,مكتب محافظة بيشة,أنشطة زراعة المحاصيل والإنتاج الحيواني والصيد والخدمات المتصلة,272,15,0,0,287
2022,1,مكتب محافظة بيشة,الإدارة العامة والدفاع ؛ والضمان الاجتماعي الإلزامي,3,4,0,0,7
2022,1,مكتب محافظة بيشة,الإقامة,30,11,1,0,42
2022,1,مكتب محافظة بيشة,الأنشطة الأخرى للتعدين واستغلال المحاجر,8,4,1,0,13
2022,1,مكتب محافظة بيشة,الأنشطة الإدارية للمكاتب ، وأنشطة الدعم للمكاتب وغير ذلك من أنشطة الدعم للأعمال,12,3,0,0,15
2022,1,مكتب محافظة بيشة,الأنشطة الإيجارية,246,5,1,0,252
2022,1,مكتب محافظة بيشة,الأنشطة البيطرية,6,0,0,0,6
2022,1,مكتب محافظة بيشة,الأنشطة الرياضية وأنشطة التسلية والترفيه,9,4,0,0,13
2022,1,مكتب محافظة بيشة,الأنشطة العقارية,5,3,0,0,8
2022,1,مكتب محافظة بيشة,الأنشطة القانونية وأنشطة المحاسبة,1,0,0,0,1
2022,1,مكتب محافظة بيشة,الأنشطة المهنية والعلمية والتقنية الأخرى,3,0,0,0,3
2022,1,مكتب محافظة بيشة,الاتصالات,9,1,0,0,10
2022,1,مكتب محافظة بيشة,البحث والتطوير في المجال العلمي,1,0,0,0,1
2022,1,مكتب محافظة بيشة,التخزين وأنشطة الدعم للنقل,35,3,0,0,38
2022,1,مكتب محافظة بيشة,التعليم,16,8,1,0,25
2022,1,مكتب محافظة بيشة,الرعاية مع الإقامة,4,0,0,0,4
2022,1,مكتب محافظة بيشة,الصحة البشرية,4,13,2,0,19
2022,1,مكتب محافظة بيشة,الصناعة التحويلية الأخرى,1,1,0,0,2
2022,1,مكتب محافظة بيشة,الطباعة واستنساخ وسائط الأعلام المسجّلة,7,0,0,0,7
2022,1,مكتب محافظة بيشة,النقل البري و النقل عبر الأنابيب,301,28,1,0,330
2022,1,مكتب محافظة بيشة,النقل الجوي,1,2,0,0,3
2022,1,مكتب محافظة بيشة,النقل المائي,1,1,0,0,2
2022,1,مكتب محافظة بيشة,الهندسة المدنية,4,2,0,0,6
2022,1,مكتب محافظة بيشة,تجارة التجزئة، باستثناء المركبات ذات المحركات والدراجات النارية,841,165,7,0,1013
2022,1,مكتب محافظة بيشة,تجارة الجملة ، باستثناء المركبات ذات المحركات والدراجات النارية,203,69,0,1,273
2022,1,مكتب محافظة بيشة,تجارة الجملة والتجزئة ، وإصلاح المركبات ذات المحركات والدراجات النارية,414,36,3,0,453
2022,1,مكتب محافظة بيشة,تجميع المياه ومعالجتها وتوصيلها,8,3,0,0,11
2022,1,مكتب محافظة بيشة,تشييد المباني,782,178,9,3,972
2022,1,مكتب محافظة بيشة,تعدين ركازات الفلزات,13,4,0,0,17
2022,1,مكتب محافظة بيشة,توصيل الكهرباء والغاز والبخار وتكييف الهواء,5,3,0,0,8
2022,1,مكتب محافظة بيشة,صناعة الآلات والمعدات غير المصنفة في موضع أخر,5,0,0,0,5
2022,1,مكتب محافظة بيشة,صناعة المركبات ذات المحركات والمركبات المقطورة ونصف المقطورة,9,0,0,0,9
2022,1,مكتب محافظة بيشة,صناعة معدات النقل الأخرى,3,0,0,0,3
2022,1,مكتب محافظة بيشة,صنع الأثاث,47,15,0,0,62
2022,1,مكتب محافظة بيشة,صنع الحواسيب والمنتجات الإلكترونية والبصرية,37,5,0,0,42
2022,1,مكتب محافظة بيشة,صُنع الخشب ومنتجات الخشب والفلين ، باستثناء الأثاث ، صُنع أصناف من القش ومواد الضفر,45,6,0,0,51
2022,1,مكتب محافظة بيشة,صنع الفلزات القاعدية,33,5,0,0,38
2022,1,مكتب محافظة بيشة,صُنع المشروبات,8,0,0,0,8
2022,1,مكتب محافظة بيشة,صنع المعدات الكهربائية,21,0,0,0,21
2022,1,مكتب محافظة بيشة,صُنع الملبوسات,124,19,0,0,143
2022,1,مكتب محافظة بيشة,صُنع المنتجات الجلدية والمنتجات ذات الصلة,4,0,0,0,4
2022,1,مكتب محافظة بيشة,صنع المنتجات الصيدلانية الأساسية والمستحضرات الصيدلانية,0,1,0,0,1
2022,1,مكتب محافظة بيشة,صُنع المنتجات الغذائية,84,14,0,0,98
2022,1,مكتب محافظة بيشة,صُنع المنسوجات,20,2,0,0,22
2022,1,مكتب محافظة بيشة,صُنع المواد الكيميائية والمنتجات الكيميائية,18,2,0,0,20
2022,1,مكتب محافظة بيشة,صُنع الورق ومنتجات الورق,1,0,0,0,1
2022,1,مكتب محافظة بيشة,صنع منتجات المطاط واللدائن,4,5,0,0,9
2022,1,مكتب محافظة بيشة,صنع منتجات المعادن اللافلزية الأخرى,28,9,2,1,40
2022,1,مكتب محافظة بيشة,صنع منتجات المعادن المشكلة ( باستثناء الآلات والمعدات ),84,11,1,0,96
2022,1,مكتب محافظة بيشة,صيد الأسماك وتربية المائيات,3,0,0,0,3
2022,1,مكتب محافظة بيشة,وكالات السفر ومشغّلو الجولات السياحية وخدمات الحجز والأنشطة المتصلة بها,1,0,0,0,1
2022,1,مكتب محافظة حفر الباطن,أبحاث الإعلان والسوق,11,3,0,0,14
2022,1,مكتب محافظة حفر الباطن,إصلاح أجهزة الحاسوب والسلع الشخصية والمنزلية,56,3,0,0,59
2022,1,مكتب محافظة حفر الباطن,إصلاح وتركيب الآلات والمعدات,26,0,0,0,26
2022,1,مكتب محافظة حفر الباطن,أنشطة أنتاج الأفلام والبرامج التلفزيونية والتسجيلات الصوتية و نشرالموسيقى,2,0,0,0,2
2022,1,مكتب محافظة حفر الباطن,أنشطة الأمن والتحقيقات,1,2,0,0,3
2022,1,مكتب محافظة حفر الباطن,أنشطة الاستخدام,16,6,1,1,24
2022,1,مكتب محافظة حفر الباطن,أنشطة الاسر المعيشية التي تستخدم أفراداً للعمل المنزلي,1,0,0,0,1
2022,1,مكتب محافظة حفر الباطن,أنشطة البرمجة الحاسوبية والخبرة الاستشارية وما يتصل بها من أنشطة,3,1,0,0,4
2022,1,مكتب محافظة حفر الباطن,أنشطة البريد ونقل الرسائل والطرود بواسطة مندوبين,2,0,0,0,2
2022,1,مكتب محافظة حفر الباطن,أنشطة التشييد المتخصصة,668,131,10,3,812
2022,1,مكتب محافظة حفر الباطن,أنشطة الخدمات الشخصية الأخرى,526,50,2,0,578
2022,1,مكتب محافظة حفر الباطن,أنشطة الخدمات المالية ، فيما عدا تمويل التأمين وصناديق المعاشات,14,5,0,0,19
2022,1,مكتب محافظة حفر الباطن,أنشطة العمل الاجتماعي، دون إقامة، لكبار السن وذوي الإعاقة,3,3,0,0,6
2022,1,مكتب محافظة حفر الباطن,أنشطة المعمارية والهندسية ، والاختبارات الفنية والتحليل,39,9,2,0,50
2022,1,مكتب محافظة حفر الباطن,أنشطة المكاتب الرئيسية ، وألأنشطة الاستشارية في مجال الإدارة,12,3,0,0,15
2022,1,مكتب محافظة حفر الباطن,أنشطة المكتبات ودور المحفوظات، والمتاحف والأنشطة الثقافية الأخرى,9,5,0,0,14
2022,1,مكتب محافظة حفر الباطن,أنشطة المنظمات ذات العضوية,0,1,0,0,1
2022,1,مكتب محافظة حفر الباطن,أنشطة النشر,13,5,0,0,18
2022,1,مكتب محافظة حفر الباطن,أنشطة تقديم الخدمات للمباني وتجميل المواقع,118,24,2,0,144
2022,1,مكتب محافظة حفر الباطن,أنشطة جمع النفايات ومعالجتها وتصريفها ، واسترجاع المواد,1,0,1,0,2
2022,1,مكتب محافظة حفر الباطن,أنشطة خدمات الأطعمة والمشروبات,1352,302,18,2,1674
2022,1,مكتب محافظة حفر الباطن,أنشطة خدمات المعلومات,5,0,0,0,5
2022,1,مكتب محافظة حفر الباطن,أنشطة خدمات دعم التعدين,9,2,0,0,11
2022,1,مكتب محافظة حفر الباطن,أنشطة زراعة المحاصيل والإنتاج الحيواني والصيد والخدمات المتصلة,127,3,0,0,130
2022,1,مكتب محافظة حفر الباطن,الإدارة العامة والدفاع ؛ والضمان الاجتماعي الإلزامي,6,6,0,0,12
2022,1,مكتب محافظة حفر الباطن,الإقامة,34,14,1,0,49
2022,1,مكتب محافظة حفر الباطن,الأنشطة الإبداعية والفنون وأنشطة الترفيه,1,0,0,0,1
2022,1,مكتب محافظة حفر الباطن,الأنشطة الأخرى للتعدين واستغلال المحاجر,11,1,0,0,12
2022,1,مكتب محافظة حفر الباطن,الأنشطة الإدارية للمكاتب ، وأنشطة الدعم للمكاتب وغير ذلك من أنشطة الدعم للأعمال,21,4,0,0,25
2022,1,مكتب محافظة حفر الباطن,الأنشطة الإيجارية,470,27,0,0,497
2022,1,مكتب محافظة حفر الباطن,الأنشطة البيطرية,8,1,0,0,9
2022,1,مكتب محافظة حفر الباطن,الأنشطة الرياضية وأنشطة التسلية والترفيه,18,5,0,0,23
2022,1,مكتب محافظة حفر الباطن,الأنشطة العقارية,18,2,0,0,20
2022,1,مكتب محافظة حفر الباطن,الأنشطة القانونية وأنشطة المحاسبة,2,0,0,0,2
2022,1,مكتب محافظة حفر الباطن,الأنشطة المساعدة لأنشطة الخدمات المالية وأنشطة التأمين,1,2,0,0,3
2022,1,مكتب محافظة حفر الباطن,الأنشطة المهنية والعلمية والتقنية الأخرى,8,2,1,0,11
2022,1,مكتب محافظة حفر الباطن,الاتصالات,10,0,0,0,10
2022,1,مكتب محافظة حفر الباطن,التخزين وأنشطة الدعم للنقل,88,24,1,0,113
2022,1,مكتب محافظة حفر الباطن,التعليم,19,21,8,1,49
2022,1,مكتب محافظة حفر الباطن,الصحة البشرية,16,21,11,0,48
2022,1,مكتب محافظة حفر الباطن,الصناعة التحويلية الأخرى,6,1,0,0,7
2022,1,مكتب محافظة حفر الباطن,الطباعة واستنساخ وسائط الأعلام المسجّلة,10,3,0,0,13
2022,1,مكتب محافظة حفر الباطن,النقل البري و النقل عبر الأنابيب,407,61,6,2,476
2022,1,مكتب محافظة حفر الباطن,النقل الجوي,10,4,0,0,14
2022,1,مكتب محافظة حفر الباطن,النقل المائي,5,0,0,0,5
2022,1,مكتب محافظة حفر الباطن,الهندسة المدنية,1,0,0,0,1
2022,1,مكتب محافظة حفر الباطن,تجارة التجزئة، باستثناء المركبات ذات المحركات والدراجات النارية,1130,199,8,1,1338
2022,1,مكتب محافظة حفر الباطن,تجارة الجملة ، باستثناء المركبات ذات المحركات والدراجات النارية,353,86,8,1,448
2022,1,مكتب محافظة حفر الباطن,تجارة الجملة والتجزئة ، وإصلاح المركبات ذات المحركات والدراجات النارية,663,116,6,0,785
2022,1,مكتب محافظة حفر الباطن,تجميع المياه ومعالجتها وتوصيلها,3,2,0,0,5
2022,1,مكتب محافظة حفر الباطن,تشييد المباني,1271,314,36,2,1623
2022,1,مكتب محافظة حفر الباطن,تعدين ركازات الفلزات,47,7,0,0,54
2022,1,مكتب محافظة حفر الباطن,توصيل الكهرباء والغاز والبخار وتكييف الهواء,4,4,0,0,8
2022,1,مكتب محافظة حفر الباطن,صناعة الآلات والمعدات غير المصنفة في موضع أخر,14,0,0,0,14
2022,1,مكتب محافظة حفر الباطن,صناعة المركبات ذات المحركات والمركبات المقطورة ونصف المقطورة,15,1,0,0,16
2022,1,مكتب محافظة حفر الباطن,صناعة معدات النقل الأخرى,6,1,0,0,7
2022,1,مكتب محافظة حفر الباطن,صنع الأثاث,96,23,0,0,119
2022,1,مكتب محافظة حفر الباطن,صنع الحواسيب والمنتجات الإلكترونية والبصرية,15,3,0,0,18
2022,1,مكتب محافظة حفر الباطن,صُنع الخشب ومنتجات الخشب والفلين ، باستثناء الأثاث ، صُنع أصناف من القش ومواد الضفر,58,10,0,0,68
2022,1,مكتب محافظة حفر الباطن,صنع الفلزات القاعدية,26,10,0,0,36
2022,1,مكتب محافظة حفر الباطن,صُنع المشروبات,10,3,3,0,16
2022,1,مكتب محافظة حفر الباطن,صنع المعدات الكهربائية,69,11,0,0,80
2022,1,مكتب محافظة حفر الباطن,صُنع الملبوسات,296,41,0,0,337
2022,1,مكتب محافظة حفر الباطن,صُنع المنتجات الجلدية والمنتجات ذات الصلة,2,2,1,0,5
2022,1,مكتب محافظة حفر الباطن,صنع المنتجات الصيدلانية الأساسية والمستحضرات الصيدلانية,0,1,0,0,1
2022,1,مكتب محافظة حفر الباطن,صُنع المنتجات الغذائية,110,38,7,1,156
2022,1,مكتب محافظة حفر الباطن,صُنع المنسوجات,58,12,1,0,71
2022,1,مكتب محافظة حفر الباطن,صُنع المواد الكيميائية والمنتجات الكيميائية,25,5,0,0,30
2022,1,مكتب محافظة حفر الباطن,صُنع الورق ومنتجات الورق,3,3,1,0,7
2022,1,مكتب محافظة حفر الباطن,صنع فحم الكوك والمنتجات النفطية المكررة,1,0,0,0,1
2022,1,مكتب محافظة حفر الباطن,صُنع منتجات التبغ,2,1,0,0,3
2022,1,مكتب محافظة حفر الباطن,صنع منتجات المطاط واللدائن,9,4,1,0,14
2022,1,مكتب محافظة حفر الباطن,صنع منتجات المعادن اللافلزية الأخرى,83,31,8,0,122
2022,1,مكتب محافظة حفر الباطن,صنع منتجات المعادن المشكلة ( باستثناء الآلات والمعدات ),116,32,2,0,150
2022,1,مكتب محافظة حفر الباطن,صيد الأسماك وتربية المائيات,1,0,0,0,1
2022,1,مكتب محافظة حفر الباطن,وكالات السفر ومشغّلو الجولات السياحية وخدمات الحجز والأنشطة المتصلة بها,2,3,0,0,5
2022,1,مكتب محافظة ينبع,أبحاث الإعلان والسوق,8,0,0,0,8
2022,1,مكتب محافظة ينبع,إصلاح أجهزة الحاسوب والسلع الشخصية والمنزلية,60,7,0,0,67
2022,1,مكتب محافظة ينبع,إصلاح وتركيب الآلات والمعدات,21,5,0,0,26
2022,1,مكتب محافظة ينبع,أنشطة أنتاج الأفلام والبرامج التلفزيونية والتسجيلات الصوتية و نشرالموسيقى,5,0,0,0,5
2022,1,مكتب محافظة ينبع,أنشطة الاستخدام,9,2,0,0,11
2022,1,مكتب محافظة ينبع,أنشطة الاسر المعيشية التي تستخدم أفراداً للعمل المنزلي,1,0,0,0,1
2022,1,مكتب محافظة ينبع,أنشطة البرمجة الحاسوبية والخبرة الاستشارية وما يتصل بها من أنشطة,5,2,0,0,7
2022,1,مكتب محافظة ينبع,أنشطة البريد ونقل الرسائل والطرود بواسطة مندوبين,1,0,0,0,1
2022,1,مكتب محافظة ينبع,أنشطة التشييد المتخصصة,541,123,9,0,673
2022,1,مكتب محافظة ينبع,أنشطة الخدمات الشخصية الأخرى,336,43,4,0,383
2022,1,مكتب محافظة ينبع,أنشطة الخدمات المالية ، فيما عدا تمويل التأمين وصناديق المعاشات,4,0,0,0,4
2022,1,مكتب محافظة ينبع,أنشطة العمل الاجتماعي، دون إقامة، لكبار السن وذوي الإعاقة,23,8,0,0,31
2022,1,مكتب محافظة ينبع,أنشطة المعمارية والهندسية ، والاختبارات الفنية والتحليل,28,5,0,0,33
2022,1,مكتب محافظة ينبع,أنشطة المكاتب الرئيسية ، وألأنشطة الاستشارية في مجال الإدارة,6,1,0,0,7
2022,1,مكتب محافظة ينبع,أنشطة المكتبات ودور المحفوظات، والمتاحف والأنشطة الثقافية الأخرى,9,1,0,0,10
2022,1,مكتب محافظة ينبع,أنشطة المنظمات الدولية,1,0,0,0,1
2022,1,مكتب محافظة ينبع,أنشطة المنظمات ذات العضوية,9,4,0,0,13
2022,1,مكتب محافظة ينبع,أنشطة النشر,3,1,0,0,4
2022,1,مكتب محافظة ينبع,أنشطة تقديم الخدمات للمباني وتجميل المواقع,109,48,0,1,158
2022,1,مكتب محافظة ينبع,أنشطة خدمات الأطعمة والمشروبات,816,246,10,0,1072
2022,1,مكتب محافظة ينبع,أنشطة خدمات المعلومات,2,3,0,0,5
2022,1,مكتب محافظة ينبع,أنشطة خدمات دعم التعدين,2,4,0,2,8
2022,1,مكتب محافظة ينبع,أنشطة زراعة المحاصيل والإنتاج الحيواني والصيد والخدمات المتصلة,125,8,0,0,133
2022,1,مكتب محافظة ينبع,الإدارة العامة والدفاع ؛ والضمان الاجتماعي الإلزامي,6,12,0,0,18
2022,1,مكتب محافظة ينبع,الإقامة,48,19,4,0,71
2022,1,مكتب محافظة ينبع,الأنشطة الإبداعية والفنون وأنشطة الترفيه,3,1,0,0,4
2022,1,مكتب محافظة ينبع,الأنشطة الأخرى للتعدين واستغلال المحاجر,5,0,0,0,5
2022,1,مكتب محافظة ينبع,الأنشطة الإدارية للمكاتب ، وأنشطة الدعم للمكاتب وغير ذلك من أنشطة الدعم للأعمال,15,0,0,0,15
2022,1,مكتب محافظة ينبع,الأنشطة الإيجارية,141,14,1,0,156
2022,1,مكتب محافظة ينبع,الأنشطة الرياضية وأنشطة التسلية والترفيه,19,8,1,0,28
2022,1,مكتب محافظة ينبع,الأنشطة العقارية,17,1,0,0,18
2022,1,مكتب محافظة ينبع,الأنشطة القانونية وأنشطة المحاسبة,3,0,0,0,3
2022,1,مكتب محافظة ينبع,الأنشطة المهنية والعلمية والتقنية الأخرى,8,0,0,0,8
2022,1,مكتب محافظة ينبع,الاتصالات,8,1,0,0,9
2022,1,مكتب محافظة ينبع,البحث والتطوير في المجال العلمي,0,0,1,0,1
2022,1,مكتب محافظة ينبع,التخزين وأنشطة الدعم للنقل,42,12,2,1,57
2022,1,مكتب محافظة ينبع,التعليم,25,14,8,0,47
2022,1,مكتب محافظة ينبع,الرعاية مع الإقامة,6,1,0,0,7
2022,1,مكتب محافظة ينبع,الصحة البشرية,15,20,6,2,43
2022,1,مكتب محافظة ينبع,الصرف الصحي,1,0,0,0,1
2022,1,مكتب محافظة ينبع,الصناعة التحويلية الأخرى,6,1,0,0,7
2022,1,مكتب محافظة ينبع,الطباعة واستنساخ وسائط الأعلام المسجّلة,15,2,1,0,18
2022,1,مكتب محافظة ينبع,النقل البري و النقل عبر الأنابيب,280,45,9,0,334
2022,1,مكتب محافظة ينبع,النقل الجوي,6,3,0,0,9
2022,1,مكتب محافظة ينبع,النقل المائي,8,2,1,0,11
2022,1,مكتب محافظة ينبع,الهندسة المدنية,5,5,0,0,10
2022,1,مكتب محافظة ينبع,تجارة التجزئة، باستثناء المركبات ذات المحركات والدراجات النارية,953,196,10,2,1161
2022,1,مكتب محافظة ينبع,تجارة الجملة ، باستثناء المركبات ذات المحركات والدراجات النارية,292,89,9,0,390
2022,1,مكتب محافظة ينبع,تجارة الجملة والتجزئة ، وإصلاح المركبات ذات المحركات والدراجات النارية,482,75,2,0,559
2022,1,مكتب محافظة ينبع,تجميع المياه ومعالجتها وتوصيلها,4,2,0,0,6
2022,1,مكتب محافظة ينبع,تشييد المباني,913,373,51,4,1341
2022,1,مكتب محافظة ينبع,تعدين الفحم والليغنيت,1,0,0,0,1
2022,1,مكتب محافظة ينبع,تعدين ركازات الفلزات,4,1,0,0,5
2022,1,مكتب محافظة ينبع,تمويل التأمين وإعادة التأمين وصناديق المعاشات التقاعدية باستثناء الضمان الاجتماعي الإلزامي,1,0,0,0,1
2022,1,مكتب محافظة ينبع,توصيل الكهرباء والغاز والبخار وتكييف الهواء,5,2,1,0,8
2022,1,مكتب محافظة ينبع,صناعة الآلات والمعدات غير المصنفة في موضع أخر,3,1,1,0,5
2022,1,مكتب محافظة ينبع,صناعة المركبات ذات المحركات والمركبات المقطورة ونصف المقطورة,8,1,1,0,10
2022,1,مكتب محافظة ينبع,صناعة معدات النقل الأخرى,4,0,0,0,4
2022,1,مكتب محافظة ينبع,صنع الأثاث,39,2,0,0,41
2022,1,مكتب محافظة ينبع,صنع الحواسيب والمنتجات الإلكترونية والبصرية,8,4,0,0,12
2022,1,مكتب محافظة ينبع,صُنع الخشب ومنتجات الخشب والفلين ، باستثناء الأثاث ، صُنع أصناف من القش ومواد الضفر,30,5,1,0,36
2022,1,مكتب محافظة ينبع,صنع الفلزات القاعدية,23,3,2,0,28
2022,1,مكتب محافظة ينبع,صُنع المشروبات,4,1,0,0,5
2022,1,مكتب محافظة ينبع,صنع المعدات الكهربائية,16,3,1,1,21
2022,1,مكتب محافظة ينبع,صُنع الملبوسات,156,21,0,0,177
2022,1,مكتب محافظة ينبع,صُنع المنتجات الجلدية والمنتجات ذات الصلة,1,0,0,0,1
2022,1,مكتب محافظة ينبع,صُنع المنتجات الغذائية,83,19,7,0,109
2022,1,مكتب محافظة ينبع,صُنع المنسوجات,10,1,1,0,12
2022,1,مكتب محافظة ينبع,صُنع المواد الكيميائية والمنتجات الكيميائية,8,12,7,2,29
2022,1,مكتب محافظة ينبع,صُنع الورق ومنتجات الورق,5,2,1,0,8
2022,1,مكتب محافظة ينبع,صنع فحم الكوك والمنتجات النفطية المكررة,1,1,3,0,5
2022,1,مكتب محافظة ينبع,صُنع منتجات التبغ,1,0,0,0,1
2022,1,مكتب محافظة ينبع,صنع منتجات المطاط واللدائن,7,6,1,1,15
2022,1,مكتب محافظة ينبع,صنع منتجات المعادن اللافلزية الأخرى,30,16,15,4,65
2022,1,مكتب محافظة ينبع,صنع منتجات المعادن المشكلة ( باستثناء الآلات والمعدات ),63,13,3,0,79
2022,1,مكتب محافظة ينبع,صيد الأسماك وتربية المائيات,36,17,0,0,53
2022,1,مكتب محافظة ينبع,وكالات السفر ومشغّلو الجولات السياحية وخدمات الحجز والأنشطة المتصلة بها,6,1,0,0,7
2022,1,مكتب مكة المكرمة,أبحاث الإعلان والسوق,50,1,0,0,51
2022,1,مكتب مكة المكرمة,إصلاح أجهزة الحاسوب والسلع الشخصية والمنزلية,270,37,0,0,307
2022,1,مكتب مكة المكرمة,إصلاح وتركيب الآلات والمعدات,151,9,0,0,160
2022,1,مكتب مكة المكرمة,أنشطة أنتاج الأفلام والبرامج التلفزيونية والتسجيلات الصوتية و نشرالموسيقى,19,4,0,0,23
2022,1,مكتب مكة المكرمة,أنشطة الأمن والتحقيقات,17,5,4,2,28
2022,1,مكتب مكة المكرمة,أنشطة الاستخدام,34,3,0,1,38
2022,1,مكتب مكة المكرمة,أنشطة الاسر المعيشية التي تستخدم أفراداً للعمل المنزلي,3,0,0,0,3
2022,1,مكتب مكة المكرمة,أنشطة البرمجة الحاسوبية والخبرة الاستشارية وما يتصل بها من أنشطة,38,10,0,0,48
2022,1,مكتب مكة المكرمة,أنشطة البرمجة والإذاعة,1,0,0,0,1
2022,1,مكتب مكة المكرمة,أنشطة البريد ونقل الرسائل والطرود بواسطة مندوبين,6,1,0,0,7
2022,1,مكتب مكة المكرمة,أنشطة التشييد المتخصصة,2329,538,34,2,2903
2022,1,مكتب مكة المكرمة,أنشطة الخدمات الشخصية الأخرى,1873,261,9,0,2143
2022,1,مكتب مكة المكرمة,أنشطة الخدمات المالية ، فيما عدا تمويل التأمين وصناديق المعاشات,61,12,0,0,73
2022,1,مكتب مكة المكرمة,أنشطة العمل الاجتماعي، دون إقامة، لكبار السن وذوي الإعاقة,205,109,9,2,325
2022,1,مكتب مكة المكرمة,أنشطة المعالجة وخدمات إدارة النفايات الأخرى,1,0,0,0,1
2022,1,مكتب مكة المكرمة,أنشطة المعمارية والهندسية ، والاختبارات الفنية والتحليل,245,166,5,2,418
2022,1,مكتب مكة المكرمة,أنشطة المكاتب الرئيسية ، وألأنشطة الاستشارية في مجال الإدارة,63,11,0,0,74
2022,1,مكتب مكة المكرمة,أنشطة المكتبات ودور المحفوظات، والمتاحف والأنشطة الثقافية الأخرى,57,13,1,0,71
2022,1,مكتب مكة المكرمة,أنشطة المنظمات الدولية,1,0,0,0,1
2022,1,مكتب مكة المكرمة,أنشطة المنظمات ذات العضوية,40,7,0,0,47
2022,1,مكتب مكة المكرمة,أنشطة النشر,20,1,0,0,21
2022,1,مكتب مكة المكرمة,أنشطة تقديم الخدمات للمباني وتجميل المواقع,775,202,24,2,1003
2022,1,مكتب مكة المكرمة,أنشطة جمع النفايات ومعالجتها وتصريفها ، واسترجاع المواد,1,0,0,0,1
2022,1,مكتب مكة المكرمة,أنشطة خدمات الأطعمة والمشروبات,3922,958,71,4,4955
2022,1,مكتب مكة المكرمة,أنشطة خدمات المعلومات,24,1,0,0,25
2022,1,مكتب مكة المكرمة,أنشطة خدمات دعم التعدين,9,6,1,0,16
2022,1,مكتب مكة المكرمة,أنشطة زراعة المحاصيل والإنتاج الحيواني والصيد والخدمات المتصلة,454,32,1,1,488
2022,1,مكتب مكة المكرمة,الإدارة العامة والدفاع ؛ والضمان الاجتماعي الإلزامي,64,43,3,0,110
2022,1,مكتب مكة المكرمة,الإقامة,333,157,40,8,538
2022,1,مكتب مكة المكرمة,الأنشطة الإبداعية والفنون وأنشطة الترفيه,8,0,0,0,8
2022,1,مكتب مكة المكرمة,الأنشطة الأخرى للتعدين واستغلال المحاجر,8,2,0,0,10
2022,1,مكتب مكة المكرمة,الأنشطة الإدارية للمكاتب ، وأنشطة الدعم للمكاتب وغير ذلك من أنشطة الدعم للأعمال,142,9,0,0,151
2022,1,مكتب مكة المكرمة,الأنشطة الإيجارية,874,38,1,1,914
2022,1,مكتب مكة المكرمة,الأنشطة البيطرية,11,5,0,0,16
2022,1,مكتب مكة المكرمة,الأنشطة الرياضية وأنشطة التسلية والترفيه,67,26,0,0,93
2022,1,مكتب مكة المكرمة,الأنشطة العقارية,191,29,4,0,224
2022,1,مكتب مكة المكرمة,الأنشطة القانونية وأنشطة المحاسبة,40,3,0,0,43
2022,1,مكتب مكة المكرمة,الأنشطة المساعدة لأنشطة الخدمات المالية وأنشطة التأمين,11,11,1,0,23
2022,1,مكتب مكة المكرمة,الأنشطة المهنية والعلمية والتقنية الأخرى,57,12,0,0,69
2022,1,مكتب مكة المكرمة,الاتصالات,44,2,0,0,46
2022,1,مكتب مكة المكرمة,البحث والتطوير في المجال العلمي,1,0,0,0,1
2022,1,مكتب مكة المكرمة,التخزين وأنشطة الدعم للنقل,84,11,1,0,96
2022,1,مكتب مكة المكرمة,التعليم,62,47,21,2,132
2022,1,مكتب مكة المكرمة,الحراجة وقطع الأخشاب,1,1,0,0,2
2022,1,مكتب مكة المكرمة,الرعاية مع الإقامة,13,5,1,0,19
2022,1,مكتب مكة المكرمة,الصحة البشرية,76,117,33,3,229
2022,1,مكتب مكة المكرمة,الصرف الصحي,6,0,1,0,7
2022,1,مكتب مكة المكرمة,الصناعة التحويلية الأخرى,35,13,2,0,50
2022,1,مكتب مكة المكرمة,الطباعة واستنساخ وسائط الأعلام المسجّلة,62,21,3,0,86
2022,1,مكتب مكة المكرمة,النقل البري و النقل عبر الأنابيب,925,135,10,2,1072
2022,1,مكتب مكة المكرمة,النقل الجوي,20,4,1,0,25
2022,1,مكتب مكة المكرمة,النقل المائي,19,1,0,0,20
2022,1,مكتب مكة المكرمة,الهندسة المدنية,44,8,0,1,53
2022,1,مكتب مكة المكرمة,تجارة التجزئة، باستثناء المركبات ذات المحركات والدراجات النارية,5130,1098,60,4,6292
2022,1,مكتب مكة المكرمة,تجارة الجملة ، باستثناء المركبات ذات المحركات والدراجات النارية,1635,445,32,3,2115
2022,1,مكتب مكة المكرمة,تجارة الجملة والتجزئة ، وإصلاح المركبات ذات المحركات والدراجات النارية,1919,310,8,0,2237
2022,1,مكتب مكة المكرمة,تجميع المياه ومعالجتها وتوصيلها,59,24,0,1,84
2022,1,مكتب مكة المكرمة,تشييد المباني,5079,1706,157,13,6955
2022,1,مكتب مكة المكرمة,تعدين ركازات الفلزات,23,4,0,0,27
2022,1,مكتب مكة المكرمة,تمويل التأمين وإعادة التأمين وصناديق المعاشات التقاعدية باستثناء الضمان الاجتماعي الإلزامي,4,2,0,0,6
2022,1,مكتب مكة المكرمة,توصيل الكهرباء والغاز والبخار وتكييف الهواء,8,9,3,0,20
2022,1,مكتب مكة المكرمة,صناعة الآلات والمعدات غير المصنفة في موضع أخر,30,1,0,0,31
2022,1,مكتب مكة المكرمة,صناعة المركبات ذات المحركات والمركبات المقطورة ونصف المقطورة,43,5,1,0,49
2022,1,مكتب مكة المكرمة,صناعة معدات النقل الأخرى,14,0,0,1,15
2022,1,مكتب مكة المكرمة,صنع الأثاث,132,37,0,0,169
2022,1,مكتب مكة المكرمة,صنع الحواسيب والمنتجات الإلكترونية والبصرية,67,17,0,0,84
2022,1,مكتب مكة المكرمة,صُنع الخشب ومنتجات الخشب والفلين ، باستثناء الأثاث ، صُنع أصناف من القش ومواد الضفر,198,40,3,0,241
2022,1,مكتب مكة المكرمة,صنع الفلزات القاعدية,64,23,2,0,89
2022,1,مكتب مكة المكرمة,صُنع المشروبات,19,7,3,0,29
2022,1,مكتب مكة المكرمة,صنع المعدات الكهربائية,90,16,1,0,107
2022,1,مكتب مكة المكرمة,صُنع الملبوسات,678,90,0,0,768
2022,1,مكتب مكة المكرمة,صُنع المنتجات الجلدية والمنتجات ذات الصلة,15,3,0,0,18
2022,1,مكتب مكة المكرمة,صنع المنتجات الصيدلانية الأساسية والمستحضرات الصيدلانية,3,1,0,0,4
2022,1,مكتب مكة المكرمة,صُنع المنتجات الغذائية,519,152,18,2,691
2022,1,مكتب مكة المكرمة,صُنع المنسوجات,113,28,0,0,141
2022,1,مكتب مكة المكرمة,صُنع المواد الكيميائية والمنتجات الكيميائية,72,26,1,0,99
2022,1,مكتب مكة المكرمة,صُنع الورق ومنتجات الورق,4,4,0,0,8
2022,1,مكتب مكة المكرمة,صُنع منتجات التبغ,3,0,0,0,3
2022,1,مكتب مكة المكرمة,صنع منتجات المطاط واللدائن,14,10,2,1,27
2022,1,مكتب مكة المكرمة,صنع منتجات المعادن اللافلزية الأخرى,95,32,9,0,136
2022,1,مكتب مكة المكرمة,صنع منتجات المعادن المشكلة ( باستثناء الآلات والمعدات ),442,89,10,0,541
2022,1,مكتب مكة المكرمة,صيد الأسماك وتربية المائيات,58,15,1,0,74
2022,1,مكتب مكة المكرمة,وكالات السفر ومشغّلو الجولات السياحية وخدمات الحجز والأنشطة المتصلة بها,105,41,4,0,150
2022,1,مكتب منطقة الباحة,أبحاث الإعلان والسوق,3,2,0,0,5
2022,1,مكتب منطقة الباحة,إصلاح أجهزة الحاسوب والسلع الشخصية والمنزلية,37,3,0,0,40
2022,1,مكتب منطقة الباحة,إصلاح وتركيب الآلات والمعدات,11,4,0,0,15
2022,1,مكتب منطقة الباحة,أنشطة أنتاج الأفلام والبرامج التلفزيونية والتسجيلات الصوتية و نشرالموسيقى,2,0,0,0,2
2022,1,مكتب منطقة الباحة,أنشطة الأمن والتحقيقات,1,0,0,0,1
2022,1,مكتب منطقة الباحة,أنشطة الاستخدام,6,1,0,0,7
2022,1,مكتب منطقة الباحة,أنشطة البرمجة الحاسوبية والخبرة الاستشارية وما يتصل بها من أنشطة,1,0,0,0,1
2022,1,مكتب منطقة الباحة,أنشطة التشييد المتخصصة,450,71,0,1,522
2022,1,مكتب منطقة الباحة,أنشطة الخدمات الشخصية الأخرى,256,21,0,0,277
2022,1,مكتب منطقة الباحة,أنشطة الخدمات المالية ، فيما عدا تمويل التأمين وصناديق المعاشات,8,0,0,0,8
2022,1,مكتب منطقة الباحة,أنشطة العمل الاجتماعي، دون إقامة، لكبار السن وذوي الإعاقة,27,14,0,0,41
2022,1,مكتب منطقة الباحة,أنشطة المعمارية والهندسية ، والاختبارات الفنية والتحليل,82,38,5,0,125
2022,1,مكتب منطقة الباحة,أنشطة المكاتب الرئيسية ، وألأنشطة الاستشارية في مجال الإدارة,5,1,0,0,6
2022,1,مكتب منطقة الباحة,أنشطة المكتبات ودور المحفوظات، والمتاحف والأنشطة الثقافية الأخرى,7,2,0,0,9
2022,1,مكتب منطقة الباحة,أنشطة المنظمات الدولية,0,1,0,0,1
2022,1,مكتب منطقة الباحة,أنشطة المنظمات ذات العضوية,11,6,0,0,17
2022,1,مكتب منطقة الباحة,أنشطة النشر,6,1,0,0,7
2022,1,مكتب منطقة الباحة,أنشطة تقديم الخدمات للمباني وتجميل المواقع,53,6,1,0,60
2022,1,مكتب منطقة الباحة,أنشطة جمع النفايات ومعالجتها وتصريفها ، واسترجاع المواد,1,0,0,0,1
2022,1,مكتب منطقة الباحة,أنشطة خدمات الأطعمة والمشروبات,555,159,7,0,721
2022,1,مكتب منطقة الباحة,أنشطة خدمات المعلومات,2,0,0,0,2
2022,1,مكتب منطقة الباحة,أنشطة خدمات دعم التعدين,7,0,0,0,7
2022,1,مكتب منطقة الباحة,أنشطة زراعة المحاصيل والإنتاج الحيواني والصيد والخدمات المتصلة,202,5,0,0,207
2022,1,مكتب منطقة الباحة,الإدارة العامة والدفاع ؛ والضمان الاجتماعي الإلزامي,5,10,1,0,16
2022,1,مكتب منطقة الباحة,الإقامة,41,21,1,0,63
2022,1,مكتب منطقة الباحة,الأنشطة الإبداعية والفنون وأنشطة الترفيه,1,0,0,0,1
2022,1,مكتب منطقة الباحة,الأنشطة الأخرى للتعدين واستغلال المحاجر,1,3,0,0,4
2022,1,مكتب منطقة الباحة,الأنشطة الإدارية للمكاتب ، وأنشطة الدعم للمكاتب وغير ذلك من أنشطة الدعم للأعمال,19,0,0,0,19
2022,1,مكتب منطقة الباحة,الأنشطة الإيجارية,136,2,0,0,138
2022,1,مكتب منطقة الباحة,الأنشطة البيطرية,1,0,0,0,1
2022,1,مكتب منطقة الباحة,الأنشطة الرياضية وأنشطة التسلية والترفيه,24,1,0,0,25
2022,1,مكتب منطقة الباحة,الأنشطة العقارية,9,1,0,0,10
2022,1,مكتب منطقة الباحة,الأنشطة القانونية وأنشطة المحاسبة,5,0,0,0,5
2022,1,مكتب منطقة الباحة,الأنشطة المهنية والعلمية والتقنية الأخرى,6,1,0,0,7
2022,1,مكتب منطقة الباحة,الاتصالات,9,1,0,0,10
2022,1,مكتب منطقة الباحة,التخزين وأنشطة الدعم للنقل,27,3,0,0,30
2022,1,مكتب منطقة الباحة,التعليم,11,7,0,0,18
2022,1,مكتب منطقة الباحة,الرعاية مع الإقامة,2,5,0,0,7
2022,1,مكتب منطقة الباحة,الصحة البشرية,12,21,1,0,34
2022,1,مكتب منطقة الباحة,الصرف الصحي,1,0,0,0,1
2022,1,مكتب منطقة الباحة,الصناعة التحويلية الأخرى,6,0,0,0,6
2022,1,مكتب منطقة الباحة,الطباعة واستنساخ وسائط الأعلام المسجّلة,12,5,0,0,17
2022,1,مكتب منطقة الباحة,النقل البري و النقل عبر الأنابيب,142,20,0,0,162
2022,1,مكتب منطقة الباحة,النقل الجوي,0,2,0,0,2
2022,1,مكتب منطقة الباحة,الهندسة المدنية,7,3,0,0,10
2022,1,مكتب منطقة الباحة,تجارة التجزئة، باستثناء المركبات ذات المحركات والدراجات النارية,944,228,12,1,1185
2022,1,مكتب منطقة الباحة,تجارة الجملة ، باستثناء المركبات ذات المحركات والدراجات النارية,362,200,6,0,568
2022,1,مكتب منطقة الباحة,تجارة الجملة والتجزئة ، وإصلاح المركبات ذات المحركات والدراجات النارية,352,50,1,0,403
2022,1,مكتب منطقة الباحة,تجميع المياه ومعالجتها وتوصيلها,16,3,0,0,19
2022,1,مكتب منطقة الباحة,تشييد المباني,671,152,12,1,836
2022,1,مكتب منطقة الباحة,تعدين ركازات الفلزات,11,3,0,0,14
2022,1,مكتب منطقة الباحة,توصيل الكهرباء والغاز والبخار وتكييف الهواء,1,1,0,0,2
2022,1,مكتب منطقة الباحة,صناعة الآلات والمعدات غير المصنفة في موضع أخر,4,0,0,0,4
2022,1,مكتب منطقة الباحة,صناعة المركبات ذات المحركات والمركبات المقطورة ونصف المقطورة,4,0,0,0,4
2022,1,مكتب منطقة الباحة,صناعة معدات النقل الأخرى,4,0,0,0,4
2022,1,مكتب منطقة الباحة,صنع الأثاث,41,9,0,0,50
2022,1,مكتب منطقة الباحة,صنع الحواسيب والمنتجات الإلكترونية والبصرية,16,5,0,0,21
2022,1,مكتب منطقة الباحة,صُنع الخشب ومنتجات الخشب والفلين ، باستثناء الأثاث ، صُنع أصناف من القش ومواد الضفر,48,12,0,0,60
2022,1,مكتب منطقة الباحة,صنع الفلزات القاعدية,21,3,0,0,24
2022,1,مكتب منطقة الباحة,صُنع المشروبات,3,2,0,0,5
2022,1,مكتب منطقة الباحة,صنع المعدات الكهربائية,15,2,0,0,17
2022,1,مكتب منطقة الباحة,صُنع الملبوسات,107,15,0,0,122
2022,1,مكتب منطقة الباحة,صُنع المنتجات الجلدية والمنتجات ذات الصلة,1,0,0,0,1
2022,1,مكتب منطقة الباحة,صنع المنتجات الصيدلانية الأساسية والمستحضرات الصيدلانية,2,0,0,0,2
2022,1,مكتب منطقة الباحة,صُنع المنتجات الغذائية,92,15,0,0,107
2022,1,مكتب منطقة الباحة,صُنع المنسوجات,8,2,0,0,10
2022,1,مكتب منطقة الباحة,صُنع المواد الكيميائية والمنتجات الكيميائية,6,1,0,0,7
2022,1,مكتب منطقة الباحة,صُنع الورق ومنتجات الورق,2,0,0,0,2
2022,1,مكتب منطقة الباحة,صنع منتجات المطاط واللدائن,4,1,0,0,5
2022,1,مكتب منطقة الباحة,صنع منتجات المعادن اللافلزية الأخرى,40,15,4,0,59
2022,1,مكتب منطقة الباحة,صنع منتجات المعادن المشكلة ( باستثناء الآلات والمعدات ),112,17,0,0,129
2022,1,مكتب منطقة الباحة,صيد الأسماك وتربية المائيات,1,0,0,0,1
2022,1,مكتب منطقة الباحة,وكالات السفر ومشغّلو الجولات السياحية وخدمات الحجز والأنشطة المتصلة بها,2,0,0,0,2
2022,1,مكتب منطقة الجوف,أبحاث الإعلان والسوق,33,4,0,0,37
2022,1,مكتب منطقة الجوف,إصلاح أجهزة الحاسوب والسلع الشخصية والمنزلية,78,9,1,0,88
2022,1,مكتب منطقة الجوف,إصلاح وتركيب الآلات والمعدات,20,3,0,0,23
2022,1,مكتب منطقة الجوف,أنشطة أنتاج الأفلام والبرامج التلفزيونية والتسجيلات الصوتية و نشرالموسيقى,3,0,0,0,3
2022,1,مكتب منطقة الجوف,أنشطة الأمن والتحقيقات,2,2,0,0,4
2022,1,مكتب منطقة الجوف,أنشطة الاستخدام,13,1,0,0,14
2022,1,مكتب منطقة الجوف,أنشطة الاسر المعيشية التي تستخدم أفراداً للعمل المنزلي,0,1,0,0,1
2022,1,مكتب منطقة الجوف,أنشطة البرمجة الحاسوبية والخبرة الاستشارية وما يتصل بها من أنشطة,10,3,0,0,13
2022,1,مكتب منطقة الجوف,أنشطة البرمجة والإذاعة,1,0,0,0,1
2022,1,مكتب منطقة الجوف,أنشطة البريد ونقل الرسائل والطرود بواسطة مندوبين,1,0,0,0,1
2022,1,مكتب منطقة الجوف,أنشطة التشييد المتخصصة,676,180,8,0,864
2022,1,مكتب منطقة الجوف,أنشطة الخدمات الشخصية الأخرى,474,57,1,0,532
2022,1,مكتب منطقة الجوف,أنشطة الخدمات المالية ، فيما عدا تمويل التأمين وصناديق المعاشات,13,1,0,0,14
2022,1,مكتب منطقة الجوف,أنشطة العمل الاجتماعي، دون إقامة، لكبار السن وذوي الإعاقة,16,15,1,0,32
2022,1,مكتب منطقة الجوف,أنشطة المعمارية والهندسية ، والاختبارات الفنية والتحليل,103,35,2,0,140
2022,1,مكتب منطقة الجوف,أنشطة المكاتب الرئيسية ، وألأنشطة الاستشارية في مجال الإدارة,10,1,0,0,11
2022,1,مكتب منطقة الجوف,أنشطة المكتبات ودور المحفوظات، والمتاحف والأنشطة الثقافية الأخرى,11,5,0,0,16
2022,1,مكتب منطقة الجوف,أنشطة المنظمات ذات العضوية,14,5,0,0,19
2022,1,مكتب منطقة الجوف,أنشطة النشر,5,1,0,0,6
2022,1,مكتب منطقة الجوف,أنشطة تقديم الخدمات للمباني وتجميل المواقع,299,87,8,1,395
2022,1,مكتب منطقة الجوف,أنشطة جمع النفايات ومعالجتها وتصريفها ، واسترجاع المواد,1,1,0,0,2
2022,1,مكتب منطقة الجوف,أنشطة خدمات الأطعمة والمشروبات,842,194,6,0,1042
2022,1,مكتب منطقة الجوف,أنشطة خدمات المعلومات,5,2,0,0,7
2022,1,مكتب منطقة الجوف,أنشطة خدمات دعم التعدين,5,1,0,0,6
2022,1,مكتب منطقة الجوف,أنشطة زراعة المحاصيل والإنتاج الحيواني والصيد والخدمات المتصلة,429,26,0,2,457
2022,1,مكتب منطقة الجوف,الإدارة العامة والدفاع ؛ والضمان الاجتماعي الإلزامي,14,6,0,0,20
2022,1,مكتب منطقة الجوف,الإقامة,54,11,1,0,66
2022,1,مكتب منطقة الجوف,الأنشطة الإبداعية والفنون وأنشطة الترفيه,2,0,0,0,2
2022,1,مكتب منطقة الجوف,الأنشطة الأخرى للتعدين واستغلال المحاجر,6,0,0,0,6
2022,1,مكتب منطقة الجوف,الأنشطة الإدارية للمكاتب ، وأنشطة الدعم للمكاتب وغير ذلك من أنشطة الدعم للأعمال,24,1,0,0,25
2022,1,مكتب منطقة الجوف,الأنشطة الإيجارية,547,23,0,0,570
2022,1,مكتب منطقة الجوف,الأنشطة البيطرية,3,3,0,0,6
2022,1,مكتب منطقة الجوف,الأنشطة الرياضية وأنشطة التسلية والترفيه,38,5,0,0,43
2022,1,مكتب منطقة الجوف,الأنشطة العقارية,26,2,1,0,29
2022,1,مكتب منطقة الجوف,الأنشطة القانونية وأنشطة المحاسبة,8,1,0,0,9
2022,1,مكتب منطقة الجوف,الأنشطة المهنية والعلمية والتقنية الأخرى,12,2,0,0,14
2022,1,مكتب منطقة الجوف,الاتصالات,23,1,0,0,24
2022,1,مكتب منطقة الجوف,التخزين وأنشطة الدعم للنقل,110,15,3,0,128
2022,1,مكتب منطقة الجوف,التعليم,18,27,10,0,55
2022,1,مكتب منطقة الجوف,الحراجة وقطع الأخشاب,1,0,0,0,1
2022,1,مكتب منطقة الجوف,الرعاية مع الإقامة,6,2,0,0,8
2022,1,مكتب منطقة الجوف,الصحة البشرية,18,29,7,0,54
2022,1,مكتب منطقة الجوف,الصرف الصحي,3,1,0,0,4
2022,1,مكتب منطقة الجوف,الصناعة التحويلية الأخرى,6,0,0,0,6
2022,1,مكتب منطقة الجوف,الطباعة واستنساخ وسائط الأعلام المسجّلة,14,4,0,0,18
2022,1,مكتب منطقة الجوف,النقل البري و النقل عبر الأنابيب,435,65,0,0,500
2022,1,مكتب منطقة الجوف,النقل الجوي,14,0,0,0,14
2022,1,مكتب منطقة الجوف,الهندسة المدنية,12,4,0,0,16
2022,1,مكتب منطقة الجوف,تجارة التجزئة، باستثناء المركبات ذات المحركات والدراجات النارية,1131,222,8,1,1362
2022,1,مكتب منطقة الجوف,تجارة الجملة ، باستثناء المركبات ذات المحركات والدراجات النارية,363,85,3,1,452
2022,1,مكتب منطقة الجوف,تجارة الجملة والتجزئة ، وإصلاح المركبات ذات المحركات والدراجات النارية,508,107,1,0,616
2022,1,مكتب منطقة الجوف,تجميع المياه ومعالجتها وتوصيلها,8,1,0,0,9
2022,1,مكتب منطقة الجوف,تشييد المباني,857,187,17,1,1062
2022,1,مكتب منطقة الجوف,تعدين الفحم والليغنيت,1,1,0,0,2
2022,1,مكتب منطقة الجوف,تعدين ركازات الفلزات,6,1,0,0,7
2022,1,مكتب منطقة الجوف,توصيل الكهرباء والغاز والبخار وتكييف الهواء,7,1,0,0,8
2022,1,مكتب منطقة الجوف,صناعة الآلات والمعدات غير المصنفة في موضع أخر,15,0,0,0,15
2022,1,مكتب منطقة الجوف,صناعة المركبات ذات المحركات والمركبات المقطورة ونصف المقطورة,14,3,0,0,17
2022,1,مكتب منطقة الجوف,صناعة معدات النقل الأخرى,2,3,0,0,5
2022,1,مكتب منطقة الجوف,صنع الأثاث,87,12,0,0,99
2022,1,مكتب منطقة الجوف,صنع الحواسيب والمنتجات الإلكترونية والبصرية,12,1,0,0,13
2022,1,مكتب منطقة الجوف,صُنع الخشب ومنتجات الخشب والفلين ، باستثناء الأثاث ، صُنع أصناف من القش ومواد الضفر,45,3,0,0,48
2022,1,مكتب منطقة الجوف,صنع الفلزات القاعدية,36,9,0,0,45
2022,1,مكتب منطقة الجوف,صُنع المشروبات,6,4,1,1,12
2022,1,مكتب منطقة الجوف,صنع المعدات الكهربائية,26,3,0,0,29
2022,1,مكتب منطقة الجوف,صُنع الملبوسات,206,22,0,0,228
2022,1,مكتب منطقة الجوف,صُنع المنتجات الجلدية والمنتجات ذات الصلة,2,0,0,0,2
2022,1,مكتب منطقة الجوف,صنع المنتجات الصيدلانية الأساسية والمستحضرات الصيدلانية,2,1,0,0,3
2022,1,مكتب منطقة الجوف,صُنع المنتجات الغذائية,144,48,1,0,193
2022,1,مكتب منطقة الجوف,صُنع المنسوجات,27,9,0,0,36
2022,1,مكتب منطقة الجوف,صُنع المواد الكيميائية والمنتجات الكيميائية,24,2,0,0,26
2022,1,مكتب منطقة الجوف,صُنع الورق ومنتجات الورق,5,1,0,0,6
2022,1,مكتب منطقة الجوف,صنع منتجات المطاط واللدائن,4,4,0,0,8
2022,1,مكتب منطقة الجوف,صنع منتجات المعادن اللافلزية الأخرى,45,21,2,0,68
2022,1,مكتب منطقة الجوف,صنع منتجات المعادن المشكلة ( باستثناء الآلات والمعدات ),108,18,1,0,127
2022,1,مكتب منطقة الجوف,صيد الأسماك وتربية المائيات,0,1,0,0,1
2022,1,مكتب منطقة الجوف,وكالات السفر ومشغّلو الجولات السياحية وخدمات الحجز والأنشطة المتصلة بها,6,3,0,0,9
2022,1,مكتب منطقة الحدود الشمالية,أبحاث الإعلان والسوق,4,0,0,0,4
2022,1,مكتب منطقة الحدود الشمالية,إصلاح أجهزة الحاسوب والسلع الشخصية والمنزلية,41,4,0,0,45
2022,1,مكتب منطقة الحدود الشمالية,إصلاح وتركيب الآلات والمعدات,15,0,0,0,15
2022,1,مكتب منطقة الحدود الشمالية,أنشطة أنتاج الأفلام والبرامج التلفزيونية والتسجيلات الصوتية و نشرالموسيقى,1,0,0,0,1
2022,1,مكتب منطقة الحدود الشمالية,أنشطة الأمن والتحقيقات,0,2,1,1,4
2022,1,مكتب منطقة الحدود الشمالية,أنشطة الاستخدام,8,1,0,0,9
2022,1,مكتب منطقة الحدود الشمالية,أنشطة الاسر المعيشية التي تستخدم أفراداً للعمل المنزلي,1,0,0,0,1
2022,1,مكتب منطقة الحدود الشمالية,أنشطة البرمجة الحاسوبية والخبرة الاستشارية وما يتصل بها من أنشطة,5,0,0,0,5
2022,1,مكتب منطقة الحدود الشمالية,أنشطة البريد ونقل الرسائل والطرود بواسطة مندوبين,0,1,0,0,1
2022,1,مكتب منطقة الحدود الشمالية,أنشطة التشييد المتخصصة,317,47,2,0,366
2022,1,مكتب منطقة الحدود الشمالية,أنشطة الخدمات الشخصية الأخرى,399,29,0,0,428
2022,1,مكتب منطقة الحدود الشمالية,أنشطة الخدمات المالية ، فيما عدا تمويل التأمين وصناديق المعاشات,9,3,0,0,12
2022,1,مكتب منطقة الحدود الشمالية,أنشطة العمل الاجتماعي، دون إقامة، لكبار السن وذوي الإعاقة,13,10,0,0,23
2022,1,مكتب منطقة الحدود الشمالية,أنشطة المعمارية والهندسية ، والاختبارات الفنية والتحليل,109,31,1,0,141
2022,1,مكتب منطقة الحدود الشمالية,أنشطة المكاتب الرئيسية ، وألأنشطة الاستشارية في مجال الإدارة,8,2,0,0,10
2022,1,مكتب منطقة الحدود الشمالية,أنشطة المكتبات ودور المحفوظات، والمتاحف والأنشطة الثقافية الأخرى,11,3,0,0,14
2022,1,مكتب منطقة الحدود الشمالية,أنشطة المنظمات ذات العضوية,9,1,0,0,10
2022,1,مكتب منطقة الحدود الشمالية,أنشطة تقديم الخدمات للمباني وتجميل المواقع,109,17,0,0,126
2022,1,مكتب منطقة الحدود الشمالية,أنشطة خدمات الأطعمة والمشروبات,784,138,3,0,925
2022,1,مكتب منطقة الحدود الشمالية,أنشطة خدمات المعلومات,1,2,0,0,3
2022,1,مكتب منطقة الحدود الشمالية,أنشطة خدمات دعم التعدين,1,1,0,0,2
2022,1,مكتب منطقة الحدود الشمالية,أنشطة زراعة المحاصيل والإنتاج الحيواني والصيد والخدمات المتصلة,107,4,0,0,111
2022,1,مكتب منطقة الحدود الشمالية,الإدارة العامة والدفاع ؛ والضمان الاجتماعي الإلزامي,5,1,0,0,6
2022,1,مكتب منطقة الحدود الشمالية,الإقامة,21,11,1,0,33
2022,1,مكتب منطقة الحدود الشمالية,الأنشطة الإبداعية والفنون وأنشطة الترفيه,3,0,0,0,3
2022,1,مكتب منطقة الحدود الشمالية,الأنشطة الأخرى للتعدين واستغلال المحاجر,3,1,0,1,5
2022,1,مكتب منطقة الحدود الشمالية,الأنشطة الإدارية للمكاتب ، وأنشطة الدعم للمكاتب وغير ذلك من أنشطة الدعم للأعمال,31,0,0,0,31
2022,1,مكتب منطقة الحدود الشمالية,الأنشطة الإيجارية,205,6,0,0,211
2022,1,مكتب منطقة الحدود الشمالية,الأنشطة البيطرية,6,1,0,0,7
2022,1,مكتب منطقة الحدود الشمالية,الأنشطة الرياضية وأنشطة التسلية والترفيه,28,7,0,0,35
2022,1,مكتب منطقة الحدود الشمالية,الأنشطة العقارية,26,3,0,0,29
2022,1,مكتب منطقة الحدود الشمالية,الأنشطة القانونية وأنشطة المحاسبة,5,0,0,0,5
2022,1,مكتب منطقة الحدود الشمالية,الأنشطة المهنية والعلمية والتقنية الأخرى,5,1,0,0,6
2022,1,مكتب منطقة الحدود الشمالية,الاتصالات,6,1,0,0,7
2022,1,مكتب منطقة الحدود الشمالية,التخزين وأنشطة الدعم للنقل,24,5,1,0,30
2022,1,مكتب منطقة الحدود الشمالية,التعليم,13,20,4,0,37
2022,1,مكتب منطقة الحدود الشمالية,الرعاية مع الإقامة,3,1,0,0,4
2022,1,مكتب منطقة الحدود الشمالية,الصحة البشرية,17,23,2,0,42
2022,1,مكتب منطقة الحدود الشمالية,الصناعة التحويلية الأخرى,4,1,0,0,5
2022,1,مكتب منطقة الحدود الشمالية,الطباعة واستنساخ وسائط الأعلام المسجّلة,10,2,0,0,12
2022,1,مكتب منطقة الحدود الشمالية,النقل البري و النقل عبر الأنابيب,311,38,0,0,349
2022,1,مكتب منطقة الحدود الشمالية,النقل الجوي,1,2,0,1,4
2022,1,مكتب منطقة الحدود الشمالية,النقل المائي,3,0,0,0,3
2022,1,مكتب منطقة الحدود الشمالية,الهندسة المدنية,8,0,0,0,8
2022,1,مكتب منطقة الحدود الشمالية,تجارة التجزئة، باستثناء المركبات ذات المحركات والدراجات النارية,804,109,10,0,923
2022,1,مكتب منطقة الحدود الشمالية,تجارة الجملة ، باستثناء المركبات ذات المحركات والدراجات النارية,215,32,1,0,248
2022,1,مكتب منطقة الحدود الشمالية,تجارة الجملة والتجزئة ، وإصلاح المركبات ذات المحركات والدراجات النارية,424,62,1,0,487
2022,1,مكتب منطقة الحدود الشمالية,تجميع المياه ومعالجتها وتوصيلها,8,4,0,0,12
2022,1,مكتب منطقة الحدود الشمالية,تشييد المباني,1194,224,21,4,1443
2022,1,مكتب منطقة الحدود الشمالية,تعدين ركازات الفلزات,8,0,0,0,8
2022,1,مكتب منطقة الحدود الشمالية,توصيل الكهرباء والغاز والبخار وتكييف الهواء,3,1,0,0,4
2022,1,مكتب منطقة الحدود الشمالية,صناعة الآلات والمعدات غير المصنفة في موضع أخر,7,0,0,0,7
2022,1,مكتب منطقة الحدود الشمالية,صناعة المركبات ذات المحركات والمركبات المقطورة ونصف المقطورة,11,1,0,0,12
2022,1,مكتب منطقة الحدود الشمالية,صناعة معدات النقل الأخرى,3,1,0,0,4
2022,1,مكتب منطقة الحدود الشمالية,صنع الأثاث,45,8,0,0,53
2022,1,مكتب منطقة الحدود الشمالية,صنع الحواسيب والمنتجات الإلكترونية والبصرية,13,4,0,0,17
2022,1,مكتب منطقة الحدود الشمالية,صُنع الخشب ومنتجات الخشب والفلين ، باستثناء الأثاث ، صُنع أصناف من القش ومواد الضفر,38,5,0,0,43
2022,1,مكتب منطقة الحدود الشمالية,صنع الفلزات القاعدية,22,6,0,0,28
2022,1,مكتب منطقة الحدود الشمالية,صُنع المشروبات,2,3,0,0,5
2022,1,مكتب منطقة الحدود الشمالية,صنع المعدات الكهربائية,39,5,0,0,44
2022,1,مكتب منطقة الحدود الشمالية,صُنع الملبوسات,213,12,1,0,226
2022,1,مكتب منطقة الحدود الشمالية,صُنع المنتجات الجلدية والمنتجات ذات الصلة,5,1,0,0,6
2022,1,مكتب منطقة الحدود الشمالية,صنع المنتجات الصيدلانية الأساسية والمستحضرات الصيدلانية,0,1,0,0,1
2022,1,مكتب منطقة الحدود الشمالية,صُنع المنتجات الغذائية,111,30,0,0,141
2022,1,مكتب منطقة الحدود الشمالية,صُنع المنسوجات,21,1,0,0,22
2022,1,مكتب منطقة الحدود الشمالية,صُنع المواد الكيميائية والمنتجات الكيميائية,13,1,0,0,14
2022,1,مكتب منطقة الحدود الشمالية,صُنع الورق ومنتجات الورق,1,1,0,0,2
2022,1,مكتب منطقة الحدود الشمالية,صنع فحم الكوك والمنتجات النفطية المكررة,1,0,0,0,1
2022,1,مكتب منطقة الحدود الشمالية,صنع منتجات المطاط واللدائن,1,3,0,0,4
2022,1,مكتب منطقة الحدود الشمالية,صنع منتجات المعادن اللافلزية الأخرى,35,13,0,1,49
2022,1,مكتب منطقة الحدود الشمالية,صنع منتجات المعادن المشكلة ( باستثناء الآلات والمعدات ),52,3,0,0,55
2022,1,مكتب منطقة الحدود الشمالية,وكالات السفر ومشغّلو الجولات السياحية وخدمات الحجز والأنشطة المتصلة بها,1,2,0,0,3
2022,1,مكتب منطقة الرياض,أبحاث الإعلان والسوق,442,110,0,0,552
2022,1,مكتب منطقة الرياض,إصلاح أجهزة الحاسوب والسلع الشخصية والمنزلية,833,188,28,7,1056
2022,1,مكتب منطقة الرياض,إصلاح وتركيب الآلات والمعدات,491,95,9,5,600
2022,1,مكتب منطقة الرياض,أنشطة أنتاج الأفلام والبرامج التلفزيونية والتسجيلات الصوتية و نشرالموسيقى,191,85,4,3,283
2022,1,مكتب منطقة الرياض,أنشطة الأمن والتحقيقات,91,42,19,10,162
2022,1,مكتب منطقة الرياض,أنشطة الاستخدام,412,91,16,24,543
2022,1,مكتب منطقة الرياض,أنشطة الاسر المعيشية التي تستخدم أفراداً للعمل المنزلي,13,1,0,0,14
2022,1,مكتب منطقة الرياض,أنشطة البرمجة الحاسوبية والخبرة الاستشارية وما يتصل بها من أنشطة,806,393,48,9,1256
2022,1,مكتب منطقة الرياض,أنشطة البرمجة والإذاعة,11,1,0,0,12
2022,1,مكتب منطقة الرياض,أنشطة البريد ونقل الرسائل والطرود بواسطة مندوبين,132,26,6,0,164
2022,1,مكتب منطقة الرياض,أنشطة التشييد المتخصصة,9619,3174,323,50,13166
2022,1,مكتب منطقة الرياض,أنشطة الخدمات الشخصية الأخرى,5750,1476,127,37,7390
2022,1,مكتب منطقة الرياض,أنشطة الخدمات المالية ، فيما عدا تمويل التأمين وصناديق المعاشات,253,110,14,12,389
2022,1,مكتب منطقة الرياض,أنشطة العمل الاجتماعي، دون إقامة، لكبار السن وذوي الإعاقة,164,155,25,1,345
2022,1,مكتب منطقة الرياض,أنشطة المعالجة وخدمات إدارة النفايات الأخرى,8,1,1,0,10
2022,1,مكتب منطقة الرياض,أنشطة المعمارية والهندسية ، والاختبارات الفنية والتحليل,658,408,88,20,1174
2022,1,مكتب منطقة الرياض,أنشطة المكاتب الرئيسية ، وألأنشطة الاستشارية في مجال الإدارة,889,319,33,8,1249
2022,1,مكتب منطقة الرياض,أنشطة المكتبات ودور المحفوظات، والمتاحف والأنشطة الثقافية الأخرى,100,43,2,0,145
2022,1,مكتب منطقة الرياض,أنشطة المنظمات الدولية,6,4,1,0,11
2022,1,مكتب منطقة الرياض,أنشطة المنظمات ذات العضوية,177,47,3,0,227
2022,1,مكتب منطقة الرياض,أنشطة النشر,182,66,5,1,254
2022,1,مكتب منطقة الرياض,أنشطة تقديم الخدمات للمباني وتجميل المواقع,5549,3143,580,118,9390
2022,1,مكتب منطقة الرياض,أنشطة جمع النفايات ومعالجتها وتصريفها ، واسترجاع المواد,26,7,4,4,41
2022,1,مكتب منطقة الرياض,أنشطة خدمات الأطعمة والمشروبات,8976,3318,424,76,12794
2022,1,مكتب منطقة الرياض,أنشطة خدمات المعلومات,232,89,9,2,332
2022,1,مكتب منطقة الرياض,أنشطة خدمات دعم التعدين,74,36,8,2,120
2022,1,مكتب منطقة الرياض,أنشطة زراعة المحاصيل والإنتاج الحيواني والصيد والخدمات المتصلة,2529,291,87,15,2922
2022,1,مكتب منطقة الرياض,استخراج النفط الخام والغاز الطبيعي,3,0,0,0,3
2022,1,مكتب منطقة الرياض,الإدارة العامة والدفاع ؛ والضمان الاجتماعي الإلزامي,341,215,46,15,617
2022,1,مكتب منطقة الرياض,الإقامة,560,321,81,9,971
2022,1,مكتب منطقة الرياض,الأنشطة الإبداعية والفنون وأنشطة الترفيه,103,23,4,1,131
2022,1,مكتب منطقة الرياض,الأنشطة الأخرى للتعدين واستغلال المحاجر,110,56,14,3,183
2022,1,مكتب منطقة الرياض,الأنشطة الإدارية للمكاتب ، وأنشطة الدعم للمكاتب وغير ذلك من أنشطة الدعم للأعمال,716,120,14,3,853
2022,1,مكتب منطقة الرياض,الأنشطة الإيجارية,51626,1046,41,3,52716
2022,1,مكتب منطقة الرياض,الأنشطة البيطرية,45,45,4,0,94
2022,1,مكتب منطقة الرياض,الأنشطة الرياضية وأنشطة التسلية والترفيه,469,164,19,5,657
2022,1,مكتب منطقة الرياض,الأنشطة العقارية,1122,452,67,8,1649
2022,1,مكتب منطقة الرياض,الأنشطة القانونية وأنشطة المحاسبة,482,195,11,2,690
2022,1,مكتب منطقة الرياض,الأنشطة المساعدة لأنشطة الخدمات المالية وأنشطة التأمين,77,76,14,2,169
2022,1,مكتب منطقة الرياض,الأنشطة المهنية والعلمية والتقنية الأخرى,352,49,3,0,404
2022,1,مكتب منطقة الرياض,الأنشطة غير المتميزة لإنتاج السلع والخدمات التي تقوم بها الأسر المعيشية الخاصة لإستعمالها الخاص,2,0,0,0,2
2022,1,مكتب منطقة الرياض,الاتصالات,372,164,22,13,571
2022,1,مكتب منطقة الرياض,البحث والتطوير في المجال العلمي,27,9,1,1,38
2022,1,مكتب منطقة الرياض,التخزين وأنشطة الدعم للنقل,827,234,51,17,1129
2022,1,مكتب منطقة الرياض,التعليم,682,402,165,47,1296
2022,1,مكتب منطقة الرياض,الحراجة وقطع الأخشاب,5,5,2,0,12
2022,1,مكتب منطقة الرياض,الرعاية مع الإقامة,35,19,1,0,55
2022,1,مكتب منطقة الرياض,الصحة البشرية,441,609,191,59,1300
2022,1,مكتب منطقة الرياض,الصرف الصحي,34,16,3,2,55
2022,1,مكتب منطقة الرياض,الصناعة التحويلية الأخرى,171,96,18,4,289
2022,1,مكتب منطقة الرياض,الطباعة واستنساخ وسائط الأعلام المسجّلة,329,205,22,6,562
2022,1,مكتب منطقة الرياض,النقل البري و النقل عبر الأنابيب,8567,650,72,16,9305
2022,1,مكتب منطقة الرياض,النقل الجوي,281,74,35,18,408
2022,1,مكتب منطقة الرياض,النقل المائي,86,17,3,0,106
2022,1,مكتب منطقة الرياض,الهندسة المدنية,254,89,24,7,374
2022,1,مكتب منطقة الرياض,تجارة التجزئة، باستثناء المركبات ذات المحركات والدراجات النارية,18228,5820,781,147,24976
2022,1,مكتب منطقة الرياض,تجارة الجملة ، باستثناء المركبات ذات المحركات والدراجات النارية,10998,5376,773,189,17336
2022,1,مكتب منطقة الرياض,تجارة الجملة والتجزئة ، وإصلاح المركبات ذات المحركات والدراجات النارية,6306,1503,70,8,7887
2022,1,مكتب منطقة الرياض,تجميع المياه ومعالجتها وتوصيلها,100,30,7,0,137
2022,1,مكتب منطقة الرياض,تشييد المباني,10456,4678,1015,355,16504
2022,1,مكتب منطقة الرياض,تعدين الفحم والليغنيت,6,1,1,0,8
2022,1,مكتب منطقة الرياض,تعدين ركازات الفلزات,49,39,0,1,89
2022,1,مكتب منطقة الرياض,تمويل التأمين وإعادة التأمين وصناديق المعاشات التقاعدية باستثناء الضمان الاجتماعي الإلزامي,52,52,17,8,129
2022,1,مكتب منطقة الرياض,توصيل الكهرباء والغاز والبخار وتكييف الهواء,93,70,23,16,202
2022,1,مكتب منطقة الرياض,صناعة الآلات والمعدات غير المصنفة في موضع أخر,160,52,9,2,223
2022,1,مكتب منطقة الرياض,صناعة المركبات ذات المحركات والمركبات المقطورة ونصف المقطورة,90,58,3,1,152
2022,1,مكتب منطقة الرياض,صناعة معدات النقل الأخرى,109,48,8,1,166
2022,1,مكتب منطقة الرياض,صنع الأثاث,824,383,37,4,1248
2022,1,مكتب منطقة الرياض,صنع الحواسيب والمنتجات الإلكترونية والبصرية,253,128,30,8,419
2022,1,مكتب منطقة الرياض,صُنع الخشب ومنتجات الخشب والفلين ، باستثناء الأثاث ، صُنع أصناف من القش ومواد الضفر,667,236,35,9,947
2022,1,مكتب منطقة الرياض,صنع الفلزات القاعدية,478,282,73,17,850
2022,1,مكتب منطقة الرياض,صُنع المشروبات,62,35,17,6,120
2022,1,مكتب منطقة الرياض,صنع المعدات الكهربائية,221,122,27,6,376
2022,1,مكتب منطقة الرياض,صُنع الملبوسات,2035,458,25,1,2519
2022,1,مكتب منطقة الرياض,صُنع المنتجات الجلدية والمنتجات ذات الصلة,63,16,1,0,80
2022,1,مكتب منطقة الرياض,صنع المنتجات الصيدلانية الأساسية والمستحضرات الصيدلانية,50,25,4,0,79
2022,1,مكتب منطقة الرياض,صُنع المنتجات الغذائية,1210,511,75,26,1822
2022,1,مكتب منطقة الرياض,صُنع المنسوجات,174,76,13,9,272
2022,1,مكتب منطقة الرياض,صُنع المواد الكيميائية والمنتجات الكيميائية,361,204,32,2,599
2022,1,مكتب منطقة الرياض,صُنع الورق ومنتجات الورق,67,49,8,0,124
2022,1,مكتب منطقة الرياض,صنع فحم الكوك والمنتجات النفطية المكررة,25,12,1,0,38
2022,1,مكتب منطقة الرياض,صُنع منتجات التبغ,1,0,0,0,1
2022,1,مكتب منطقة الرياض,صنع منتجات المطاط واللدائن,264,180,83,13,540
2022,1,مكتب منطقة الرياض,صنع منتجات المعادن اللافلزية الأخرى,895,495,90,21,1501
2022,1,مكتب منطقة الرياض,صنع منتجات المعادن المشكلة ( باستثناء الآلات والمعدات ),896,453,97,24,1470
2022,1,مكتب منطقة الرياض,صيد الأسماك وتربية المائيات,24,3,1,1,29
2022,1,مكتب منطقة الرياض,وكالات السفر ومشغّلو الجولات السياحية وخدمات الحجز والأنشطة المتصلة بها,223,103,15,5,346
2022,1,مكتب منطقة القصيم,أبحاث الإعلان والسوق,30,6,0,0,36
2022,1,مكتب منطقة القصيم,إصلاح أجهزة الحاسوب والسلع الشخصية والمنزلية,272,39,3,0,314
2022,1,مكتب منطقة القصيم,إصلاح وتركيب الآلات والمعدات,90,9,0,0,99
2022,1,مكتب منطقة القصيم,أنشطة أنتاج الأفلام والبرامج التلفزيونية والتسجيلات الصوتية و نشرالموسيقى,11,2,0,0,13
2022,1,مكتب منطقة القصيم,أنشطة الأمن والتحقيقات,4,4,0,0,8
2022,1,مكتب منطقة القصيم,أنشطة الاستخدام,22,10,1,0,33
2022,1,مكتب منطقة القصيم,أنشطة الاسر المعيشية التي تستخدم أفراداً للعمل المنزلي,8,1,0,0,9
2022,1,مكتب منطقة القصيم,أنشطة البرمجة الحاسوبية والخبرة الاستشارية وما يتصل بها من أنشطة,38,9,0,0,47
2022,1,مكتب منطقة القصيم,أنشطة البرمجة والإذاعة,1,0,0,0,1
2022,1,مكتب منطقة القصيم,أنشطة البريد ونقل الرسائل والطرود بواسطة مندوبين,3,0,0,0,3
2022,1,مكتب منطقة القصيم,أنشطة التشييد المتخصصة,3381,602,86,3,4072
2022,1,مكتب منطقة القصيم,أنشطة الخدمات الشخصية الأخرى,1287,127,9,1,1424
2022,1,مكتب منطقة القصيم,أنشطة الخدمات المالية ، فيما عدا تمويل التأمين وصناديق المعاشات,29,2,0,1,32
2022,1,مكتب منطقة القصيم,أنشطة العمل الاجتماعي، دون إقامة، لكبار السن وذوي الإعاقة,56,48,4,0,108
2022,1,مكتب منطقة القصيم,أنشطة المعمارية والهندسية ، والاختبارات الفنية والتحليل,220,75,9,0,304
2022,1,مكتب منطقة القصيم,أنشطة المكاتب الرئيسية ، وألأنشطة الاستشارية في مجال الإدارة,61,17,2,0,80
2022,1,مكتب منطقة القصيم,أنشطة المكتبات ودور المحفوظات، والمتاحف والأنشطة الثقافية الأخرى,22,13,0,0,35
2022,1,مكتب منطقة القصيم,أنشطة المنظمات الدولية,2,0,0,0,2
2022,1,مكتب منطقة القصيم,أنشطة المنظمات ذات العضوية,34,13,1,0,48
2022,1,مكتب منطقة القصيم,أنشطة النشر,17,6,0,0,23
2022,1,مكتب منطقة القصيم,أنشطة تقديم الخدمات للمباني وتجميل المواقع,1300,287,48,12,1647
2022,1,مكتب منطقة القصيم,أنشطة جمع النفايات ومعالجتها وتصريفها ، واسترجاع المواد,4,2,0,0,6
2022,1,مكتب منطقة القصيم,أنشطة خدمات الأطعمة والمشروبات,2906,902,63,3,3874
2022,1,مكتب منطقة القصيم,أنشطة خدمات المعلومات,14,3,0,0,17
2022,1,مكتب منطقة القصيم,أنشطة خدمات دعم التعدين,7,2,0,0,9
2022,1,مكتب منطقة القصيم,أنشطة زراعة المحاصيل والإنتاج الحيواني والصيد والخدمات المتصلة,920,91,13,6,1030
2022,1,مكتب منطقة القصيم,الإدارة العامة والدفاع ؛ والضمان الاجتماعي الإلزامي,31,27,2,0,60
2022,1,مكتب منطقة القصيم,الإقامة,91,48,7,1,147
2022,1,مكتب منطقة القصيم,الأنشطة الإبداعية والفنون وأنشطة الترفيه,8,3,0,0,11
2022,1,مكتب منطقة القصيم,الأنشطة الأخرى للتعدين واستغلال المحاجر,11,1,0,0,12
2022,1,مكتب منطقة القصيم,الأنشطة الإدارية للمكاتب ، وأنشطة الدعم للمكاتب وغير ذلك من أنشطة الدعم للأعمال,69,10,4,0,83
2022,1,مكتب منطقة القصيم,الأنشطة الإيجارية,1053,62,5,0,1120
2022,1,مكتب منطقة القصيم,الأنشطة البيطرية,10,5,1,0,16
2022,1,مكتب منطقة القصيم,الأنشطة الرياضية وأنشطة التسلية والترفيه,71,31,0,0,102
2022,1,مكتب منطقة القصيم,الأنشطة العقارية,99,15,0,0,114
2022,1,مكتب منطقة القصيم,الأنشطة القانونية وأنشطة المحاسبة,34,1,0,0,35
2022,1,مكتب منطقة القصيم,الأنشطة المساعدة لأنشطة الخدمات المالية وأنشطة التأمين,1,0,0,0,1
2022,1,مكتب منطقة القصيم,الأنشطة المهنية والعلمية والتقنية الأخرى,21,5,0,0,26
2022,1,مكتب منطقة القصيم,الاتصالات,81,22,1,0,104
2022,1,مكتب منطقة القصيم,البحث والتطوير في المجال العلمي,2,0,0,0,2
2022,1,مكتب منطقة القصيم,التخزين وأنشطة الدعم للنقل,108,32,6,0,146
2022,1,مكتب منطقة القصيم,التعليم,53,38,18,2,111
2022,1,مكتب منطقة القصيم,الحراجة وقطع الأخشاب,4,0,0,0,4
2022,1,مكتب منطقة القصيم,الرعاية مع الإقامة,11,5,0,0,16
2022,1,مكتب منطقة القصيم,الصحة البشرية,38,82,26,4,150
2022,1,مكتب منطقة القصيم,الصرف الصحي,2,1,0,0,3
2022,1,مكتب منطقة القصيم,الصناعة التحويلية الأخرى,30,5,0,0,35
2022,1,مكتب منطقة القصيم,الطباعة واستنساخ وسائط الأعلام المسجّلة,54,25,1,0,80
2022,1,مكتب منطقة القصيم,النقل البري و النقل عبر الأنابيب,838,159,11,2,1010
2022,1,مكتب منطقة القصيم,النقل الجوي,11,9,2,2,24
2022,1,مكتب منطقة القصيم,النقل المائي,10,1,0,0,11
2022,1,مكتب منطقة القصيم,الهندسة المدنية,34,9,5,1,49
2022,1,مكتب منطقة القصيم,تجارة التجزئة، باستثناء المركبات ذات المحركات والدراجات النارية,3171,658,53,7,3889
2022,1,مكتب منطقة القصيم,تجارة الجملة ، باستثناء المركبات ذات المحركات والدراجات النارية,1637,558,60,6,2261
2022,1,مكتب منطقة القصيم,تجارة الجملة والتجزئة ، وإصلاح المركبات ذات المحركات والدراجات النارية,2142,416,17,2,2577
2022,1,مكتب منطقة القصيم,تجميع المياه ومعالجتها وتوصيلها,32,6,0,0,38
2022,1,مكتب منطقة القصيم,تشييد المباني,7212,1896,259,40,9407
2022,1,مكتب منطقة القصيم,تعدين الفحم والليغنيت,2,0,0,0,2
2022,1,مكتب منطقة القصيم,تعدين ركازات الفلزات,40,12,1,0,53
2022,1,مكتب منطقة القصيم,تمويل التأمين وإعادة التأمين وصناديق المعاشات التقاعدية باستثناء الضمان الاجتماعي الإلزامي,2,2,0,0,4
2022,1,مكتب منطقة القصيم,توصيل الكهرباء والغاز والبخار وتكييف الهواء,12,3,0,0,15
2022,1,مكتب منطقة القصيم,صناعة الآلات والمعدات غير المصنفة في موضع أخر,36,8,2,0,46
2022,1,مكتب منطقة القصيم,صناعة المركبات ذات المحركات والمركبات المقطورة ونصف المقطورة,30,6,1,0,37
2022,1,مكتب منطقة القصيم,صناعة معدات النقل الأخرى,18,6,0,0,24
2022,1,مكتب منطقة القصيم,صنع الأثاث,179,60,7,0,246
2022,1,مكتب منطقة القصيم,صنع الحواسيب والمنتجات الإلكترونية والبصرية,54,12,1,0,67
2022,1,مكتب منطقة القصيم,صُنع الخشب ومنتجات الخشب والفلين ، باستثناء الأثاث ، صُنع أصناف من القش ومواد الضفر,242,47,4,1,294
2022,1,مكتب منطقة القصيم,صنع الفلزات القاعدية,232,40,3,0,275
2022,1,مكتب منطقة القصيم,صُنع المشروبات,12,10,3,1,26
2022,1,مكتب منطقة القصيم,صنع المعدات الكهربائية,84,15,3,0,102
2022,1,مكتب منطقة القصيم,صُنع الملبوسات,540,78,6,1,625
2022,1,مكتب منطقة القصيم,صُنع المنتجات الجلدية والمنتجات ذات الصلة,6,1,0,0,7
2022,1,مكتب منطقة القصيم,صنع المنتجات الصيدلانية الأساسية والمستحضرات الصيدلانية,3,4,1,0,8
2022,1,مكتب منطقة القصيم,صُنع المنتجات الغذائية,378,93,32,5,508
2022,1,مكتب منطقة القصيم,صُنع المنسوجات,84,20,1,0,105
2022,1,مكتب منطقة القصيم,صُنع المواد الكيميائية والمنتجات الكيميائية,52,16,3,0,71
2022,1,مكتب منطقة القصيم,صُنع الورق ومنتجات الورق,6,8,4,0,18
2022,1,مكتب منطقة القصيم,صنع فحم الكوك والمنتجات النفطية المكررة,2,0,0,0,2
2022,1,مكتب منطقة القصيم,صُنع منتجات التبغ,2,0,0,0,2
2022,1,مكتب منطقة القصيم,صنع منتجات المطاط واللدائن,24,21,9,1,55
2022,1,مكتب منطقة القصيم,صنع منتجات المعادن اللافلزية الأخرى,144,58,15,3,220
2022,1,مكتب منطقة القصيم,صنع منتجات المعادن المشكلة ( باستثناء الآلات والمعدات ),613,104,8,3,728
2022,1,مكتب منطقة القصيم,صيد الأسماك وتربية المائيات,4,1,0,0,5
2022,1,مكتب منطقة القصيم,وكالات السفر ومشغّلو الجولات السياحية وخدمات الحجز والأنشطة المتصلة بها,38,13,0,0,51
2022,1,مكتب منطقة المدينة المنورة,أبحاث الإعلان والسوق,37,5,0,0,42
2022,1,مكتب منطقة المدينة المنورة,إصلاح أجهزة الحاسوب والسلع الشخصية والمنزلية,151,11,0,0,162
2022,1,مكتب منطقة المدينة المنورة,إصلاح وتركيب الآلات والمعدات,64,6,0,0,70
2022,1,مكتب منطقة المدينة المنورة,أنشطة أنتاج الأفلام والبرامج التلفزيونية والتسجيلات الصوتية و نشرالموسيقى,13,2,0,0,15
2022,1,مكتب منطقة المدينة المنورة,أنشطة الأمن والتحقيقات,6,2,1,0,9
2022,1,مكتب منطقة المدينة المنورة,أنشطة الاستخدام,33,12,0,0,45
2022,1,مكتب منطقة المدينة المنورة,أنشطة الاسر المعيشية التي تستخدم أفراداً للعمل المنزلي,4,0,0,0,4
2022,1,مكتب منطقة المدينة المنورة,أنشطة البرمجة الحاسوبية والخبرة الاستشارية وما يتصل بها من أنشطة,53,8,0,0,61
2022,1,مكتب منطقة المدينة المنورة,أنشطة البرمجة والإذاعة,4,0,0,0,4
2022,1,مكتب منطقة المدينة المنورة,أنشطة البريد ونقل الرسائل والطرود بواسطة مندوبين,6,1,0,0,7
2022,1,مكتب منطقة المدينة المنورة,أنشطة التشييد المتخصصة,1627,346,11,0,1984
2022,1,مكتب منطقة المدينة المنورة,أنشطة الخدمات الشخصية الأخرى,1447,147,3,0,1597
2022,1,مكتب منطقة المدينة المنورة,أنشطة الخدمات المالية ، فيما عدا تمويل التأمين وصناديق المعاشات,27,2,0,0,29
2022,1,مكتب منطقة المدينة المنورة,أنشطة العمل الاجتماعي، دون إقامة، لكبار السن وذوي الإعاقة,64,36,10,0,110
2022,1,مكتب منطقة المدينة المنورة,أنشطة المعمارية والهندسية ، والاختبارات الفنية والتحليل,84,54,4,1,143
2022,1,مكتب منطقة المدينة المنورة,أنشطة المكاتب الرئيسية ، وألأنشطة الاستشارية في مجال الإدارة,59,10,1,0,70
2022,1,مكتب منطقة المدينة المنورة,أنشطة المكتبات ودور المحفوظات، والمتاحف والأنشطة الثقافية الأخرى,65,19,0,0,84
2022,1,مكتب منطقة المدينة المنورة,أنشطة المنظمات ذات العضوية,14,5,2,0,21
2022,1,مكتب منطقة المدينة المنورة,أنشطة النشر,34,12,0,0,46
2022,1,مكتب منطقة المدينة المنورة,أنشطة تقديم الخدمات للمباني وتجميل المواقع,841,220,17,2,1080
2022,1,مكتب منطقة المدينة المنورة,أنشطة جمع النفايات ومعالجتها وتصريفها ، واسترجاع المواد,4,2,0,0,6
2022,1,مكتب منطقة المدينة المنورة,أنشطة خدمات الأطعمة والمشروبات,3093,776,39,3,3911
2022,1,مكتب منطقة المدينة المنورة,أنشطة خدمات المعلومات,15,5,0,0,20
2022,1,مكتب منطقة المدينة المنورة,أنشطة خدمات دعم التعدين,6,8,0,0,14
2022,1,مكتب منطقة المدينة المنورة,أنشطة زراعة المحاصيل والإنتاج الحيواني والصيد والخدمات المتصلة,470,60,4,0,534
2022,1,مكتب منطقة المدينة المنورة,الإدارة العامة والدفاع ؛ والضمان الاجتماعي الإلزامي,48,24,2,0,74
2022,1,مكتب منطقة المدينة المنورة,الإقامة,197,106,31,5,339
2022,1,مكتب منطقة المدينة المنورة,الأنشطة الإبداعية والفنون وأنشطة الترفيه,3,0,0,0,3
2022,1,مكتب منطقة المدينة المنورة,الأنشطة الأخرى للتعدين واستغلال المحاجر,19,4,0,0,23
2022,1,مكتب منطقة المدينة المنورة,الأنشطة الإدارية للمكاتب ، وأنشطة الدعم للمكاتب وغير ذلك من أنشطة الدعم للأعمال,84,7,0,0,91
2022,1,مكتب منطقة المدينة المنورة,الأنشطة الإيجارية,671,44,3,0,718
2022,1,مكتب منطقة المدينة المنورة,الأنشطة البيطرية,15,4,0,0,19
2022,1,مكتب منطقة المدينة المنورة,الأنشطة الرياضية وأنشطة التسلية والترفيه,65,21,1,0,87
2022,1,مكتب منطقة المدينة المنورة,الأنشطة العقارية,153,24,4,0,181
2022,1,مكتب منطقة المدينة المنورة,الأنشطة القانونية وأنشطة المحاسبة,39,10,0,0,49
2022,1,مكتب منطقة المدينة المنورة,الأنشطة المساعدة لأنشطة الخدمات المالية وأنشطة التأمين,10,5,0,0,15
2022,1,مكتب منطقة المدينة المنورة,الأنشطة المهنية والعلمية والتقنية الأخرى,42,14,1,0,57
2022,1,مكتب منطقة المدينة المنورة,الأنشطة غير المتميزة لإنتاج السلع والخدمات التي تقوم بها الأسر المعيشية الخاصة لإستعمالها الخاص,1,0,0,0,1
2022,1,مكتب منطقة المدينة المنورة,الاتصالات,40,3,0,0,43
2022,1,مكتب منطقة المدينة المنورة,البحث والتطوير في المجال العلمي,1,1,0,0,2
2022,1,مكتب منطقة المدينة المنورة,التخزين وأنشطة الدعم للنقل,214,34,1,2,251
2022,1,مكتب منطقة المدينة المنورة,التعليم,73,61,23,1,158
2022,1,مكتب منطقة المدينة المنورة,الحراجة وقطع الأخشاب,1,1,0,0,2
2022,1,مكتب منطقة المدينة المنورة,الرعاية مع الإقامة,11,5,0,0,16
2022,1,مكتب منطقة المدينة المنورة,الصحة البشرية,31,95,21,5,152
2022,1,مكتب منطقة المدينة المنورة,الصرف الصحي,3,1,0,0,4
2022,1,مكتب منطقة المدينة المنورة,الصناعة التحويلية الأخرى,30,14,1,1,46
2022,1,مكتب منطقة المدينة المنورة,الطباعة واستنساخ وسائط الأعلام المسجّلة,58,13,2,0,73
2022,1,مكتب منطقة المدينة المنورة,النقل البري و النقل عبر الأنابيب,647,66,0,0,713
2022,1,مكتب منطقة المدينة المنورة,النقل الجوي,10,2,0,0,12
2022,1,مكتب منطقة المدينة المنورة,النقل المائي,7,0,0,0,7
2022,1,مكتب منطقة المدينة المنورة,الهندسة المدنية,38,3,1,0,42
2022,1,مكتب منطقة المدينة المنورة,تجارة التجزئة، باستثناء المركبات ذات المحركات والدراجات النارية,4612,964,51,5,5632
2022,1,مكتب منطقة المدينة المنورة,تجارة الجملة ، باستثناء المركبات ذات المحركات والدراجات النارية,1517,393,34,3,1947
2022,1,مكتب منطقة المدينة المنورة,تجارة الجملة والتجزئة ، وإصلاح المركبات ذات المحركات والدراجات النارية,1489,224,5,0,1718
2022,1,مكتب منطقة المدينة المنورة,تجميع المياه ومعالجتها وتوصيلها,27,6,1,0,34
2022,1,مكتب منطقة المدينة المنورة,تشييد المباني,2941,847,60,19,3867
2022,1,مكتب منطقة المدينة المنورة,تعدين ركازات الفلزات,20,6,0,0,26
2022,1,مكتب منطقة المدينة المنورة,تمويل التأمين وإعادة التأمين وصناديق المعاشات التقاعدية باستثناء الضمان الاجتماعي الإلزامي,2,1,0,0,3
2022,1,مكتب منطقة المدينة المنورة,توصيل الكهرباء والغاز والبخار وتكييف الهواء,17,9,2,0,28
2022,1,مكتب منطقة المدينة المنورة,صناعة الآلات والمعدات غير المصنفة في موضع أخر,19,2,0,0,21
2022,1,مكتب منطقة المدينة المنورة,صناعة المركبات ذات المحركات والمركبات المقطورة ونصف المقطورة,42,2,0,0,44
2022,1,مكتب منطقة المدينة المنورة,صناعة معدات النقل الأخرى,10,3,0,0,13
2022,1,مكتب منطقة المدينة المنورة,صنع الأثاث,179,37,1,0,217
2022,1,مكتب منطقة المدينة المنورة,صنع الحواسيب والمنتجات الإلكترونية والبصرية,41,12,0,0,53
2022,1,مكتب منطقة المدينة المنورة,صُنع الخشب ومنتجات الخشب والفلين ، باستثناء الأثاث ، صُنع أصناف من القش ومواد الضفر,105,18,0,0,123
2022,1,مكتب منطقة المدينة المنورة,صنع الفلزات القاعدية,90,20,4,1,115
2022,1,مكتب منطقة المدينة المنورة,صُنع المشروبات,16,14,6,1,37
2022,1,مكتب منطقة المدينة المنورة,صنع المعدات الكهربائية,69,17,0,0,86
2022,1,مكتب منطقة المدينة المنورة,صُنع الملبوسات,652,74,2,0,728
2022,1,مكتب منطقة المدينة المنورة,صُنع المنتجات الجلدية والمنتجات ذات الصلة,8,1,1,0,10
2022,1,مكتب منطقة المدينة المنورة,صنع المنتجات الصيدلانية الأساسية والمستحضرات الصيدلانية,5,1,0,0,6
2022,1,مكتب منطقة المدينة المنورة,صُنع المنتجات الغذائية,444,114,5,2,565
2022,1,مكتب منطقة المدينة المنورة,صُنع المنسوجات,78,23,2,0,103
2022,1,مكتب منطقة المدينة المنورة,صُنع المواد الكيميائية والمنتجات الكيميائية,35,14,2,0,51
2022,1,مكتب منطقة المدينة المنورة,صُنع الورق ومنتجات الورق,4,4,1,0,9
2022,1,مكتب منطقة المدينة المنورة,صنع فحم الكوك والمنتجات النفطية المكررة,1,1,0,0,2
2022,1,مكتب منطقة المدينة المنورة,صُنع منتجات التبغ,1,0,0,0,1
2022,1,مكتب منطقة المدينة المنورة,صنع منتجات المطاط واللدائن,27,18,4,0,49
2022,1,مكتب منطقة المدينة المنورة,صنع منتجات المعادن اللافلزية الأخرى,109,41,11,0,161
2022,1,مكتب منطقة المدينة المنورة,صنع منتجات المعادن المشكلة ( باستثناء الآلات والمعدات ),258,55,4,0,317
2022,1,مكتب منطقة المدينة المنورة,صيد الأسماك وتربية المائيات,5,1,0,0,6
2022,1,مكتب منطقة المدينة المنورة,وكالات السفر ومشغّلو الجولات السياحية وخدمات الحجز والأنشطة المتصلة بها,65,13,1,0,79
2022,1,مكتب منطقة تبوك,أبحاث الإعلان والسوق,15,0,1,0,16
2022,1,مكتب منطقة تبوك,إصلاح أجهزة الحاسوب والسلع الشخصية والمنزلية,174,34,0,0,208
2022,1,مكتب منطقة تبوك,إصلاح وتركيب الآلات والمعدات,56,1,0,0,57
2022,1,مكتب منطقة تبوك,أنشطة أنتاج الأفلام والبرامج التلفزيونية والتسجيلات الصوتية و نشرالموسيقى,5,0,0,0,5
2022,1,مكتب منطقة تبوك,أنشطة الأمن والتحقيقات,2,0,0,0,2
2022,1,مكتب منطقة تبوك,أنشطة الاستخدام,19,2,0,0,21
2022,1,مكتب منطقة تبوك,أنشطة الاسر المعيشية التي تستخدم أفراداً للعمل المنزلي,2,1,0,0,3
2022,1,مكتب منطقة تبوك,أنشطة البرمجة الحاسوبية والخبرة الاستشارية وما يتصل بها من أنشطة,6,2,0,0,8
2022,1,مكتب منطقة تبوك,أنشطة البرمجة والإذاعة,1,0,0,0,1
2022,1,مكتب منطقة تبوك,أنشطة البريد ونقل الرسائل والطرود بواسطة مندوبين,2,0,0,0,2
2022,1,مكتب منطقة تبوك,أنشطة التشييد المتخصصة,1113,136,3,0,1252
2022,1,مكتب منطقة تبوك,أنشطة الخدمات الشخصية الأخرى,912,74,2,0,988
2022,1,مكتب منطقة تبوك,أنشطة الخدمات المالية ، فيما عدا تمويل التأمين وصناديق المعاشات,18,2,0,0,20
2022,1,مكتب منطقة تبوك,أنشطة العمل الاجتماعي، دون إقامة، لكبار السن وذوي الإعاقة,28,10,1,0,39
2022,1,مكتب منطقة تبوك,أنشطة المعمارية والهندسية ، والاختبارات الفنية والتحليل,63,24,1,0,88
2022,1,مكتب منطقة تبوك,أنشطة المكاتب الرئيسية ، وألأنشطة الاستشارية في مجال الإدارة,11,1,0,0,12
2022,1,مكتب منطقة تبوك,أنشطة المكتبات ودور المحفوظات، والمتاحف والأنشطة الثقافية الأخرى,24,8,0,0,32
2022,1,مكتب منطقة تبوك,أنشطة المنظمات ذات العضوية,5,2,1,0,8
2022,1,مكتب منطقة تبوك,أنشطة النشر,6,2,0,0,8
2022,1,مكتب منطقة تبوك,أنشطة تقديم الخدمات للمباني وتجميل المواقع,359,61,4,1,425
2022,1,مكتب منطقة تبوك,أنشطة جمع النفايات ومعالجتها وتصريفها ، واسترجاع المواد,1,0,0,0,1
2022,1,مكتب منطقة تبوك,أنشطة خدمات الأطعمة والمشروبات,1670,370,24,0,2064
2022,1,مكتب منطقة تبوك,أنشطة خدمات المعلومات,9,2,0,0,11
2022,1,مكتب منطقة تبوك,أنشطة خدمات دعم التعدين,2,1,0,0,3
2022,1,مكتب منطقة تبوك,أنشطة زراعة المحاصيل والإنتاج الحيواني والصيد والخدمات المتصلة,418,35,1,2,456
2022,1,مكتب منطقة تبوك,الإدارة العامة والدفاع ؛ والضمان الاجتماعي الإلزامي,9,8,1,0,18
2022,1,مكتب منطقة تبوك,الإقامة,71,34,2,0,107
2022,1,مكتب منطقة تبوك,الأنشطة الإبداعية والفنون وأنشطة الترفيه,2,0,0,0,2
2022,1,مكتب منطقة تبوك,الأنشطة الأخرى للتعدين واستغلال المحاجر,4,2,0,0,6
2022,1,مكتب منطقة تبوك,الأنشطة الإدارية للمكاتب ، وأنشطة الدعم للمكاتب وغير ذلك من أنشطة الدعم للأعمال,40,3,1,0,44
2022,1,مكتب منطقة تبوك,الأنشطة الإيجارية,385,9,0,0,394
2022,1,مكتب منطقة تبوك,الأنشطة البيطرية,6,2,0,0,8
2022,1,مكتب منطقة تبوك,الأنشطة الرياضية وأنشطة التسلية والترفيه,52,9,0,0,61
2022,1,مكتب منطقة تبوك,الأنشطة العقارية,51,6,0,0,57
2022,1,مكتب منطقة تبوك,الأنشطة القانونية وأنشطة المحاسبة,8,0,0,0,8
2022,1,مكتب منطقة تبوك,الأنشطة المساعدة لأنشطة الخدمات المالية وأنشطة التأمين,3,0,0,0,3
2022,1,مكتب منطقة تبوك,الأنشطة المهنية والعلمية والتقنية الأخرى,21,2,0,0,23
2022,1,مكتب منطقة تبوك,الاتصالات,18,1,0,0,19
2022,1,مكتب منطقة تبوك,البحث والتطوير في المجال العلمي,1,0,0,0,1
2022,1,مكتب منطقة تبوك,التخزين وأنشطة الدعم للنقل,69,7,0,0,76
2022,1,مكتب منطقة تبوك,التعليم,34,36,17,1,88
2022,1,مكتب منطقة تبوك,الرعاية مع الإقامة,9,0,1,0,10
2022,1,مكتب منطقة تبوك,الصحة البشرية,19,48,10,1,78
2022,1,مكتب منطقة تبوك,الصرف الصحي,1,0,0,0,1
2022,1,مكتب منطقة تبوك,الصناعة التحويلية الأخرى,15,0,0,0,15
2022,1,مكتب منطقة تبوك,الطباعة واستنساخ وسائط الأعلام المسجّلة,24,7,0,0,31
2022,1,مكتب منطقة تبوك,النقل البري و النقل عبر الأنابيب,458,57,5,0,520
2022,1,مكتب منطقة تبوك,النقل الجوي,8,4,3,0,15
2022,1,مكتب منطقة تبوك,النقل المائي,8,1,0,0,9
2022,1,مكتب منطقة تبوك,الهندسة المدنية,11,1,0,0,12
2022,1,مكتب منطقة تبوك,تجارة التجزئة، باستثناء المركبات ذات المحركات والدراجات النارية,1867,280,13,1,2161
2022,1,مكتب منطقة تبوك,تجارة الجملة ، باستثناء المركبات ذات المحركات والدراجات النارية,570,104,7,0,681
2022,1,مكتب منطقة تبوك,تجارة الجملة والتجزئة ، وإصلاح المركبات ذات المحركات والدراجات النارية,907,129,0,0,1036
2022,1,مكتب منطقة تبوك,تجميع المياه ومعالجتها وتوصيلها,38,4,0,0,42
2022,1,مكتب منطقة تبوك,تشييد المباني,2137,387,29,5,2558
2022,1,مكتب منطقة تبوك,تعدين الفحم والليغنيت,1,0,0,0,1
2022,1,مكتب منطقة تبوك,تعدين ركازات الفلزات,6,2,0,0,8
2022,1,مكتب منطقة تبوك,توصيل الكهرباء والغاز والبخار وتكييف الهواء,8,2,0,0,10
2022,1,مكتب منطقة تبوك,صناعة الآلات والمعدات غير المصنفة في موضع أخر,18,3,0,0,21
2022,1,مكتب منطقة تبوك,صناعة المركبات ذات المحركات والمركبات المقطورة ونصف المقطورة,30,1,0,0,31
2022,1,مكتب منطقة تبوك,صناعة معدات النقل الأخرى,2,1,0,0,3
2022,1,مكتب منطقة تبوك,صنع الأثاث,137,23,0,0,160
2022,1,مكتب منطقة تبوك,صنع الحواسيب والمنتجات الإلكترونية والبصرية,45,4,1,0,50
2022,1,مكتب منطقة تبوك,صُنع الخشب ومنتجات الخشب والفلين ، باستثناء الأثاث ، صُنع أصناف من القش ومواد الضفر,83,21,0,0,104
2022,1,مكتب منطقة تبوك,صنع الفلزات القاعدية,22,4,1,0,27
2022,1,مكتب منطقة تبوك,صُنع المشروبات,25,6,1,0,32
2022,1,مكتب منطقة تبوك,صنع المعدات الكهربائية,46,4,0,0,50
2022,1,مكتب منطقة تبوك,صُنع الملبوسات,622,40,0,0,662
2022,1,مكتب منطقة تبوك,صُنع المنتجات الجلدية والمنتجات ذات الصلة,3,4,0,0,7
2022,1,مكتب منطقة تبوك,صنع المنتجات الصيدلانية الأساسية والمستحضرات الصيدلانية,0,0,0,1,1
2022,1,مكتب منطقة تبوك,صُنع المنتجات الغذائية,194,42,2,2,240
2022,1,مكتب منطقة تبوك,صُنع المنسوجات,40,14,0,0,54
2022,1,مكتب منطقة تبوك,صُنع المواد الكيميائية والمنتجات الكيميائية,21,7,0,0,28
2022,1,مكتب منطقة تبوك,صُنع الورق ومنتجات الورق,2,3,0,0,5
2022,1,مكتب منطقة تبوك,صُنع منتجات التبغ,4,0,0,0,4
2022,1,مكتب منطقة تبوك,صنع منتجات المطاط واللدائن,6,8,1,0,15
2022,1,مكتب منطقة تبوك,صنع منتجات المعادن اللافلزية الأخرى,44,19,0,0,63
2022,1,مكتب منطقة تبوك,صنع منتجات المعادن المشكلة ( باستثناء الآلات والمعدات ),152,37,1,1,191
2022,1,مكتب منطقة تبوك,صيد الأسماك وتربية المائيات,21,10,0,0,31
2022,1,مكتب منطقة تبوك,وكالات السفر ومشغّلو الجولات السياحية وخدمات الحجز والأنشطة المتصلة بها,21,5,0,0,26
2022,1,مكتب منطقة جازان,أبحاث الإعلان والسوق,20,2,0,0,22
2022,1,مكتب منطقة جازان,إصلاح أجهزة الحاسوب والسلع الشخصية والمنزلية,156,15,0,0,171
2022,1,مكتب منطقة جازان,إصلاح وتركيب الآلات والمعدات,155,5,0,0,160
2022,1,مكتب منطقة جازان,أنشطة أنتاج الأفلام والبرامج التلفزيونية والتسجيلات الصوتية و نشرالموسيقى,8,0,0,0,8
2022,1,مكتب منطقة جازان,أنشطة الأمن والتحقيقات,6,1,0,0,7
2022,1,مكتب منطقة جازان,أنشطة الاستخدام,21,2,0,0,23
2022,1,مكتب منطقة جازان,أنشطة الاسر المعيشية التي تستخدم أفراداً للعمل المنزلي,4,0,0,0,4
2022,1,مكتب منطقة جازان,أنشطة البرمجة الحاسوبية والخبرة الاستشارية وما يتصل بها من أنشطة,11,0,0,0,11
2022,1,مكتب منطقة جازان,أنشطة التشييد المتخصصة,1246,149,6,1,1402
2022,1,مكتب منطقة جازان,أنشطة الخدمات الشخصية الأخرى,1254,92,0,0,1346
2022,1,مكتب منطقة جازان,أنشطة الخدمات المالية ، فيما عدا تمويل التأمين وصناديق المعاشات,32,3,0,0,35
2022,1,مكتب منطقة جازان,أنشطة العمل الاجتماعي، دون إقامة، لكبار السن وذوي الإعاقة,26,28,2,0,56
2022,1,مكتب منطقة جازان,أنشطة المعالجة وخدمات إدارة النفايات الأخرى,1,0,0,0,1
2022,1,مكتب منطقة جازان,أنشطة المعمارية والهندسية ، والاختبارات الفنية والتحليل,69,18,2,0,89
2022,1,مكتب منطقة جازان,أنشطة المكاتب الرئيسية ، وألأنشطة الاستشارية في مجال الإدارة,28,2,0,0,30
2022,1,مكتب منطقة جازان,أنشطة المكتبات ودور المحفوظات، والمتاحف والأنشطة الثقافية الأخرى,24,9,1,0,34
2022,1,مكتب منطقة جازان,أنشطة المنظمات ذات العضوية,26,5,0,0,31
2022,1,مكتب منطقة جازان,أنشطة النشر,16,2,0,0,18
2022,1,مكتب منطقة جازان,أنشطة تقديم الخدمات للمباني وتجميل المواقع,393,85,2,0,480
2022,1,مكتب منطقة جازان,أنشطة جمع النفايات ومعالجتها وتصريفها ، واسترجاع المواد,1,0,0,0,1
2022,1,مكتب منطقة جازان,أنشطة خدمات الأطعمة والمشروبات,3010,558,15,0,3583
2022,1,مكتب منطقة جازان,أنشطة خدمات المعلومات,12,4,0,0,16
2022,1,مكتب منطقة جازان,أنشطة خدمات دعم التعدين,11,7,0,0,18
2022,1,مكتب منطقة جازان,أنشطة زراعة المحاصيل والإنتاج الحيواني والصيد والخدمات المتصلة,402,33,1,0,436
2022,1,مكتب منطقة جازان,الإدارة العامة والدفاع ؛ والضمان الاجتماعي الإلزامي,18,8,0,0,26
2022,1,مكتب منطقة جازان,الإقامة,175,39,7,0,221
2022,1,مكتب منطقة جازان,الأنشطة الإبداعية والفنون وأنشطة الترفيه,3,0,0,0,3
2022,1,مكتب منطقة جازان,الأنشطة الأخرى للتعدين واستغلال المحاجر,10,4,0,0,14
2022,1,مكتب منطقة جازان,الأنشطة الإدارية للمكاتب ، وأنشطة الدعم للمكاتب وغير ذلك من أنشطة الدعم للأعمال,40,1,0,0,41
2022,1,مكتب منطقة جازان,الأنشطة الإيجارية,1172,32,1,0,1205
2022,1,مكتب منطقة جازان,الأنشطة البيطرية,6,6,0,0,12
2022,1,مكتب منطقة جازان,الأنشطة الرياضية وأنشطة التسلية والترفيه,41,6,1,0,48
2022,1,مكتب منطقة جازان,الأنشطة العقارية,62,10,0,1,73
2022,1,مكتب منطقة جازان,الأنشطة القانونية وأنشطة المحاسبة,14,2,0,0,16
2022,1,مكتب منطقة جازان,الأنشطة المساعدة لأنشطة الخدمات المالية وأنشطة التأمين,1,0,0,0,1
2022,1,مكتب منطقة جازان,الأنشطة المهنية والعلمية والتقنية الأخرى,21,3,0,0,24
2022,1,مكتب منطقة جازان,الأنشطة غير المتميزة لإنتاج السلع والخدمات التي تقوم بها الأسر المعيشية الخاصة لإستعمالها الخاص,1,0,0,0,1
2022,1,مكتب منطقة جازان,الاتصالات,23,4,0,0,27
2022,1,مكتب منطقة جازان,البحث والتطوير في المجال العلمي,1,0,0,0,1
2022,1,مكتب منطقة جازان,التخزين وأنشطة الدعم للنقل,76,19,1,1,97
2022,1,مكتب منطقة جازان,التعليم,43,31,3,0,77
2022,1,مكتب منطقة جازان,الحراجة وقطع الأخشاب,0,1,0,0,1
2022,1,مكتب منطقة جازان,الرعاية مع الإقامة,10,4,0,0,14
2022,1,مكتب منطقة جازان,الصحة البشرية,37,65,12,2,116
2022,1,مكتب منطقة جازان,الصرف الصحي,2,2,0,0,4
2022,1,مكتب منطقة جازان,الصناعة التحويلية الأخرى,16,8,0,0,24
2022,1,مكتب منطقة جازان,الطباعة واستنساخ وسائط الأعلام المسجّلة,16,5,0,0,21
2022,1,مكتب منطقة جازان,النقل البري و النقل عبر الأنابيب,316,32,2,0,350
2022,1,مكتب منطقة جازان,النقل الجوي,10,1,0,0,11
2022,1,مكتب منطقة جازان,النقل المائي,4,2,1,0,7
2022,1,مكتب منطقة جازان,الهندسة المدنية,21,2,1,0,24
2022,1,مكتب منطقة جازان,تجارة التجزئة، باستثناء المركبات ذات المحركات والدراجات النارية,3558,496,18,1,4073
2022,1,مكتب منطقة جازان,تجارة الجملة ، باستثناء المركبات ذات المحركات والدراجات النارية,1342,305,23,0,1670
2022,1,مكتب منطقة جازان,تجارة الجملة والتجزئة ، وإصلاح المركبات ذات المحركات والدراجات النارية,1432,154,5,1,1592
2022,1,مكتب منطقة جازان,تجميع المياه ومعالجتها وتوصيلها,46,7,1,1,55
2022,1,مكتب منطقة جازان,تشييد المباني,2565,433,38,1,3037
2022,1,مكتب منطقة جازان,تعدين ركازات الفلزات,22,7,0,0,29
2022,1,مكتب منطقة جازان,تمويل التأمين وإعادة التأمين وصناديق المعاشات التقاعدية باستثناء الضمان الاجتماعي الإلزامي,1,1,0,0,2
2022,1,مكتب منطقة جازان,توصيل الكهرباء والغاز والبخار وتكييف الهواء,11,9,1,0,21
2022,1,مكتب منطقة جازان,صناعة الآلات والمعدات غير المصنفة في موضع أخر,36,2,0,0,38
2022,1,مكتب منطقة جازان,صناعة المركبات ذات المحركات والمركبات المقطورة ونصف المقطورة,85,4,0,0,89
2022,1,مكتب منطقة جازان,صناعة معدات النقل الأخرى,13,3,0,0,16
2022,1,مكتب منطقة جازان,صنع الأثاث,175,12,0,0,187
2022,1,مكتب منطقة جازان,صنع الحواسيب والمنتجات الإلكترونية والبصرية,40,11,0,0,51
2022,1,مكتب منطقة جازان,صُنع الخشب ومنتجات الخشب والفلين ، باستثناء الأثاث ، صُنع أصناف من القش ومواد الضفر,148,15,0,0,163
2022,1,مكتب منطقة جازان,صنع الفلزات القاعدية,59,13,1,1,74
2022,1,مكتب منطقة جازان,صُنع المشروبات,14,4,3,1,22
2022,1,مكتب منطقة جازان,صنع المعدات الكهربائية,71,8,0,0,79
2022,1,مكتب منطقة جازان,صُنع الملبوسات,410,45,0,0,455
2022,1,مكتب منطقة جازان,صُنع المنتجات الجلدية والمنتجات ذات الصلة,47,2,0,0,49
2022,1,مكتب منطقة جازان,صنع المنتجات الصيدلانية الأساسية والمستحضرات الصيدلانية,5,1,0,0,6
2022,1,مكتب منطقة جازان,صُنع المنتجات الغذائية,271,74,5,0,350
2022,1,مكتب منطقة جازان,صُنع المنسوجات,14,4,0,0,18
2022,1,مكتب منطقة جازان,صُنع المواد الكيميائية والمنتجات الكيميائية,34,10,2,1,47
2022,1,مكتب منطقة جازان,صُنع الورق ومنتجات الورق,2,1,1,0,4
2022,1,مكتب منطقة جازان,صنع فحم الكوك والمنتجات النفطية المكررة,1,0,0,0,1
2022,1,مكتب منطقة جازان,صُنع منتجات التبغ,0,1,0,0,1
2022,1,مكتب منطقة جازان,صنع منتجات المطاط واللدائن,8,8,1,0,17
2022,1,مكتب منطقة جازان,صنع منتجات المعادن اللافلزية الأخرى,95,38,10,2,145
2022,1,مكتب منطقة جازان,صنع منتجات المعادن المشكلة ( باستثناء الآلات والمعدات ),390,20,1,0,411
2022,1,مكتب منطقة جازان,صيد الأسماك وتربية المائيات,111,67,4,0,182
2022,1,مكتب منطقة جازان,وكالات السفر ومشغّلو الجولات السياحية وخدمات الحجز والأنشطة المتصلة بها,17,2,0,0,19
2022,1,مكتب منطقة حائل,أبحاث الإعلان والسوق,14,7,0,0,21
2022,1,مكتب منطقة حائل,إصلاح أجهزة الحاسوب والسلع الشخصية والمنزلية,127,10,1,0,138
2022,1,مكتب منطقة حائل,إصلاح وتركيب الآلات والمعدات,24,2,0,0,26
2022,1,مكتب منطقة حائل,أنشطة أنتاج الأفلام والبرامج التلفزيونية والتسجيلات الصوتية و نشرالموسيقى,7,1,0,0,8
2022,1,مكتب منطقة حائل,أنشطة الأمن والتحقيقات,3,1,0,0,4
2022,1,مكتب منطقة حائل,أنشطة الاستخدام,9,3,0,0,12
2022,1,مكتب منطقة حائل,أنشطة الاسر المعيشية التي تستخدم أفراداً للعمل المنزلي,1,0,0,0,1
2022,1,مكتب منطقة حائل,أنشطة البرمجة الحاسوبية والخبرة الاستشارية وما يتصل بها من أنشطة,7,4,0,0,11
2022,1,مكتب منطقة حائل,أنشطة البريد ونقل الرسائل والطرود بواسطة مندوبين,2,1,0,0,3
2022,1,مكتب منطقة حائل,أنشطة التشييد المتخصصة,1190,182,3,0,1375
2022,1,مكتب منطقة حائل,أنشطة الخدمات الشخصية الأخرى,768,70,1,0,839
2022,1,مكتب منطقة حائل,أنشطة الخدمات المالية ، فيما عدا تمويل التأمين وصناديق المعاشات,27,1,0,0,28
2022,1,مكتب منطقة حائل,أنشطة العمل الاجتماعي، دون إقامة، لكبار السن وذوي الإعاقة,42,19,0,0,61
2022,1,مكتب منطقة حائل,أنشطة المعمارية والهندسية ، والاختبارات الفنية والتحليل,64,15,1,0,80
2022,1,مكتب منطقة حائل,أنشطة المكاتب الرئيسية ، وألأنشطة الاستشارية في مجال الإدارة,21,1,0,0,22
2022,1,مكتب منطقة حائل,أنشطة المكتبات ودور المحفوظات، والمتاحف والأنشطة الثقافية الأخرى,6,2,0,0,8
2022,1,مكتب منطقة حائل,أنشطة المنظمات ذات العضوية,26,4,0,0,30
2022,1,مكتب منطقة حائل,أنشطة النشر,39,0,0,0,39
2022,1,مكتب منطقة حائل,أنشطة تقديم الخدمات للمباني وتجميل المواقع,360,53,7,1,421
2022,1,مكتب منطقة حائل,أنشطة جمع النفايات ومعالجتها وتصريفها ، واسترجاع المواد,2,0,0,0,2
2022,1,مكتب منطقة حائل,أنشطة خدمات الأطعمة والمشروبات,1503,281,17,1,1802
2022,1,مكتب منطقة حائل,أنشطة خدمات المعلومات,9,0,0,0,9
2022,1,مكتب منطقة حائل,أنشطة خدمات دعم التعدين,8,3,0,0,11
2022,1,مكتب منطقة حائل,أنشطة زراعة المحاصيل والإنتاج الحيواني والصيد والخدمات المتصلة,1160,51,6,1,1218
2022,1,مكتب منطقة حائل,الإدارة العامة والدفاع ؛ والضمان الاجتماعي الإلزامي,16,8,0,0,24
2022,1,مكتب منطقة حائل,الإقامة,61,19,1,0,81
2022,1,مكتب منطقة حائل,الأنشطة الإبداعية والفنون وأنشطة الترفيه,2,1,0,0,3
2022,1,مكتب منطقة حائل,الأنشطة الأخرى للتعدين واستغلال المحاجر,29,4,0,0,33
2022,1,مكتب منطقة حائل,الأنشطة الإدارية للمكاتب ، وأنشطة الدعم للمكاتب وغير ذلك من أنشطة الدعم للأعمال,46,3,0,0,49
2022,1,مكتب منطقة حائل,الأنشطة الإيجارية,829,38,1,0,868
2022,1,مكتب منطقة حائل,الأنشطة البيطرية,4,0,1,0,5
2022,1,مكتب منطقة حائل,الأنشطة الرياضية وأنشطة التسلية والترفيه,44,20,0,0,64
2022,1,مكتب منطقة حائل,الأنشطة العقارية,63,10,0,0,73
2022,1,مكتب منطقة حائل,الأنشطة القانونية وأنشطة المحاسبة,7,2,0,0,9
2022,1,مكتب منطقة حائل,الأنشطة المهنية والعلمية والتقنية الأخرى,12,0,1,0,13
2022,1,مكتب منطقة حائل,الاتصالات,29,2,0,0,31
2022,1,مكتب منطقة حائل,التخزين وأنشطة الدعم للنقل,63,13,0,0,76
2022,1,مكتب منطقة حائل,التعليم,33,24,4,0,61
2022,1,مكتب منطقة حائل,الحراجة وقطع الأخشاب,2,0,0,0,2
2022,1,مكتب منطقة حائل,الرعاية مع الإقامة,11,3,0,0,14
2022,1,مكتب منطقة حائل,الصحة البشرية,40,52,17,2,111
2022,1,مكتب منطقة حائل,الصرف الصحي,2,0,0,0,2
2022,1,مكتب منطقة حائل,الصناعة التحويلية الأخرى,12,1,0,0,13
2022,1,مكتب منطقة حائل,الطباعة واستنساخ وسائط الأعلام المسجّلة,44,7,0,0,51
2022,1,مكتب منطقة حائل,النقل البري و النقل عبر الأنابيب,488,36,3,0,527
2022,1,مكتب منطقة حائل,النقل الجوي,26,5,0,0,31
2022,1,مكتب منطقة حائل,النقل المائي,3,0,0,0,3
2022,1,مكتب منطقة حائل,الهندسة المدنية,15,5,1,0,21
2022,1,مكتب منطقة حائل,تجارة التجزئة، باستثناء المركبات ذات المحركات والدراجات النارية,1476,278,14,0,1768
2022,1,مكتب منطقة حائل,تجارة الجملة ، باستثناء المركبات ذات المحركات والدراجات النارية,474,94,7,2,577
2022,1,مكتب منطقة حائل,تجارة الجملة والتجزئة ، وإصلاح المركبات ذات المحركات والدراجات النارية,734,141,2,0,877
2022,1,مكتب منطقة حائل,تجميع المياه ومعالجتها وتوصيلها,15,3,1,0,19
2022,1,مكتب منطقة حائل,تشييد المباني,2806,595,61,8,3470
2022,1,مكتب منطقة حائل,تعدين الفحم والليغنيت,1,0,0,0,1
2022,1,مكتب منطقة حائل,تعدين ركازات الفلزات,5,0,0,0,5
2022,1,مكتب منطقة حائل,توصيل الكهرباء والغاز والبخار وتكييف الهواء,15,5,2,0,22
2022,1,مكتب منطقة حائل,صناعة الآلات والمعدات غير المصنفة في موضع أخر,22,4,0,0,26
2022,1,مكتب منطقة حائل,صناعة المركبات ذات المحركات والمركبات المقطورة ونصف المقطورة,38,3,0,0,41
2022,1,مكتب منطقة حائل,صناعة معدات النقل الأخرى,4,0,0,0,4
2022,1,مكتب منطقة حائل,صنع الأثاث,120,24,0,0,144
2022,1,مكتب منطقة حائل,صنع الحواسيب والمنتجات الإلكترونية والبصرية,35,5,0,0,40
2022,1,مكتب منطقة حائل,صُنع الخشب ومنتجات الخشب والفلين ، باستثناء الأثاث ، صُنع أصناف من القش ومواد الضفر,58,10,1,0,69
2022,1,مكتب منطقة حائل,صنع الفلزات القاعدية,89,26,3,0,118
2022,1,مكتب منطقة حائل,صُنع المشروبات,8,6,0,0,14
2022,1,مكتب منطقة حائل,صنع المعدات الكهربائية,42,3,0,0,45
2022,1,مكتب منطقة حائل,صُنع الملبوسات,316,40,0,0,356
2022,1,مكتب منطقة حائل,صُنع المنتجات الجلدية والمنتجات ذات الصلة,6,2,0,0,8
2022,1,مكتب منطقة حائل,صنع المنتجات الصيدلانية الأساسية والمستحضرات الصيدلانية,3,0,0,0,3
2022,1,مكتب منطقة حائل,صُنع المنتجات الغذائية,179,40,5,0,224
2022,1,مكتب منطقة حائل,صُنع المنسوجات,50,21,0,0,71
2022,1,مكتب منطقة حائل,صُنع المواد الكيميائية والمنتجات الكيميائية,85,31,0,0,116
2022,1,مكتب منطقة حائل,صُنع الورق ومنتجات الورق,4,3,0,0,7
2022,1,مكتب منطقة حائل,صنع منتجات المطاط واللدائن,13,7,2,0,22
2022,1,مكتب منطقة حائل,صنع منتجات المعادن اللافلزية الأخرى,96,36,8,1,141
2022,1,مكتب منطقة حائل,صنع منتجات المعادن المشكلة ( باستثناء الآلات والمعدات ),105,34,0,0,139
2022,1,مكتب منطقة حائل,صيد الأسماك وتربية المائيات,1,0,0,0,1
2022,1,مكتب منطقة حائل,وكالات السفر ومشغّلو الجولات السياحية وخدمات الحجز والأنشطة المتصلة بها,8,1,0,0,9
2022,1,مكتب منطقة عسير,أبحاث الإعلان والسوق,29,1,0,0,30
2022,1,مكتب منطقة عسير,إصلاح أجهزة الحاسوب والسلع الشخصية والمنزلية,209,29,1,0,239
2022,1,مكتب منطقة عسير,إصلاح وتركيب الآلات والمعدات,63,2,1,0,66
2022,1,مكتب منطقة عسير,أنشطة أنتاج الأفلام والبرامج التلفزيونية والتسجيلات الصوتية و نشرالموسيقى,12,0,0,0,12
2022,1,مكتب منطقة عسير,أنشطة الأمن والتحقيقات,10,4,2,1,17
2022,1,مكتب منطقة عسير,أنشطة الاستخدام,34,5,0,1,40
2022,1,مكتب منطقة عسير,أنشطة البرمجة الحاسوبية والخبرة الاستشارية وما يتصل بها من أنشطة,15,6,0,0,21
2022,1,مكتب منطقة عسير,أنشطة البرمجة والإذاعة,6,3,0,0,9
2022,1,مكتب منطقة عسير,أنشطة البريد ونقل الرسائل والطرود بواسطة مندوبين,7,1,0,0,8
2022,1,مكتب منطقة عسير,أنشطة التشييد المتخصصة,1798,266,9,1,2074
2022,1,مكتب منطقة عسير,أنشطة الخدمات الشخصية الأخرى,1193,127,2,0,1322
2022,1,مكتب منطقة عسير,أنشطة الخدمات المالية ، فيما عدا تمويل التأمين وصناديق المعاشات,18,1,0,0,19
2022,1,مكتب منطقة عسير,أنشطة العمل الاجتماعي، دون إقامة، لكبار السن وذوي الإعاقة,49,40,4,0,93
2022,1,مكتب منطقة عسير,أنشطة المعمارية والهندسية ، والاختبارات الفنية والتحليل,104,46,3,1,154
2022,1,مكتب منطقة عسير,أنشطة المكاتب الرئيسية ، وألأنشطة الاستشارية في مجال الإدارة,27,2,1,0,30
2022,1,مكتب منطقة عسير,أنشطة المكتبات ودور المحفوظات، والمتاحف والأنشطة الثقافية الأخرى,27,21,1,0,49
2022,1,مكتب منطقة عسير,أنشطة المنظمات ذات العضوية,24,6,0,0,30
2022,1,مكتب منطقة عسير,أنشطة النشر,16,2,1,0,19
2022,1,مكتب منطقة عسير,أنشطة تقديم الخدمات للمباني وتجميل المواقع,433,75,5,2,515
2022,1,مكتب منطقة عسير,أنشطة جمع النفايات ومعالجتها وتصريفها ، واسترجاع المواد,6,1,0,0,7
2022,1,مكتب منطقة عسير,أنشطة خدمات الأطعمة والمشروبات,3366,906,63,4,4339
2022,1,مكتب منطقة عسير,أنشطة خدمات المعلومات,20,3,0,0,23
2022,1,مكتب منطقة عسير,أنشطة خدمات دعم التعدين,23,5,1,0,29
2022,1,مكتب منطقة عسير,أنشطة زراعة المحاصيل والإنتاج الحيواني والصيد والخدمات المتصلة,836,38,4,0,878
2022,1,مكتب منطقة عسير,الإدارة العامة والدفاع ؛ والضمان الاجتماعي الإلزامي,12,13,1,0,26
2022,1,مكتب منطقة عسير,الإقامة,208,76,5,1,290
2022,1,مكتب منطقة عسير,الأنشطة الإبداعية والفنون وأنشطة الترفيه,3,0,0,0,3
2022,1,مكتب منطقة عسير,الأنشطة الأخرى للتعدين واستغلال المحاجر,14,5,0,0,19
2022,1,مكتب منطقة عسير,الأنشطة الإدارية للمكاتب ، وأنشطة الدعم للمكاتب وغير ذلك من أنشطة الدعم للأعمال,79,6,1,1,87
2022,1,مكتب منطقة عسير,الأنشطة الإيجارية,1031,67,2,1,1101
2022,1,مكتب منطقة عسير,الأنشطة البيطرية,11,5,3,0,19
2022,1,مكتب منطقة عسير,الأنشطة الرياضية وأنشطة التسلية والترفيه,76,26,0,0,102
2022,1,مكتب منطقة عسير,الأنشطة العقارية,108,20,2,0,130
2022,1,مكتب منطقة عسير,الأنشطة القانونية وأنشطة المحاسبة,23,4,0,0,27
2022,1,مكتب منطقة عسير,الأنشطة المساعدة لأنشطة الخدمات المالية وأنشطة التأمين,3,2,0,0,5
2022,1,مكتب منطقة عسير,الأنشطة المهنية والعلمية والتقنية الأخرى,26,4,2,0,32
2022,1,مكتب منطقة عسير,الأنشطة غير المتميزة لإنتاج السلع والخدمات التي تقوم بها الأسر المعيشية الخاصة لإستعمالها الخاص,1,0,0,0,1
2022,1,مكتب منطقة عسير,الاتصالات,27,2,0,0,29
2022,1,مكتب منطقة عسير,التخزين وأنشطة الدعم للنقل,87,24,4,0,115
2022,1,مكتب منطقة عسير,التعليم,37,37,12,1,87
2022,1,مكتب منطقة عسير,الرعاية مع الإقامة,14,3,0,0,17
2022,1,مكتب منطقة عسير,الصحة البشرية,63,94,38,6,201
2022,1,مكتب منطقة عسير,الصرف الصحي,2,1,1,0,4
2022,1,مكتب منطقة عسير,الصناعة التحويلية الأخرى,20,13,1,0,34
2022,1,مكتب منطقة عسير,الطباعة واستنساخ وسائط الأعلام المسجّلة,24,17,2,0,43
2022,1,مكتب منطقة عسير,النقل البري و النقل عبر الأنابيب,1248,157,4,3,1412
2022,1,مكتب منطقة عسير,النقل الجوي,13,1,0,0,14
2022,1,مكتب منطقة عسير,النقل المائي,9,0,0,0,9
2022,1,مكتب منطقة عسير,الهندسة المدنية,33,7,1,0,41
2022,1,مكتب منطقة عسير,تجارة التجزئة، باستثناء المركبات ذات المحركات والدراجات النارية,3542,701,48,5,4296
2022,1,مكتب منطقة عسير,تجارة الجملة ، باستثناء المركبات ذات المحركات والدراجات النارية,1006,260,18,2,1286
2022,1,مكتب منطقة عسير,تجارة الجملة والتجزئة ، وإصلاح المركبات ذات المحركات والدراجات النارية,1607,366,11,0,1984
2022,1,مكتب منطقة عسير,تجميع المياه ومعالجتها وتوصيلها,101,30,0,0,131
2022,1,مكتب منطقة عسير,تشييد المباني,5893,1421,118,16,7448
2022,1,مكتب منطقة عسير,تعدين ركازات الفلزات,87,18,0,0,105
2022,1,مكتب منطقة عسير,تمويل التأمين وإعادة التأمين وصناديق المعاشات التقاعدية باستثناء الضمان الاجتماعي الإلزامي,2,2,1,0,5
2022,1,مكتب منطقة عسير,توصيل الكهرباء والغاز والبخار وتكييف الهواء,10,8,1,1,20
2022,1,مكتب منطقة عسير,صناعة الآلات والمعدات غير المصنفة في موضع أخر,35,5,0,0,40
2022,1,مكتب منطقة عسير,صناعة المركبات ذات المحركات والمركبات المقطورة ونصف المقطورة,38,4,1,0,43
2022,1,مكتب منطقة عسير,صناعة معدات النقل الأخرى,8,2,0,0,10
2022,1,مكتب منطقة عسير,صنع الأثاث,210,27,0,0,237
2022,1,مكتب منطقة عسير,صنع الحواسيب والمنتجات الإلكترونية والبصرية,67,19,0,0,86
2022,1,مكتب منطقة عسير,صُنع الخشب ومنتجات الخشب والفلين ، باستثناء الأثاث ، صُنع أصناف من القش ومواد الضفر,235,60,1,0,296
2022,1,مكتب منطقة عسير,صنع الفلزات القاعدية,110,33,0,0,143
2022,1,مكتب منطقة عسير,صُنع المشروبات,21,9,1,0,31
2022,1,مكتب منطقة عسير,صنع المعدات الكهربائية,48,10,0,0,58
2022,1,مكتب منطقة عسير,صُنع الملبوسات,530,61,1,0,592
2022,1,مكتب منطقة عسير,صُنع المنتجات الجلدية والمنتجات ذات الصلة,8,4,0,0,12
2022,1,مكتب منطقة عسير,صنع المنتجات الصيدلانية الأساسية والمستحضرات الصيدلانية,2,1,0,0,3
2022,1,مكتب منطقة عسير,صُنع المنتجات الغذائية,317,109,9,1,436
2022,1,مكتب منطقة عسير,صُنع المنسوجات,38,11,2,0,51
2022,1,مكتب منطقة عسير,صُنع المواد الكيميائية والمنتجات الكيميائية,48,21,5,0,74
2022,1,مكتب منطقة عسير,صُنع الورق ومنتجات الورق,7,4,1,0,12
2022,1,مكتب منطقة عسير,صنع فحم الكوك والمنتجات النفطية المكررة,2,0,0,0,2
2022,1,مكتب منطقة عسير,صُنع منتجات التبغ,1,0,0,0,1
2022,1,مكتب منطقة عسير,صنع منتجات المطاط واللدائن,32,13,2,1,48
2022,1,مكتب منطقة عسير,صنع منتجات المعادن اللافلزية الأخرى,130,81,18,2,231
2022,1,مكتب منطقة عسير,صنع منتجات المعادن المشكلة ( باستثناء الآلات والمعدات ),325,26,4,0,355
2022,1,مكتب منطقة عسير,صيد الأسماك وتربية المائيات,68,17,0,0,85
2022,1,مكتب منطقة عسير,وكالات السفر ومشغّلو الجولات السياحية وخدمات الحجز والأنشطة المتصلة بها,19,5,0,0,24
2022,1,مكتب منطقة مكة المكرمة/جدة,أبحاث الإعلان والسوق,227,33,1,0,261
2022,1,مكتب منطقة مكة المكرمة/جدة,إصلاح أجهزة الحاسوب والسلع الشخصية والمنزلية,495,88,7,1,591
2022,1,مكتب منطقة مكة المكرمة/جدة,إصلاح وتركيب الآلات والمعدات,228,46,11,1,286
2022,1,مكتب منطقة مكة المكرمة/جدة,أنشطة أنتاج الأفلام والبرامج التلفزيونية والتسجيلات الصوتية و نشرالموسيقى,99,20,0,0,119
2022,1,مكتب منطقة مكة المكرمة/جدة,أنشطة الأمن والتحقيقات,38,18,8,3,67
2022,1,مكتب منطقة مكة المكرمة/جدة,أنشطة الاستخدام,136,27,5,3,171
2022,1,مكتب منطقة مكة المكرمة/جدة,أنشطة الاسر المعيشية التي تستخدم أفراداً للعمل المنزلي,8,0,0,0,8
2022,1,مكتب منطقة مكة المكرمة/جدة,أنشطة البرمجة الحاسوبية والخبرة الاستشارية وما يتصل بها من أنشطة,321,122,14,3,460
2022,1,مكتب منطقة مكة المكرمة/جدة,أنشطة البرمجة والإذاعة,3,2,0,0,5
2022,1,مكتب منطقة مكة المكرمة/جدة,أنشطة البريد ونقل الرسائل والطرود بواسطة مندوبين,27,3,0,0,30
2022,1,مكتب منطقة مكة المكرمة/جدة,أنشطة التشييد المتخصصة,5317,1750,130,20,7217
2022,1,مكتب منطقة مكة المكرمة/جدة,أنشطة الخدمات الشخصية الأخرى,3156,524,29,5,3714
2022,1,مكتب منطقة مكة المكرمة/جدة,أنشطة الخدمات المالية ، فيما عدا تمويل التأمين وصناديق المعاشات,94,30,6,2,132
2022,1,مكتب منطقة مكة المكرمة/جدة,أنشطة العمل الاجتماعي، دون إقامة، لكبار السن وذوي الإعاقة,136,132,13,0,281
2022,1,مكتب منطقة مكة المكرمة/جدة,أنشطة المعالجة وخدمات إدارة النفايات الأخرى,3,0,0,0,3
2022,1,مكتب منطقة مكة المكرمة/جدة,أنشطة المعمارية والهندسية ، والاختبارات الفنية والتحليل,380,238,23,4,645
2022,1,مكتب منطقة مكة المكرمة/جدة,أنشطة المكاتب الرئيسية ، وألأنشطة الاستشارية في مجال الإدارة,360,173,3,0,536
2022,1,مكتب منطقة مكة المكرمة/جدة,أنشطة المكتبات ودور المحفوظات، والمتاحف والأنشطة الثقافية الأخرى,61,47,3,1,112
2022,1,مكتب منطقة مكة المكرمة/جدة,أنشطة المنظمات الدولية,1,1,1,0,3
2022,1,مكتب منطقة مكة المكرمة/جدة,أنشطة المنظمات ذات العضوية,31,14,0,0,45
2022,1,مكتب منطقة مكة المكرمة/جدة,أنشطة النشر,86,17,2,0,105
2022,1,مكتب منطقة مكة المكرمة/جدة,أنشطة تقديم الخدمات للمباني وتجميل المواقع,1869,862,89,34,2854
2022,1,مكتب منطقة مكة المكرمة/جدة,أنشطة جمع النفايات ومعالجتها وتصريفها ، واسترجاع المواد,26,6,2,0,34
2022,1,مكتب منطقة مكة المكرمة/جدة,أنشطة خدمات الأطعمة والمشروبات,5766,1953,238,32,7989
2022,1,مكتب منطقة مكة المكرمة/جدة,أنشطة خدمات المعلومات,116,38,5,0,159
2022,1,مكتب منطقة مكة المكرمة/جدة,أنشطة خدمات دعم التعدين,40,22,5,5,72
2022,1,مكتب منطقة مكة المكرمة/جدة,أنشطة زراعة المحاصيل والإنتاج الحيواني والصيد والخدمات المتصلة,493,89,8,2,592
2022,1,مكتب منطقة مكة المكرمة/جدة,استخراج النفط الخام والغاز الطبيعي,2,0,0,0,2
2022,1,مكتب منطقة مكة المكرمة/جدة,الإدارة العامة والدفاع ؛ والضمان الاجتماعي الإلزامي,294,159,17,1,471
2022,1,مكتب منطقة مكة المكرمة/جدة,الإقامة,362,293,37,6,698
2022,1,مكتب منطقة مكة المكرمة/جدة,الأنشطة الإبداعية والفنون وأنشطة الترفيه,62,13,1,0,76
2022,1,مكتب منطقة مكة المكرمة/جدة,الأنشطة الأخرى للتعدين واستغلال المحاجر,51,16,5,2,74
2022,1,مكتب منطقة مكة المكرمة/جدة,الأنشطة الإدارية للمكاتب ، وأنشطة الدعم للمكاتب وغير ذلك من أنشطة الدعم للأعمال,496,59,7,0,562
2022,1,مكتب منطقة مكة المكرمة/جدة,الأنشطة الإيجارية,1110,147,14,3,1274
2022,1,مكتب منطقة مكة المكرمة/جدة,الأنشطة البيطرية,25,19,3,0,47
2022,1,مكتب منطقة مكة المكرمة/جدة,الأنشطة الرياضية وأنشطة التسلية والترفيه,280,93,11,1,385
2022,1,مكتب منطقة مكة المكرمة/جدة,الأنشطة العقارية,655,218,33,1,907
2022,1,مكتب منطقة مكة المكرمة/جدة,الأنشطة القانونية وأنشطة المحاسبة,236,93,5,1,335
2022,1,مكتب منطقة مكة المكرمة/جدة,الأنشطة المساعدة لأنشطة الخدمات المالية وأنشطة التأمين,25,17,7,0,49
2022,1,مكتب منطقة مكة المكرمة/جدة,الأنشطة المهنية والعلمية والتقنية الأخرى,191,26,1,0,218
2022,1,مكتب منطقة مكة المكرمة/جدة,الأنشطة غير المتميزة لإنتاج السلع والخدمات التي تقوم بها الأسر المعيشية الخاصة لإستعمالها الخاص,2,0,0,0,2
2022,1,مكتب منطقة مكة المكرمة/جدة,الاتصالات,145,50,4,0,199
2022,1,مكتب منطقة مكة المكرمة/جدة,البحث والتطوير في المجال العلمي,13,4,2,0,19
2022,1,مكتب منطقة مكة المكرمة/جدة,التخزين وأنشطة الدعم للنقل,393,180,49,12,634
2022,1,مكتب منطقة مكة المكرمة/جدة,التعليم,233,261,90,12,596
2022,1,مكتب منطقة مكة المكرمة/جدة,الحراجة وقطع الأخشاب,5,0,0,1,6
2022,1,مكتب منطقة مكة المكرمة/جدة,الرعاية مع الإقامة,12,11,0,0,23
2022,1,مكتب منطقة مكة المكرمة/جدة,الصحة البشرية,248,356,124,35,763
2022,1,مكتب منطقة مكة المكرمة/جدة,الصرف الصحي,11,13,1,1,26
2022,1,مكتب منطقة مكة المكرمة/جدة,الصناعة التحويلية الأخرى,94,81,8,3,186
2022,1,مكتب منطقة مكة المكرمة/جدة,الطباعة واستنساخ وسائط الأعلام المسجّلة,202,134,28,2,366
2022,1,مكتب منطقة مكة المكرمة/جدة,النقل البري و النقل عبر الأنابيب,1223,370,53,13,1659
2022,1,مكتب منطقة مكة المكرمة/جدة,النقل الجوي,47,53,18,10,128
2022,1,مكتب منطقة مكة المكرمة/جدة,النقل المائي,67,37,9,5,118
2022,1,مكتب منطقة مكة المكرمة/جدة,الهندسة المدنية,96,35,11,1,143
2022,1,مكتب منطقة مكة المكرمة/جدة,تجارة التجزئة، باستثناء المركبات ذات المحركات والدراجات النارية,10540,3051,287,65,13943
2022,1,مكتب منطقة مكة المكرمة/جدة,تجارة الجملة ، باستثناء المركبات ذات المحركات والدراجات النارية,8739,4501,480,92,13812
2022,1,مكتب منطقة مكة المكرمة/جدة,تجارة الجملة والتجزئة ، وإصلاح المركبات ذات المحركات والدراجات النارية,3091,793,60,19,3963
2022,1,مكتب منطقة مكة المكرمة/جدة,تجميع المياه ومعالجتها وتوصيلها,57,24,2,3,86
2022,1,مكتب منطقة مكة المكرمة/جدة,تشييد المباني,8150,3300,406,110,11966
2022,1,مكتب منطقة مكة المكرمة/جدة,تعدين الفحم والليغنيت,4,3,0,0,7
2022,1,مكتب منطقة مكة المكرمة/جدة,تعدين ركازات الفلزات,30,16,6,3,55
2022,1,مكتب منطقة مكة المكرمة/جدة,تمويل التأمين وإعادة التأمين وصناديق المعاشات التقاعدية باستثناء الضمان الاجتماعي الإلزامي,8,26,10,4,48
2022,1,مكتب منطقة مكة المكرمة/جدة,توصيل الكهرباء والغاز والبخار وتكييف الهواء,47,31,12,7,97
2022,1,مكتب منطقة مكة المكرمة/جدة,صناعة الآلات والمعدات غير المصنفة في موضع أخر,66,21,6,1,94
2022,1,مكتب منطقة مكة المكرمة/جدة,صناعة المركبات ذات المحركات والمركبات المقطورة ونصف المقطورة,72,27,6,0,105
2022,1,مكتب منطقة مكة المكرمة/جدة,صناعة معدات النقل الأخرى,55,21,4,2,82
2022,1,مكتب منطقة مكة المكرمة/جدة,صنع الأثاث,218,109,21,2,350
2022,1,مكتب منطقة مكة المكرمة/جدة,صنع الحواسيب والمنتجات الإلكترونية والبصرية,132,70,17,1,220
2022,1,مكتب منطقة مكة المكرمة/جدة,صُنع الخشب ومنتجات الخشب والفلين ، باستثناء الأثاث ، صُنع أصناف من القش ومواد الضفر,238,64,17,3,322
2022,1,مكتب منطقة مكة المكرمة/جدة,صنع الفلزات القاعدية,99,110,34,8,251
2022,1,مكتب منطقة مكة المكرمة/جدة,صُنع المشروبات,57,38,12,5,112
2022,1,مكتب منطقة مكة المكرمة/جدة,صنع المعدات الكهربائية,147,70,14,2,233
2022,1,مكتب منطقة مكة المكرمة/جدة,صُنع الملبوسات,1018,190,13,2,1223
2022,1,مكتب منطقة مكة المكرمة/جدة,صُنع المنتجات الجلدية والمنتجات ذات الصلة,14,10,2,0,26
2022,1,مكتب منطقة مكة المكرمة/جدة,صنع المنتجات الصيدلانية الأساسية والمستحضرات الصيدلانية,12,12,6,1,31
2022,1,مكتب منطقة مكة المكرمة/جدة,صُنع المنتجات الغذائية,695,392,64,25,1176
2022,1,مكتب منطقة مكة المكرمة/جدة,صُنع المنسوجات,77,40,15,3,135
2022,1,مكتب منطقة مكة المكرمة/جدة,صُنع المواد الكيميائية والمنتجات الكيميائية,209,131,38,5,383
2022,1,مكتب منطقة مكة المكرمة/جدة,صُنع الورق ومنتجات الورق,38,42,12,5,97
2022,1,مكتب منطقة مكة المكرمة/جدة,صنع فحم الكوك والمنتجات النفطية المكررة,11,14,1,0,26
2022,1,مكتب منطقة مكة المكرمة/جدة,صُنع منتجات التبغ,4,4,0,0,8
2022,1,مكتب منطقة مكة المكرمة/جدة,صنع منتجات المطاط واللدائن,76,106,48,8,238
2022,1,مكتب منطقة مكة المكرمة/جدة,صنع منتجات المعادن اللافلزية الأخرى,137,95,30,13,275
2022,1,مكتب منطقة مكة المكرمة/جدة,صنع منتجات المعادن المشكلة ( باستثناء الآلات والمعدات ),277,109,43,8,437
2022,1,مكتب منطقة مكة المكرمة/جدة,صيد الأسماك وتربية المائيات,154,58,0,0,212
2022,1,مكتب منطقة مكة المكرمة/جدة,وكالات السفر ومشغّلو الجولات السياحية وخدمات الحجز والأنشطة المتصلة بها,160,87,7,0,254
2022,1,مكتب منطقة نجران,أبحاث الإعلان والسوق,8,2,0,0,10
2022,1,مكتب منطقة نجران,إصلاح أجهزة الحاسوب والسلع الشخصية والمنزلية,66,6,0,0,72
2022,1,مكتب منطقة نجران,إصلاح وتركيب الآلات والمعدات,38,5,0,1,44
2022,1,مكتب منطقة نجران,أنشطة أنتاج الأفلام والبرامج التلفزيونية والتسجيلات الصوتية و نشرالموسيقى,2,0,0,0,2
2022,1,مكتب منطقة نجران,أنشطة الأمن والتحقيقات,1,0,0,1,2
2022,1,مكتب منطقة نجران,أنشطة الاستخدام,15,2,0,0,17
2022,1,مكتب منطقة نجران,أنشطة الاسر المعيشية التي تستخدم أفراداً للعمل المنزلي,5,0,0,0,5
2022,1,مكتب منطقة نجران,أنشطة البرمجة الحاسوبية والخبرة الاستشارية وما يتصل بها من أنشطة,5,1,0,0,6
2022,1,مكتب منطقة نجران,أنشطة البريد ونقل الرسائل والطرود بواسطة مندوبين,1,0,0,0,1
2022,1,مكتب منطقة نجران,أنشطة التشييد المتخصصة,1409,244,16,6,1675
2022,1,مكتب منطقة نجران,أنشطة الخدمات الشخصية الأخرى,513,37,0,0,550
2022,1,مكتب منطقة نجران,أنشطة الخدمات المالية ، فيما عدا تمويل التأمين وصناديق المعاشات,21,1,0,0,22
2022,1,مكتب منطقة نجران,أنشطة العمل الاجتماعي، دون إقامة، لكبار السن وذوي الإعاقة,22,5,0,0,27
2022,1,مكتب منطقة نجران,أنشطة المعالجة وخدمات إدارة النفايات الأخرى,0,1,0,0,1
2022,1,مكتب منطقة نجران,أنشطة المعمارية والهندسية ، والاختبارات الفنية والتحليل,46,19,2,0,67
2022,1,مكتب منطقة نجران,أنشطة المكاتب الرئيسية ، وألأنشطة الاستشارية في مجال الإدارة,12,2,0,0,14
2022,1,مكتب منطقة نجران,أنشطة المكتبات ودور المحفوظات، والمتاحف والأنشطة الثقافية الأخرى,23,2,0,0,25
2022,1,مكتب منطقة نجران,أنشطة المنظمات الدولية,2,0,0,0,2
2022,1,مكتب منطقة نجران,أنشطة المنظمات ذات العضوية,17,0,0,0,17
2022,1,مكتب منطقة نجران,أنشطة النشر,14,5,0,0,19
2022,1,مكتب منطقة نجران,أنشطة تقديم الخدمات للمباني وتجميل المواقع,186,29,4,4,223
2022,1,مكتب منطقة نجران,أنشطة جمع النفايات ومعالجتها وتصريفها ، واسترجاع المواد,4,0,0,0,4
2022,1,مكتب منطقة نجران,أنشطة خدمات الأطعمة والمشروبات,1139,230,14,2,1385
2022,1,مكتب منطقة نجران,أنشطة خدمات المعلومات,1,1,0,0,2
2022,1,مكتب منطقة نجران,أنشطة خدمات دعم التعدين,4,3,0,0,7
2022,1,مكتب منطقة نجران,أنشطة زراعة المحاصيل والإنتاج الحيواني والصيد والخدمات المتصلة,518,18,4,0,540
2022,1,مكتب منطقة نجران,استخراج النفط الخام والغاز الطبيعي,1,0,0,0,1
2022,1,مكتب منطقة نجران,الإدارة العامة والدفاع ؛ والضمان الاجتماعي الإلزامي,50,18,1,0,69
2022,1,مكتب منطقة نجران,الإقامة,68,24,1,1,94
2022,1,مكتب منطقة نجران,الأنشطة الإبداعية والفنون وأنشطة الترفيه,3,0,0,0,3
2022,1,مكتب منطقة نجران,الأنشطة الأخرى للتعدين واستغلال المحاجر,7,0,0,1,8
2022,1,مكتب منطقة نجران,الأنشطة الإدارية للمكاتب ، وأنشطة الدعم للمكاتب وغير ذلك من أنشطة الدعم للأعمال,30,1,0,0,31
2022,1,مكتب منطقة نجران,الأنشطة الإيجارية,1198,79,2,2,1281
2022,1,مكتب منطقة نجران,الأنشطة البيطرية,2,3,0,0,5
2022,1,مكتب منطقة نجران,الأنشطة الرياضية وأنشطة التسلية والترفيه,26,9,0,1,36
2022,1,مكتب منطقة نجران,الأنشطة العقارية,32,4,0,0,36
2022,1,مكتب منطقة نجران,الأنشطة القانونية وأنشطة المحاسبة,4,0,0,0,4
2022,1,مكتب منطقة نجران,الأنشطة المساعدة لأنشطة الخدمات المالية وأنشطة التأمين,0,1,0,0,1
2022,1,مكتب منطقة نجران,الأنشطة المهنية والعلمية والتقنية الأخرى,20,0,0,0,20
2022,1,مكتب منطقة نجران,الاتصالات,18,1,0,0,19
2022,1,مكتب منطقة نجران,التخزين وأنشطة الدعم للنقل,225,72,2,0,299
2022,1,مكتب منطقة نجران,التعليم,16,14,6,0,36
2022,1,مكتب منطقة نجران,الحراجة وقطع الأخشاب,1,0,0,0,1
2022,1,مكتب منطقة نجران,الرعاية مع الإقامة,4,1,0,0,5
2022,1,مكتب منطقة نجران,الصحة البشرية,14,47,12,1,74
2022,1,مكتب منطقة نجران,الصناعة التحويلية الأخرى,6,1,1,0,8
2022,1,مكتب منطقة نجران,الطباعة واستنساخ وسائط الأعلام المسجّلة,10,2,0,0,12
2022,1,مكتب منطقة نجران,النقل البري و النقل عبر الأنابيب,787,83,0,1,871
2022,1,مكتب منطقة نجران,النقل الجوي,7,3,0,0,10
2022,1,مكتب منطقة نجران,النقل المائي,12,0,0,0,12
2022,1,مكتب منطقة نجران,الهندسة المدنية,13,3,2,3,21
2022,1,مكتب منطقة نجران,تجارة التجزئة، باستثناء المركبات ذات المحركات والدراجات النارية,1479,356,23,3,1861
2022,1,مكتب منطقة نجران,تجارة الجملة ، باستثناء المركبات ذات المحركات والدراجات النارية,459,96,11,1,567
2022,1,مكتب منطقة نجران,تجارة الجملة والتجزئة ، وإصلاح المركبات ذات المحركات والدراجات النارية,533,96,3,0,632
2022,1,مكتب منطقة نجران,تجميع المياه ومعالجتها وتوصيلها,19,4,0,0,23
2022,1,مكتب منطقة نجران,تشييد المباني,2329,546,71,15,2961
2022,1,مكتب منطقة نجران,تعدين الفحم والليغنيت,1,0,0,0,1
2022,1,مكتب منطقة نجران,تعدين ركازات الفلزات,10,1,1,0,12
2022,1,مكتب منطقة نجران,توصيل الكهرباء والغاز والبخار وتكييف الهواء,3,1,1,0,5
2022,1,مكتب منطقة نجران,صناعة الآلات والمعدات غير المصنفة في موضع أخر,11,2,0,0,13
2022,1,مكتب منطقة نجران,صناعة المركبات ذات المحركات والمركبات المقطورة ونصف المقطورة,15,2,0,0,17
2022,1,مكتب منطقة نجران,صناعة معدات النقل الأخرى,8,3,0,0,11
2022,1,مكتب منطقة نجران,صنع الأثاث,83,22,1,0,106
2022,1,مكتب منطقة نجران,صنع الحواسيب والمنتجات الإلكترونية والبصرية,17,2,0,0,19
2022,1,مكتب منطقة نجران,صُنع الخشب ومنتجات الخشب والفلين ، باستثناء الأثاث ، صُنع أصناف من القش ومواد الضفر,68,9,0,0,77
2022,1,مكتب منطقة نجران,صنع الفلزات القاعدية,80,16,2,0,98
2022,1,مكتب منطقة نجران,صُنع المشروبات,5,0,1,0,6
2022,1,مكتب منطقة نجران,صنع المعدات الكهربائية,16,2,0,0,18
2022,1,مكتب منطقة نجران,صُنع الملبوسات,295,29,0,0,324
2022,1,مكتب منطقة نجران,صُنع المنتجات الجلدية والمنتجات ذات الصلة,4,0,0,0,4
2022,1,مكتب منطقة نجران,صنع المنتجات الصيدلانية الأساسية والمستحضرات الصيدلانية,3,0,0,0,3
2022,1,مكتب منطقة نجران,صُنع المنتجات الغذائية,122,29,1,0,152
2022,1,مكتب منطقة نجران,صُنع المنسوجات,36,4,0,0,40
2022,1,مكتب منطقة نجران,صُنع المواد الكيميائية والمنتجات الكيميائية,17,5,1,0,23
2022,1,مكتب منطقة نجران,صُنع الورق ومنتجات الورق,12,4,1,0,17
2022,1,مكتب منطقة نجران,صنع منتجات المطاط واللدائن,16,3,0,0,19
2022,1,مكتب منطقة نجران,صنع منتجات المعادن اللافلزية الأخرى,59,17,8,1,85
2022,1,مكتب منطقة نجران,صنع منتجات المعادن المشكلة ( باستثناء الآلات والمعدات ),148,23,4,0,175
2022,1,مكتب منطقة نجران,صيد الأسماك وتربية المائيات,3,1,0,0,4
2022,1,مكتب منطقة نجران,وكالات السفر ومشغّلو الجولات السياحية وخدمات الحجز والأنشطة المتصلة بها,6,2,0,0,8
2022,1,المركز الرئيسي,أنشطة التشييد المتخصصة,0,1,0,0,1
2022,1,المركز الرئيسي,أنشطة الخدمات الشخصية الأخرى,1,0,0,0,1
2022,1,المركز الرئيسي,أنشطة خدمات الأطعمة والمشروبات,4,2,0,0,6
2022,1,المركز الرئيسي,أنشطة زراعة المحاصيل والإنتاج الحيواني والصيد والخدمات المتصلة,1,2,0,0,3
2022,1,المركز الرئيسي,الأنشطة الإيجارية,2,0,0,0,2
2022,1,المركز الرئيسي,الأنشطة الرياضية وأنشطة التسلية والترفيه,1,0,0,0,1
2022,1,المركز الرئيسي,الأنشطة القانونية وأنشطة المحاسبة,1,0,0,0,1
2022,1,المركز الرئيسي,تجارة التجزئة، باستثناء المركبات ذات المحركات والدراجات النارية,2,1,0,0,3
2022,1,المركز الرئيسي,تجارة الجملة والتجزئة ، وإصلاح المركبات ذات المحركات والدراجات النارية,4,0,0,0,4
2022,1,المركز الرئيسي,تشييد المباني,2,0,0,0,2
2022,1,المركز الرئيسي,صُنع الملبوسات,1,0,0,0,1
2022,1,المركز الرئيسي,صُنع المنتجات الغذائية,0,1,0,0,1
2022,1,المركز الرئيسي,صُنع المنسوجات,1,0,0,0,1
2022,1,المركز الرئيسي,صيد الأسماك وتربية المائيات,0,1,0,0,1
2022,1,مكتب المنطقة الشرقية,أبحاث الإعلان والسوق,143,34,1,0,178
2022,1,مكتب المنطقة الشرقية,إصلاح أجهزة الحاسوب والسلع الشخصية والمنزلية,316,72,9,1,398
2022,1,مكتب المنطقة الشرقية,إصلاح وتركيب الآلات والمعدات,230,85,8,2,325
2022,1,مكتب المنطقة الشرقية,أنشطة أنتاج الأفلام والبرامج التلفزيونية والتسجيلات الصوتية و نشرالموسيقى,30,4,0,0,34
2022,1,مكتب المنطقة الشرقية,أنشطة الأمن والتحقيقات,24,18,11,4,57
2022,1,مكتب المنطقة الشرقية,أنشطة الاستخدام,89,26,3,6,124
2022,1,مكتب المنطقة الشرقية,أنشطة الاسر المعيشية التي تستخدم أفراداً للعمل المنزلي,2,0,0,0,2
2022,1,مكتب المنطقة الشرقية,أنشطة البرمجة الحاسوبية والخبرة الاستشارية وما يتصل بها من أنشطة,143,54,10,1,208
2022,1,مكتب المنطقة الشرقية,أنشطة البرمجة والإذاعة,1,1,0,0,2
2022,1,مكتب المنطقة الشرقية,أنشطة البريد ونقل الرسائل والطرود بواسطة مندوبين,17,3,0,0,20
2022,1,مكتب المنطقة الشرقية,أنشطة التشييد المتخصصة,2647,996,117,19,3779
2022,1,مكتب المنطقة الشرقية,أنشطة الخدمات الشخصية الأخرى,2230,411,29,3,2673
2022,1,مكتب المنطقة الشرقية,أنشطة الخدمات المالية ، فيما عدا تمويل التأمين وصناديق المعاشات,45,14,6,1,66
2022,1,مكتب المنطقة الشرقية,أنشطة العمل الاجتماعي، دون إقامة، لكبار السن وذوي الإعاقة,66,82,3,0,151
2022,1,مكتب المنطقة الشرقية,أنشطة المعالجة وخدمات إدارة النفايات الأخرى,3,2,1,0,6
2022,1,مكتب المنطقة الشرقية,أنشطة المعمارية والهندسية ، والاختبارات الفنية والتحليل,201,168,43,17,429
2022,1,مكتب المنطقة الشرقية,أنشطة المكاتب الرئيسية ، وألأنشطة الاستشارية في مجال الإدارة,155,57,8,1,221
2022,1,مكتب المنطقة الشرقية,أنشطة المكتبات ودور المحفوظات، والمتاحف والأنشطة الثقافية الأخرى,53,24,0,0,77
2022,1,مكتب المنطقة الشرقية,أنشطة المنظمات الدولية,0,1,0,0,1
2022,1,مكتب المنطقة الشرقية,أنشطة المنظمات ذات العضوية,22,4,1,0,27
2022,1,مكتب المنطقة الشرقية,أنشطة النشر,34,11,0,0,45
2022,1,مكتب المنطقة الشرقية,أنشطة تقديم الخدمات للمباني وتجميل المواقع,1412,770,127,40,2349
2022,1,مكتب المنطقة الشرقية,أنشطة جمع النفايات ومعالجتها وتصريفها ، واسترجاع المواد,13,12,1,2,28
2022,1,مكتب المنطقة الشرقية,أنشطة خدمات الأطعمة والمشروبات,3710,1581,183,23,5497
2022,1,مكتب المنطقة الشرقية,أنشطة خدمات المعلومات,51,19,1,0,71
2022,1,مكتب المنطقة الشرقية,أنشطة خدمات دعم التعدين,131,126,65,40,362
2022,1,مكتب المنطقة الشرقية,أنشطة زراعة المحاصيل والإنتاج الحيواني والصيد والخدمات المتصلة,427,67,8,0,502
2022,1,مكتب المنطقة الشرقية,استخراج النفط الخام والغاز الطبيعي,1,1,1,0,3
2022,1,مكتب المنطقة الشرقية,الإدارة العامة والدفاع ؛ والضمان الاجتماعي الإلزامي,190,120,30,3,343
2022,1,مكتب المنطقة الشرقية,الإقامة,169,157,23,1,350
2022,1,مكتب المنطقة الشرقية,الأنشطة الإبداعية والفنون وأنشطة الترفيه,18,1,0,0,19
2022,1,مكتب المنطقة الشرقية,الأنشطة الأخرى للتعدين واستغلال المحاجر,44,25,10,1,80
2022,1,مكتب المنطقة الشرقية,الأنشطة الإدارية للمكاتب ، وأنشطة الدعم للمكاتب وغير ذلك من أنشطة الدعم للأعمال,203,34,2,1,240
2022,1,مكتب المنطقة الشرقية,الأنشطة الإيجارية,668,142,23,7,840
2022,1,مكتب المنطقة الشرقية,الأنشطة البيطرية,7,9,2,0,18
2022,1,مكتب المنطقة الشرقية,الأنشطة الرياضية وأنشطة التسلية والترفيه,166,69,4,1,240
2022,1,مكتب المنطقة الشرقية,الأنشطة العقارية,280,131,12,2,425
2022,1,مكتب المنطقة الشرقية,الأنشطة القانونية وأنشطة المحاسبة,102,47,2,0,151
2022,1,مكتب المنطقة الشرقية,الأنشطة المساعدة لأنشطة الخدمات المالية وأنشطة التأمين,11,14,2,1,28
2022,1,مكتب المنطقة الشرقية,الأنشطة المهنية والعلمية والتقنية الأخرى,90,18,0,0,108
2022,1,مكتب المنطقة الشرقية,الأنشطة غير المتميزة لإنتاج السلع والخدمات التي تقوم بها الأسر المعيشية الخاصة لإستعمالها الخاص,1,1,0,0,2
2022,1,مكتب المنطقة الشرقية,الاتصالات,64,19,0,0,83
2022,1,مكتب المنطقة الشرقية,البحث والتطوير في المجال العلمي,6,3,1,0,10
2022,1,مكتب المنطقة الشرقية,التخزين وأنشطة الدعم للنقل,282,124,32,5,443
2022,1,مكتب المنطقة الشرقية,التعليم,154,171,55,13,393
2022,1,مكتب المنطقة الشرقية,الحراجة وقطع الأخشاب,2,1,0,0,3
2022,1,مكتب المنطقة الشرقية,الرعاية مع الإقامة,8,6,1,0,15
2022,1,مكتب المنطقة الشرقية,الصحة البشرية,91,151,63,25,330
2022,1,مكتب المنطقة الشرقية,الصرف الصحي,11,7,1,1,20
2022,1,مكتب المنطقة الشرقية,الصناعة التحويلية الأخرى,66,35,4,0,105
2022,1,مكتب المنطقة الشرقية,الطباعة واستنساخ وسائط الأعلام المسجّلة,111,71,8,0,190
2022,1,مكتب المنطقة الشرقية,النقل البري و النقل عبر الأنابيب,1003,317,68,23,1411
2022,1,مكتب المنطقة الشرقية,النقل الجوي,75,72,34,6,187
2022,1,مكتب المنطقة الشرقية,النقل المائي,29,18,6,0,53
2022,1,مكتب المنطقة الشرقية,الهندسة المدنية,123,61,16,2,202
2022,1,مكتب المنطقة الشرقية,تجارة التجزئة، باستثناء المركبات ذات المحركات والدراجات النارية,5614,1995,215,38,7862
2022,1,مكتب المنطقة الشرقية,تجارة الجملة ، باستثناء المركبات ذات المحركات والدراجات النارية,2634,1410,223,49,4316
2022,1,مكتب المنطقة الشرقية,تجارة الجملة والتجزئة ، وإصلاح المركبات ذات المحركات والدراجات النارية,2280,752,30,5,3067
2022,1,مكتب المنطقة الشرقية,تجميع المياه ومعالجتها وتوصيلها,26,15,1,1,43
2022,1,مكتب المنطقة الشرقية,تشييد المباني,4379,2635,537,204,7755
2022,1,مكتب المنطقة الشرقية,تعدين الفحم والليغنيت,6,0,0,0,6
2022,1,مكتب المنطقة الشرقية,تعدين ركازات الفلزات,85,80,12,2,179
2022,1,مكتب المنطقة الشرقية,تمويل التأمين وإعادة التأمين وصناديق المعاشات التقاعدية باستثناء الضمان الاجتماعي الإلزامي,5,12,3,4,24
2022,1,مكتب المنطقة الشرقية,توصيل الكهرباء والغاز والبخار وتكييف الهواء,36,54,15,4,109
2022,1,مكتب المنطقة الشرقية,صناعة الآلات والمعدات غير المصنفة في موضع أخر,50,35,10,2,97
2022,1,مكتب المنطقة الشرقية,صناعة المركبات ذات المحركات والمركبات المقطورة ونصف المقطورة,22,11,0,0,33
2022,1,مكتب المنطقة الشرقية,صناعة معدات النقل الأخرى,22,12,6,1,41
2022,1,مكتب المنطقة الشرقية,صنع الأثاث,302,117,8,1,428
2022,1,مكتب المنطقة الشرقية,صنع الحواسيب والمنتجات الإلكترونية والبصرية,98,53,10,3,164
2022,1,مكتب المنطقة الشرقية,صُنع الخشب ومنتجات الخشب والفلين ، باستثناء الأثاث ، صُنع أصناف من القش ومواد الضفر,256,160,21,8,445
2022,1,مكتب المنطقة الشرقية,صنع الفلزات القاعدية,115,116,50,9,290
2022,1,مكتب المنطقة الشرقية,صُنع المشروبات,19,15,3,1,38
2022,1,مكتب المنطقة الشرقية,صنع المعدات الكهربائية,174,78,16,3,271
2022,1,مكتب المنطقة الشرقية,صُنع الملبوسات,767,175,7,0,949
2022,1,مكتب المنطقة الشرقية,صُنع المنتجات الجلدية والمنتجات ذات الصلة,5,1,0,0,6
2022,1,مكتب المنطقة الشرقية,صنع المنتجات الصيدلانية الأساسية والمستحضرات الصيدلانية,3,4,3,0,10
2022,1,مكتب المنطقة الشرقية,صُنع المنتجات الغذائية,445,213,50,9,717
2022,1,مكتب المنطقة الشرقية,صُنع المنسوجات,146,87,8,0,241
2022,1,مكتب المنطقة الشرقية,صُنع المواد الكيميائية والمنتجات الكيميائية,123,73,16,0,212
2022,1,مكتب المنطقة الشرقية,صُنع الورق ومنتجات الورق,25,20,10,0,55
2022,1,مكتب المنطقة الشرقية,صنع فحم الكوك والمنتجات النفطية المكررة,11,16,3,2,32
2022,1,مكتب المنطقة الشرقية,صُنع منتجات التبغ,2,1,0,0,3
2022,1,مكتب المنطقة الشرقية,صنع منتجات المطاط واللدائن,54,79,63,10,206
2022,1,مكتب المنطقة الشرقية,صنع منتجات المعادن اللافلزية الأخرى,163,107,34,8,312
2022,1,مكتب المنطقة الشرقية,صنع منتجات المعادن المشكلة ( باستثناء الآلات والمعدات ),393,243,69,17,722
2022,1,مكتب المنطقة الشرقية,صيد الأسماك وتربية المائيات,247,168,5,0,420
2022,1,مكتب المنطقة الشرقية,وكالات السفر ومشغّلو الجولات السياحية وخدمات الحجز والأنشطة المتصلة بها,80,36,6,0,122
2022,1,مكتب محافظة الأحساء,أبحاث الإعلان والسوق,21,3,0,0,24
2022,1,مكتب محافظة الأحساء,إصلاح أجهزة الحاسوب والسلع الشخصية والمنزلية,124,21,2,0,147
2022,1,مكتب محافظة الأحساء,إصلاح وتركيب الآلات والمعدات,61,5,0,0,66
2022,1,مكتب محافظة الأحساء,أنشطة أنتاج الأفلام والبرامج التلفزيونية والتسجيلات الصوتية و نشرالموسيقى,7,0,0,0,7
2022,1,مكتب محافظة الأحساء,أنشطة الأمن والتحقيقات,3,3,2,0,8
2022,1,مكتب محافظة الأحساء,أنشطة الاستخدام,30,4,0,0,34
2022,1,مكتب محافظة الأحساء,أنشطة الاسر المعيشية التي تستخدم أفراداً للعمل المنزلي,1,0,0,0,1
2022,1,مكتب محافظة الأحساء,أنشطة البرمجة الحاسوبية والخبرة الاستشارية وما يتصل بها من أنشطة,9,4,0,0,13
2022,1,مكتب محافظة الأحساء,أنشطة البرمجة والإذاعة,1,0,0,0,1
2022,1,مكتب محافظة الأحساء,أنشطة البريد ونقل الرسائل والطرود بواسطة مندوبين,1,2,0,0,3
2022,1,مكتب محافظة الأحساء,أنشطة التشييد المتخصصة,908,209,10,3,1130
2022,1,مكتب محافظة الأحساء,أنشطة الخدمات الشخصية الأخرى,937,132,3,1,1073
2022,1,مكتب محافظة الأحساء,أنشطة الخدمات المالية ، فيما عدا تمويل التأمين وصناديق المعاشات,21,2,1,0,24
2022,1,مكتب محافظة الأحساء,أنشطة العمل الاجتماعي، دون إقامة، لكبار السن وذوي الإعاقة,18,25,2,0,45
2022,1,مكتب محافظة الأحساء,أنشطة المعالجة وخدمات إدارة النفايات الأخرى,0,1,0,0,1
2022,1,مكتب محافظة الأحساء,أنشطة المعمارية والهندسية ، والاختبارات الفنية والتحليل,34,31,4,0,69
2022,1,مكتب محافظة الأحساء,أنشطة المكاتب الرئيسية ، وألأنشطة الاستشارية في مجال الإدارة,27,4,0,0,31
2022,1,مكتب محافظة الأحساء,أنشطة المكتبات ودور المحفوظات، والمتاحف والأنشطة الثقافية الأخرى,33,9,0,0,42
2022,1,مكتب محافظة الأحساء,أنشطة المنظمات ذات العضوية,6,1,1,0,8
2022,1,مكتب محافظة الأحساء,أنشطة النشر,4,1,0,0,5
2022,1,مكتب محافظة الأحساء,أنشطة تقديم الخدمات للمباني وتجميل المواقع,191,50,4,0,245
2022,1,مكتب محافظة الأحساء,أنشطة جمع النفايات ومعالجتها وتصريفها ، واسترجاع المواد,2,2,0,0,4
2022,1,مكتب محافظة الأحساء,أنشطة خدمات الأطعمة والمشروبات,1347,572,31,2,1952
2022,1,مكتب محافظة الأحساء,أنشطة خدمات المعلومات,8,2,0,0,10
2022,1,مكتب محافظة الأحساء,أنشطة خدمات دعم التعدين,8,13,0,0,21
2022,1,مكتب محافظة الأحساء,أنشطة زراعة المحاصيل والإنتاج الحيواني والصيد والخدمات المتصلة,331,49,6,0,386
2022,1,مكتب محافظة الأحساء,الإدارة العامة والدفاع ؛ والضمان الاجتماعي الإلزامي,27,14,1,0,42
2022,1,مكتب محافظة الأحساء,الإقامة,49,27,4,0,80
2022,1,مكتب محافظة الأحساء,الأنشطة الإبداعية والفنون وأنشطة الترفيه,6,1,0,0,7
2022,1,مكتب محافظة الأحساء,الأنشطة الأخرى للتعدين واستغلال المحاجر,17,3,0,0,20
2022,1,مكتب محافظة الأحساء,الأنشطة الإدارية للمكاتب ، وأنشطة الدعم للمكاتب وغير ذلك من أنشطة الدعم للأعمال,42,9,0,0,51
2022,1,مكتب محافظة الأحساء,الأنشطة الإيجارية,299,46,6,2,353
2022,1,مكتب محافظة الأحساء,الأنشطة البيطرية,5,1,0,0,6
2022,1,مكتب محافظة الأحساء,الأنشطة الرياضية وأنشطة التسلية والترفيه,34,15,1,0,50
2022,1,مكتب محافظة الأحساء,الأنشطة العقارية,41,8,2,0,51
2022,1,مكتب محافظة الأحساء,الأنشطة القانونية وأنشطة المحاسبة,14,2,1,0,17
2022,1,مكتب محافظة الأحساء,الأنشطة المساعدة لأنشطة الخدمات المالية وأنشطة التأمين,2,0,0,0,2
2022,1,مكتب محافظة الأحساء,الأنشطة المهنية والعلمية والتقنية الأخرى,34,1,0,0,35
2022,1,مكتب محافظة الأحساء,الاتصالات,18,6,0,0,24
2022,1,مكتب محافظة الأحساء,التخزين وأنشطة الدعم للنقل,66,15,1,1,83
2022,1,مكتب محافظة الأحساء,التعليم,37,32,11,1,81
2022,1,مكتب محافظة الأحساء,الرعاية مع الإقامة,3,0,1,0,4
2022,1,مكتب محافظة الأحساء,الصحة البشرية,30,60,14,6,110
2022,1,مكتب محافظة الأحساء,الصرف الصحي,2,0,0,0,2
2022,1,مكتب محافظة الأحساء,الصناعة التحويلية الأخرى,20,3,0,0,23
2022,1,مكتب محافظة الأحساء,الطباعة واستنساخ وسائط الأعلام المسجّلة,35,7,1,1,44
2022,1,مكتب محافظة الأحساء,النقل البري و النقل عبر الأنابيب,242,44,7,2,295
2022,1,مكتب محافظة الأحساء,النقل الجوي,9,5,1,0,15
2022,1,مكتب محافظة الأحساء,النقل المائي,3,0,0,0,3
2022,1,مكتب محافظة الأحساء,الهندسة المدنية,19,7,1,0,27
2022,1,مكتب محافظة الأحساء,تجارة التجزئة، باستثناء المركبات ذات المحركات والدراجات النارية,1977,478,36,3,2494
2022,1,مكتب محافظة الأحساء,تجارة الجملة ، باستثناء المركبات ذات المحركات والدراجات النارية,550,144,10,3,707
2022,1,مكتب محافظة الأحساء,تجارة الجملة والتجزئة ، وإصلاح المركبات ذات المحركات والدراجات النارية,798,192,5,0,995
2022,1,مكتب محافظة الأحساء,تجميع المياه ومعالجتها وتوصيلها,10,9,0,0,19
2022,1,مكتب محافظة الأحساء,تشييد المباني,1583,665,58,17,2323
2022,1,مكتب محافظة الأحساء,تعدين الفحم والليغنيت,2,1,0,0,3
2022,1,مكتب محافظة الأحساء,تعدين ركازات الفلزات,26,8,1,1,36
2022,1,مكتب محافظة الأحساء,تمويل التأمين وإعادة التأمين وصناديق المعاشات التقاعدية باستثناء الضمان الاجتماعي الإلزامي,0,1,0,0,1
2022,1,مكتب محافظة الأحساء,توصيل الكهرباء والغاز والبخار وتكييف الهواء,10,4,0,0,14
2022,1,مكتب محافظة الأحساء,صناعة الآلات والمعدات غير المصنفة في موضع أخر,16,6,1,0,23
2022,1,مكتب محافظة الأحساء,صناعة المركبات ذات المحركات والمركبات المقطورة ونصف المقطورة,9,1,0,0,10
2022,1,مكتب محافظة الأحساء,صناعة معدات النقل الأخرى,15,1,0,0,16
2022,1,مكتب محافظة الأحساء,صنع الأثاث,139,43,1,0,183
2022,1,مكتب محافظة الأحساء,صنع الحواسيب والمنتجات الإلكترونية والبصرية,87,21,1,0,109
2022,1,مكتب محافظة الأحساء,صُنع الخشب ومنتجات الخشب والفلين ، باستثناء الأثاث ، صُنع أصناف من القش ومواد الضفر,57,20,1,1,79
2022,1,مكتب محافظة الأحساء,صنع الفلزات القاعدية,54,15,0,0,69
2022,1,مكتب محافظة الأحساء,صُنع المشروبات,5,9,0,0,14
2022,1,مكتب محافظة الأحساء,صنع المعدات الكهربائية,47,24,2,0,73
2022,1,مكتب محافظة الأحساء,صُنع الملبوسات,503,68,2,0,573
2022,1,مكتب محافظة الأحساء,صُنع المنتجات الجلدية والمنتجات ذات الصلة,6,1,0,0,7
2022,1,مكتب محافظة الأحساء,صنع المنتجات الصيدلانية الأساسية والمستحضرات الصيدلانية,3,3,0,0,6
2022,1,مكتب محافظة الأحساء,صُنع المنتجات الغذائية,240,87,14,4,345
2022,1,مكتب محافظة الأحساء,صُنع المنسوجات,36,9,1,0,46
2022,1,مكتب محافظة الأحساء,صُنع المواد الكيميائية والمنتجات الكيميائية,29,7,3,0,39
2022,1,مكتب محافظة الأحساء,صُنع الورق ومنتجات الورق,2,2,1,0,5
2022,1,مكتب محافظة الأحساء,صنع فحم الكوك والمنتجات النفطية المكررة,0,1,1,0,2
2022,1,مكتب محافظة الأحساء,صُنع منتجات التبغ,2,1,0,0,3
2022,1,مكتب محافظة الأحساء,صنع منتجات المطاط واللدائن,8,6,4,1,19
2022,1,مكتب محافظة الأحساء,صنع منتجات المعادن اللافلزية الأخرى,57,41,11,0,109
2022,1,مكتب محافظة الأحساء,صنع منتجات المعادن المشكلة ( باستثناء الآلات والمعدات ),102,60,7,1,170
2022,1,مكتب محافظة الأحساء,صيد الأسماك وتربية المائيات,10,4,1,0,15
2022,1,مكتب محافظة الأحساء,وكالات السفر ومشغّلو الجولات السياحية وخدمات الحجز والأنشطة المتصلة بها,18,4,0,0,22
2022,1,مكتب محافظة الجبيل,أبحاث الإعلان والسوق,19,7,0,0,26
2022,1,مكتب محافظة الجبيل,إصلاح أجهزة الحاسوب والسلع الشخصية والمنزلية,43,14,3,0,60
2022,1,مكتب محافظة الجبيل,إصلاح وتركيب الآلات والمعدات,48,30,6,0,84
2022,1,مكتب محافظة الجبيل,أنشطة أنتاج الأفلام والبرامج التلفزيونية والتسجيلات الصوتية و نشرالموسيقى,2,0,0,0,2
2022,1,مكتب محافظة الجبيل,أنشطة الأمن والتحقيقات,6,0,2,0,8
2022,1,مكتب محافظة الجبيل,أنشطة الاستخدام,11,2,0,1,14
2022,1,مكتب محافظة الجبيل,أنشطة الاسر المعيشية التي تستخدم أفراداً للعمل المنزلي,1,0,0,0,1
2022,1,مكتب محافظة الجبيل,أنشطة البرمجة الحاسوبية والخبرة الاستشارية وما يتصل بها من أنشطة,10,6,0,0,16
2022,1,مكتب محافظة الجبيل,أنشطة البريد ونقل الرسائل والطرود بواسطة مندوبين,2,0,0,0,2
2022,1,مكتب محافظة الجبيل,أنشطة التشييد المتخصصة,763,304,34,19,1120
2022,1,مكتب محافظة الجبيل,أنشطة الخدمات الشخصية الأخرى,481,86,6,0,573
2022,1,مكتب محافظة الجبيل,أنشطة الخدمات المالية ، فيما عدا تمويل التأمين وصناديق المعاشات,8,2,1,0,11
2022,1,مكتب محافظة الجبيل,أنشطة العمل الاجتماعي، دون إقامة، لكبار السن وذوي الإعاقة,8,8,1,0,17
2022,1,مكتب محافظة الجبيل,أنشطة المعالجة وخدمات إدارة النفايات الأخرى,1,2,0,0,3
2022,1,مكتب محافظة الجبيل,أنشطة المعمارية والهندسية ، والاختبارات الفنية والتحليل,45,17,1,3,66
2022,1,مكتب محافظة الجبيل,أنشطة المكاتب الرئيسية ، وألأنشطة الاستشارية في مجال الإدارة,15,4,0,0,19
2022,1,مكتب محافظة الجبيل,أنشطة المكتبات ودور المحفوظات، والمتاحف والأنشطة الثقافية الأخرى,11,2,1,0,14
2022,1,مكتب محافظة الجبيل,أنشطة المنظمات الدولية,1,0,0,0,1
2022,1,مكتب محافظة الجبيل,أنشطة المنظمات ذات العضوية,2,3,1,0,6
2022,1,مكتب محافظة الجبيل,أنشطة النشر,31,4,1,0,36
2022,1,مكتب محافظة الجبيل,أنشطة تقديم الخدمات للمباني وتجميل المواقع,254,117,27,6,404
2022,1,مكتب محافظة الجبيل,أنشطة جمع النفايات ومعالجتها وتصريفها ، واسترجاع المواد,2,1,1,1,5
2022,1,مكتب محافظة الجبيل,أنشطة خدمات الأطعمة والمشروبات,952,328,17,2,1299
2022,1,مكتب محافظة الجبيل,أنشطة خدمات المعلومات,4,2,0,0,6
2022,1,مكتب محافظة الجبيل,أنشطة خدمات دعم التعدين,23,20,12,10,65
2022,1,مكتب محافظة الجبيل,أنشطة زراعة المحاصيل والإنتاج الحيواني والصيد والخدمات المتصلة,345,22,2,0,369
2022,1,مكتب محافظة الجبيل,الإدارة العامة والدفاع ؛ والضمان الاجتماعي الإلزامي,16,6,3,0,25
2022,1,مكتب محافظة الجبيل,الإقامة,44,27,6,0,77
2022,1,مكتب محافظة الجبيل,الأنشطة الأخرى للتعدين واستغلال المحاجر,4,6,3,2,15
2022,1,مكتب محافظة الجبيل,الأنشطة الإدارية للمكاتب ، وأنشطة الدعم للمكاتب وغير ذلك من أنشطة الدعم للأعمال,26,2,0,0,28
2022,1,مكتب محافظة الجبيل,الأنشطة الإيجارية,396,43,6,0,445
2022,1,مكتب محافظة الجبيل,الأنشطة البيطرية,5,0,0,0,5
2022,1,مكتب محافظة الجبيل,الأنشطة الرياضية وأنشطة التسلية والترفيه,32,7,0,0,39
2022,1,مكتب محافظة الجبيل,الأنشطة العقارية,31,10,0,0,41
2022,1,مكتب محافظة الجبيل,الأنشطة القانونية وأنشطة المحاسبة,6,3,0,0,9
2022,1,مكتب محافظة الجبيل,الأنشطة المساعدة لأنشطة الخدمات المالية وأنشطة التأمين,2,0,0,0,2
2022,1,مكتب محافظة الجبيل,الأنشطة المهنية والعلمية والتقنية الأخرى,20,3,0,0,23
2022,1,مكتب محافظة الجبيل,الاتصالات,21,4,0,0,25
2022,1,مكتب محافظة الجبيل,البحث والتطوير في المجال العلمي,2,0,0,0,2
2022,1,مكتب محافظة الجبيل,التخزين وأنشطة الدعم للنقل,59,17,3,1,80
2022,1,مكتب محافظة الجبيل,التعليم,28,17,12,0,57
2022,1,مكتب محافظة الجبيل,الحراجة وقطع الأخشاب,2,0,0,0,2
2022,1,مكتب محافظة الجبيل,الرعاية مع الإقامة,3,3,0,0,6
2022,1,مكتب محافظة الجبيل,الصحة البشرية,20,18,14,6,58
2022,1,مكتب محافظة الجبيل,الصرف الصحي,2,2,1,1,6
2022,1,مكتب محافظة الجبيل,الصناعة التحويلية الأخرى,7,5,0,0,12
2022,1,مكتب محافظة الجبيل,الطباعة واستنساخ وسائط الأعلام المسجّلة,15,10,1,0,26
2022,1,مكتب محافظة الجبيل,النقل البري و النقل عبر الأنابيب,237,69,4,0,310
2022,1,مكتب محافظة الجبيل,النقل الجوي,11,7,0,2,20
2022,1,مكتب محافظة الجبيل,النقل المائي,8,1,0,0,9
2022,1,مكتب محافظة الجبيل,الهندسة المدنية,34,24,6,0,64
2022,1,مكتب محافظة الجبيل,تجارة التجزئة، باستثناء المركبات ذات المحركات والدراجات النارية,1158,258,20,2,1438
2022,1,مكتب محافظة الجبيل,تجارة الجملة ، باستثناء المركبات ذات المحركات والدراجات النارية,551,178,20,7,756
2022,1,مكتب محافظة الجبيل,تجارة الجملة والتجزئة ، وإصلاح المركبات ذات المحركات والدراجات النارية,606,115,4,0,725
2022,1,مكتب محافظة الجبيل,تجميع المياه ومعالجتها وتوصيلها,1,7,0,0,8
2022,1,مكتب محافظة الجبيل,تشييد المباني,1257,707,137,41,2142
2022,1,مكتب محافظة الجبيل,تعدين الفحم والليغنيت,0,2,0,0,2
2022,1,مكتب محافظة الجبيل,تعدين ركازات الفلزات,46,12,1,1,60
2022,1,مكتب محافظة الجبيل,تمويل التأمين وإعادة التأمين وصناديق المعاشات التقاعدية باستثناء الضمان الاجتماعي الإلزامي,0,1,0,0,1
2022,1,مكتب محافظة الجبيل,توصيل الكهرباء والغاز والبخار وتكييف الهواء,12,12,3,1,28
2022,1,مكتب محافظة الجبيل,صناعة الآلات والمعدات غير المصنفة في موضع أخر,14,17,4,0,35
2022,1,مكتب محافظة الجبيل,صناعة المركبات ذات المحركات والمركبات المقطورة ونصف المقطورة,11,2,0,0,13
2022,1,مكتب محافظة الجبيل,صناعة معدات النقل الأخرى,14,4,1,0,19
2022,1,مكتب محافظة الجبيل,صنع الأثاث,39,5,0,0,44
2022,1,مكتب محافظة الجبيل,صنع الحواسيب والمنتجات الإلكترونية والبصرية,27,7,4,2,40
2022,1,مكتب محافظة الجبيل,صُنع الخشب ومنتجات الخشب والفلين ، باستثناء الأثاث ، صُنع أصناف من القش ومواد الضفر,68,14,4,0,86
2022,1,مكتب محافظة الجبيل,صنع الفلزات القاعدية,68,29,14,5,116
2022,1,مكتب محافظة الجبيل,صُنع المشروبات,2,1,0,0,3
2022,1,مكتب محافظة الجبيل,صنع المعدات الكهربائية,60,21,4,1,86
2022,1,مكتب محافظة الجبيل,صُنع الملبوسات,178,25,1,0,204
2022,1,مكتب محافظة الجبيل,صُنع المنتجات الجلدية والمنتجات ذات الصلة,0,1,0,0,1
2022,1,مكتب محافظة الجبيل,صنع المنتجات الصيدلانية الأساسية والمستحضرات الصيدلانية,1,0,0,0,1
2022,1,مكتب محافظة الجبيل,صُنع المنتجات الغذائية,124,39,3,1,167
2022,1,مكتب محافظة الجبيل,صُنع المنسوجات,45,13,1,0,59
2022,1,مكتب محافظة الجبيل,صُنع المواد الكيميائية والمنتجات الكيميائية,26,21,18,3,68
2022,1,مكتب محافظة الجبيل,صُنع الورق ومنتجات الورق,1,0,0,0,1
2022,1,مكتب محافظة الجبيل,صنع فحم الكوك والمنتجات النفطية المكررة,1,5,0,1,7
2022,1,مكتب محافظة الجبيل,صُنع منتجات التبغ,2,0,0,0,2
2022,1,مكتب محافظة الجبيل,صنع منتجات المطاط واللدائن,13,23,10,10,56
2022,1,مكتب محافظة الجبيل,صنع منتجات المعادن اللافلزية الأخرى,50,28,11,2,91
2022,1,مكتب محافظة الجبيل,صنع منتجات المعادن المشكلة ( باستثناء الآلات والمعدات ),156,51,21,6,234
2022,1,مكتب محافظة الجبيل,صيد الأسماك وتربية المائيات,73,86,1,0,160
2022,1,مكتب محافظة الجبيل,وكالات السفر ومشغّلو الجولات السياحية وخدمات الحجز والأنشطة المتصلة بها,5,3,0,0,8
2022,1,مكتب محافظة الخرج,أبحاث الإعلان والسوق,14,5,0,0,19
2022,1,مكتب محافظة الخرج,إصلاح أجهزة الحاسوب والسلع الشخصية والمنزلية,88,9,0,0,97
2022,1,مكتب محافظة الخرج,إصلاح وتركيب الآلات والمعدات,42,3,1,0,46
2022,1,مكتب محافظة الخرج,أنشطة أنتاج الأفلام والبرامج التلفزيونية والتسجيلات الصوتية و نشرالموسيقى,2,0,0,0,2
2022,1,مكتب محافظة الخرج,أنشطة الأمن والتحقيقات,4,1,0,0,5
2022,1,مكتب محافظة الخرج,أنشطة الاستخدام,19,6,0,1,26
2022,1,مكتب محافظة الخرج,أنشطة البرمجة الحاسوبية والخبرة الاستشارية وما يتصل بها من أنشطة,4,1,0,0,5
2022,1,مكتب محافظة الخرج,أنشطة البرمجة والإذاعة,2,0,0,0,2
2022,1,مكتب محافظة الخرج,أنشطة البريد ونقل الرسائل والطرود بواسطة مندوبين,3,0,0,0,3
2022,1,مكتب محافظة الخرج,أنشطة التشييد المتخصصة,1054,196,9,1,1260
2022,1,مكتب محافظة الخرج,أنشطة الخدمات الشخصية الأخرى,599,64,1,0,664
2022,1,مكتب محافظة الخرج,أنشطة الخدمات المالية ، فيما عدا تمويل التأمين وصناديق المعاشات,29,7,0,0,36
2022,1,مكتب محافظة الخرج,أنشطة العمل الاجتماعي، دون إقامة، لكبار السن وذوي الإعاقة,18,19,0,0,37
2022,1,مكتب محافظة الخرج,أنشطة المعمارية والهندسية ، والاختبارات الفنية والتحليل,29,7,1,1,38
2022,1,مكتب محافظة الخرج,أنشطة المكاتب الرئيسية ، وألأنشطة الاستشارية في مجال الإدارة,20,1,0,0,21
2022,1,مكتب محافظة الخرج,أنشطة المكتبات ودور المحفوظات، والمتاحف والأنشطة الثقافية الأخرى,22,1,0,0,23
2022,1,مكتب محافظة الخرج,أنشطة المنظمات ذات العضوية,13,3,0,0,16
2022,1,مكتب محافظة الخرج,أنشطة النشر,10,3,0,0,13
2022,1,مكتب محافظة الخرج,أنشطة تقديم الخدمات للمباني وتجميل المواقع,209,54,7,0,270
2022,1,مكتب محافظة الخرج,أنشطة جمع النفايات ومعالجتها وتصريفها ، واسترجاع المواد,1,1,1,0,3
2022,1,مكتب محافظة الخرج,أنشطة خدمات الأطعمة والمشروبات,1091,261,10,0,1362
2022,1,مكتب محافظة الخرج,أنشطة خدمات المعلومات,10,0,0,0,10
2022,1,مكتب محافظة الخرج,أنشطة خدمات دعم التعدين,10,3,0,0,13
2022,1,مكتب محافظة الخرج,أنشطة زراعة المحاصيل والإنتاج الحيواني والصيد والخدمات المتصلة,1560,113,16,1,1690
2022,1,مكتب محافظة الخرج,الإدارة العامة والدفاع ؛ والضمان الاجتماعي الإلزامي,14,9,0,0,23
2022,1,مكتب محافظة الخرج,الإقامة,57,12,0,0,69
2022,1,مكتب محافظة الخرج,الأنشطة الإبداعية والفنون وأنشطة الترفيه,6,0,1,0,7
2022,1,مكتب محافظة الخرج,الأنشطة الأخرى للتعدين واستغلال المحاجر,18,3,0,0,21
2022,1,مكتب محافظة الخرج,الأنشطة الإدارية للمكاتب ، وأنشطة الدعم للمكاتب وغير ذلك من أنشطة الدعم للأعمال,45,6,0,0,51
2022,1,مكتب محافظة الخرج,الأنشطة الإيجارية,624,30,1,0,655
2022,1,مكتب محافظة الخرج,الأنشطة البيطرية,9,3,0,0,12
2022,1,مكتب محافظة الخرج,الأنشطة الرياضية وأنشطة التسلية والترفيه,31,11,0,0,42
2022,1,مكتب محافظة الخرج,الأنشطة العقارية,87,21,0,1,109
2022,1,مكتب محافظة الخرج,الأنشطة القانونية وأنشطة المحاسبة,5,0,0,0,5
2022,1,مكتب محافظة الخرج,الأنشطة المساعدة لأنشطة الخدمات المالية وأنشطة التأمين,2,0,0,0,2
2022,1,مكتب محافظة الخرج,الأنشطة المهنية والعلمية والتقنية الأخرى,9,2,0,0,11
2022,1,مكتب محافظة الخرج,الاتصالات,15,1,1,0,17
2022,1,مكتب محافظة الخرج,التخزين وأنشطة الدعم للنقل,79,11,0,0,90
2022,1,مكتب محافظة الخرج,التعليم,29,15,7,0,51
2022,1,مكتب محافظة الخرج,الحراجة وقطع الأخشاب,1,0,0,0,1
2022,1,مكتب محافظة الخرج,الرعاية مع الإقامة,1,1,0,0,2
2022,1,مكتب محافظة الخرج,الصحة البشرية,19,23,8,2,52
2022,1,مكتب محافظة الخرج,الصرف الصحي,0,1,0,0,1
2022,1,مكتب محافظة الخرج,الصناعة التحويلية الأخرى,10,6,1,0,17
2022,1,مكتب محافظة الخرج,الطباعة واستنساخ وسائط الأعلام المسجّلة,14,5,0,0,19
2022,1,مكتب محافظة الخرج,النقل البري و النقل عبر الأنابيب,912,109,6,0,1027
2022,1,مكتب محافظة الخرج,النقل الجوي,15,5,0,0,20
2022,1,مكتب محافظة الخرج,النقل المائي,13,0,0,0,13
2022,1,مكتب محافظة الخرج,الهندسة المدنية,8,6,0,2,16
2022,1,مكتب محافظة الخرج,تجارة التجزئة، باستثناء المركبات ذات المحركات والدراجات النارية,1692,299,14,1,2006
2022,1,مكتب محافظة الخرج,تجارة الجملة ، باستثناء المركبات ذات المحركات والدراجات النارية,752,216,17,0,985
2022,1,مكتب محافظة الخرج,تجارة الجملة والتجزئة ، وإصلاح المركبات ذات المحركات والدراجات النارية,823,127,3,0,953
2022,1,مكتب محافظة الخرج,تجميع المياه ومعالجتها وتوصيلها,10,2,0,1,13
2022,1,مكتب محافظة الخرج,تشييد المباني,1697,461,41,5,2204
2022,1,مكتب محافظة الخرج,تعدين ركازات الفلزات,16,1,0,0,17
2022,1,مكتب محافظة الخرج,توصيل الكهرباء والغاز والبخار وتكييف الهواء,7,5,1,0,13
2022,1,مكتب محافظة الخرج,صناعة الآلات والمعدات غير المصنفة في موضع أخر,20,7,1,0,28
2022,1,مكتب محافظة الخرج,صناعة المركبات ذات المحركات والمركبات المقطورة ونصف المقطورة,21,4,0,0,25
2022,1,مكتب محافظة الخرج,صناعة معدات النقل الأخرى,8,3,1,0,12
2022,1,مكتب محافظة الخرج,صنع الأثاث,65,20,1,1,87
2022,1,مكتب محافظة الخرج,صنع الحواسيب والمنتجات الإلكترونية والبصرية,34,5,0,0,39
2022,1,مكتب محافظة الخرج,صُنع الخشب ومنتجات الخشب والفلين ، باستثناء الأثاث ، صُنع أصناف من القش ومواد الضفر,74,17,1,0,92
2022,1,مكتب محافظة الخرج,صنع الفلزات القاعدية,109,26,4,0,139
2022,1,مكتب محافظة الخرج,صُنع المشروبات,9,7,5,7,28
2022,1,مكتب محافظة الخرج,صنع المعدات الكهربائية,46,10,1,0,57
2022,1,مكتب محافظة الخرج,صُنع الملبوسات,330,33,1,0,364
2022,1,مكتب محافظة الخرج,صُنع المنتجات الجلدية والمنتجات ذات الصلة,5,0,0,0,5
2022,1,مكتب محافظة الخرج,صنع المنتجات الصيدلانية الأساسية والمستحضرات الصيدلانية,3,5,0,0,8
2022,1,مكتب محافظة الخرج,صُنع المنتجات الغذائية,177,64,8,0,249
2022,1,مكتب محافظة الخرج,صُنع المنسوجات,31,9,0,0,40
2022,1,مكتب محافظة الخرج,صُنع المواد الكيميائية والمنتجات الكيميائية,51,17,3,0,71
2022,1,مكتب محافظة الخرج,صُنع الورق ومنتجات الورق,9,3,5,0,17
2022,1,مكتب محافظة الخرج,صنع فحم الكوك والمنتجات النفطية المكررة,1,2,0,0,3
2022,1,مكتب محافظة الخرج,صُنع منتجات التبغ,1,0,0,0,1
2022,1,مكتب محافظة الخرج,صنع منتجات المطاط واللدائن,18,16,6,1,41
2022,1,مكتب محافظة الخرج,صنع منتجات المعادن اللافلزية الأخرى,57,37,12,0,106
2022,1,مكتب محافظة الخرج,صنع منتجات المعادن المشكلة ( باستثناء الآلات والمعدات ),116,31,4,1,152
2022,1,مكتب محافظة الخرج,صيد الأسماك وتربية المائيات,17,0,0,0,17
2022,1,مكتب محافظة الخرج,وكالات السفر ومشغّلو الجولات السياحية وخدمات الحجز والأنشطة المتصلة بها,5,1,0,0,6
2022,1,مكتب محافظة الدوادمي,أبحاث الإعلان والسوق,4,1,0,0,5
2022,1,مكتب محافظة الدوادمي,إصلاح أجهزة الحاسوب والسلع الشخصية والمنزلية,32,12,0,0,44
2022,1,مكتب محافظة الدوادمي,إصلاح وتركيب الآلات والمعدات,12,3,0,0,15
2022,1,مكتب محافظة الدوادمي,أنشطة أنتاج الأفلام والبرامج التلفزيونية والتسجيلات الصوتية و نشرالموسيقى,2,0,0,0,2
2022,1,مكتب محافظة الدوادمي,أنشطة الأمن والتحقيقات,1,0,0,0,1
2022,1,مكتب محافظة الدوادمي,أنشطة الاستخدام,9,1,0,0,10
2022,1,مكتب محافظة الدوادمي,أنشطة الاسر المعيشية التي تستخدم أفراداً للعمل المنزلي,3,0,0,0,3
2022,1,مكتب محافظة الدوادمي,أنشطة البرمجة الحاسوبية والخبرة الاستشارية وما يتصل بها من أنشطة,5,0,0,0,5
2022,1,مكتب محافظة الدوادمي,أنشطة البرمجة والإذاعة,1,1,0,0,2
2022,1,مكتب محافظة الدوادمي,أنشطة البريد ونقل الرسائل والطرود بواسطة مندوبين,2,2,0,0,4
2022,1,مكتب محافظة الدوادمي,أنشطة التشييد المتخصصة,721,111,7,1,840
2022,1,مكتب محافظة الدوادمي,أنشطة الخدمات الشخصية الأخرى,368,30,2,0,400
2022,1,مكتب محافظة الدوادمي,أنشطة الخدمات المالية ، فيما عدا تمويل التأمين وصناديق المعاشات,20,1,0,0,21
2022,1,مكتب محافظة الدوادمي,أنشطة العمل الاجتماعي، دون إقامة، لكبار السن وذوي الإعاقة,14,1,1,0,16
2022,1,مكتب محافظة الدوادمي,أنشطة المعمارية والهندسية ، والاختبارات الفنية والتحليل,24,6,0,0,30
2022,1,مكتب محافظة الدوادمي,أنشطة المكاتب الرئيسية ، وألأنشطة الاستشارية في مجال الإدارة,6,0,0,0,6
2022,1,مكتب محافظة الدوادمي,أنشطة المكتبات ودور المحفوظات، والمتاحف والأنشطة الثقافية الأخرى,6,1,0,0,7
2022,1,مكتب محافظة الدوادمي,أنشطة المنظمات ذات العضوية,4,0,0,0,4
2022,1,مكتب محافظة الدوادمي,أنشطة النشر,2,0,0,0,2
2022,1,مكتب محافظة الدوادمي,أنشطة تقديم الخدمات للمباني وتجميل المواقع,743,151,11,1,906
2022,1,مكتب محافظة الدوادمي,أنشطة جمع النفايات ومعالجتها وتصريفها ، واسترجاع المواد,1,0,0,0,1
2022,1,مكتب محافظة الدوادمي,أنشطة خدمات الأطعمة والمشروبات,624,78,4,0,706
2022,1,مكتب محافظة الدوادمي,أنشطة خدمات المعلومات,4,1,0,0,5
2022,1,مكتب محافظة الدوادمي,أنشطة خدمات دعم التعدين,0,2,0,0,2
2022,1,مكتب محافظة الدوادمي,أنشطة زراعة المحاصيل والإنتاج الحيواني والصيد والخدمات المتصلة,1497,36,0,0,1533
2022,1,مكتب محافظة الدوادمي,الإدارة العامة والدفاع ؛ والضمان الاجتماعي الإلزامي,6,3,0,0,9
2022,1,مكتب محافظة الدوادمي,الإقامة,36,7,1,0,44
2022,1,مكتب محافظة الدوادمي,الأنشطة الإبداعية والفنون وأنشطة الترفيه,4,0,0,0,4
2022,1,مكتب محافظة الدوادمي,الأنشطة الأخرى للتعدين واستغلال المحاجر,3,2,0,0,5
2022,1,مكتب محافظة الدوادمي,الأنشطة الإدارية للمكاتب ، وأنشطة الدعم للمكاتب وغير ذلك من أنشطة الدعم للأعمال,14,0,0,0,14
2022,1,مكتب محافظة الدوادمي,الأنشطة الإيجارية,1034,18,1,1,1054
2022,1,مكتب محافظة الدوادمي,الأنشطة البيطرية,8,0,0,0,8
2022,1,مكتب محافظة الدوادمي,الأنشطة الرياضية وأنشطة التسلية والترفيه,23,4,0,0,27
2022,1,مكتب محافظة الدوادمي,الأنشطة العقارية,31,6,0,0,37
2022,1,مكتب محافظة الدوادمي,الأنشطة القانونية وأنشطة المحاسبة,1,0,0,0,1
2022,1,مكتب محافظة الدوادمي,الأنشطة المساعدة لأنشطة الخدمات المالية وأنشطة التأمين,1,0,0,0,1
2022,1,مكتب محافظة الدوادمي,الأنشطة المهنية والعلمية والتقنية الأخرى,6,1,0,0,7
2022,1,مكتب محافظة الدوادمي,الاتصالات,5,0,0,0,5
2022,1,مكتب محافظة الدوادمي,التخزين وأنشطة الدعم للنقل,58,4,0,0,62
2022,1,مكتب محافظة الدوادمي,التعليم,16,13,2,0,31
2022,1,مكتب محافظة الدوادمي,الحراجة وقطع الأخشاب,1,0,0,0,1
2022,1,مكتب محافظة الدوادمي,الصحة البشرية,18,8,2,0,28
2022,1,مكتب محافظة الدوادمي,الصرف الصحي,1,0,0,0,1
2022,1,مكتب محافظة الدوادمي,الصناعة التحويلية الأخرى,11,1,0,0,12
2022,1,مكتب محافظة الدوادمي,الطباعة واستنساخ وسائط الأعلام المسجّلة,7,0,0,0,7
2022,1,مكتب محافظة الدوادمي,النقل البري و النقل عبر الأنابيب,738,66,4,0,808
2022,1,مكتب محافظة الدوادمي,النقل الجوي,13,3,0,0,16
2022,1,مكتب محافظة الدوادمي,النقل المائي,3,0,0,0,3
2022,1,مكتب محافظة الدوادمي,الهندسة المدنية,3,1,2,0,6
2022,1,مكتب محافظة الدوادمي,تجارة التجزئة، باستثناء المركبات ذات المحركات والدراجات النارية,664,88,2,0,754
2022,1,مكتب محافظة الدوادمي,تجارة الجملة ، باستثناء المركبات ذات المحركات والدراجات النارية,299,70,4,0,373
2022,1,مكتب محافظة الدوادمي,تجارة الجملة والتجزئة ، وإصلاح المركبات ذات المحركات والدراجات النارية,580,63,5,1,649
2022,1,مكتب محافظة الدوادمي,تجميع المياه ومعالجتها وتوصيلها,5,2,1,0,8
2022,1,مكتب محافظة الدوادمي,تشييد المباني,818,169,19,3,1009
2022,1,مكتب محافظة الدوادمي,تعدين ركازات الفلزات,6,0,0,0,6
2022,1,مكتب محافظة الدوادمي,توصيل الكهرباء والغاز والبخار وتكييف الهواء,5,0,1,0,6
2022,1,مكتب محافظة الدوادمي,صناعة الآلات والمعدات غير المصنفة في موضع أخر,6,1,0,0,7
2022,1,مكتب محافظة الدوادمي,صناعة المركبات ذات المحركات والمركبات المقطورة ونصف المقطورة,11,0,0,0,11
2022,1,مكتب محافظة الدوادمي,صناعة معدات النقل الأخرى,4,1,0,0,5
2022,1,مكتب محافظة الدوادمي,صنع الأثاث,47,7,0,0,54
2022,1,مكتب محافظة الدوادمي,صنع الحواسيب والمنتجات الإلكترونية والبصرية,11,0,0,0,11
2022,1,مكتب محافظة الدوادمي,صُنع الخشب ومنتجات الخشب والفلين ، باستثناء الأثاث ، صُنع أصناف من القش ومواد الضفر,55,8,2,0,65
2022,1,مكتب محافظة الدوادمي,صنع الفلزات القاعدية,57,8,0,0,65
2022,1,مكتب محافظة الدوادمي,صُنع المشروبات,6,1,0,0,7
2022,1,مكتب محافظة الدوادمي,صنع المعدات الكهربائية,27,2,0,0,29
2022,1,مكتب محافظة الدوادمي,صُنع الملبوسات,178,20,1,0,199
2022,1,مكتب محافظة الدوادمي,صُنع المنتجات الجلدية والمنتجات ذات الصلة,4,0,0,0,4
2022,1,مكتب محافظة الدوادمي,صنع المنتجات الصيدلانية الأساسية والمستحضرات الصيدلانية,0,1,0,0,1
2022,1,مكتب محافظة الدوادمي,صُنع المنتجات الغذائية,91,12,0,0,103
2022,1,مكتب محافظة الدوادمي,صُنع المنسوجات,22,5,1,0,28
2022,1,مكتب محافظة الدوادمي,صُنع المواد الكيميائية والمنتجات الكيميائية,14,2,0,0,16
2022,1,مكتب محافظة الدوادمي,صُنع الورق ومنتجات الورق,1,0,0,0,1
2022,1,مكتب محافظة الدوادمي,صنع منتجات المطاط واللدائن,5,3,0,0,8
2022,1,مكتب محافظة الدوادمي,صنع منتجات المعادن اللافلزية الأخرى,53,21,1,0,75
2022,1,مكتب محافظة الدوادمي,صنع منتجات المعادن المشكلة ( باستثناء الآلات والمعدات ),80,10,0,0,90
2022,1,مكتب محافظة الدوادمي,صيد الأسماك وتربية المائيات,16,0,0,0,16
2022,1,مكتب محافظة الدوادمي,وكالات السفر ومشغّلو الجولات السياحية وخدمات الحجز والأنشطة المتصلة بها,2,0,0,0,2
2022,1,مكتب محافظة الطائف,أبحاث الإعلان والسوق,24,3,0,0,27
2022,1,مكتب محافظة الطائف,إصلاح أجهزة الحاسوب والسلع الشخصية والمنزلية,164,16,0,0,180
2022,1,مكتب محافظة الطائف,إصلاح وتركيب الآلات والمعدات,67,4,0,0,71
2022,1,مكتب محافظة الطائف,أنشطة أنتاج الأفلام والبرامج التلفزيونية والتسجيلات الصوتية و نشرالموسيقى,18,3,0,0,21
2022,1,مكتب محافظة الطائف,أنشطة الأمن والتحقيقات,10,1,0,0,11
2022,1,مكتب محافظة الطائف,أنشطة الاستخدام,24,2,0,0,26
2022,1,مكتب محافظة الطائف,أنشطة الاسر المعيشية التي تستخدم أفراداً للعمل المنزلي,3,0,0,0,3
2022,1,مكتب محافظة الطائف,أنشطة البرمجة الحاسوبية والخبرة الاستشارية وما يتصل بها من أنشطة,9,3,0,0,12
2022,1,مكتب محافظة الطائف,أنشطة البرمجة والإذاعة,0,0,1,0,1
2022,1,مكتب محافظة الطائف,أنشطة البريد ونقل الرسائل والطرود بواسطة مندوبين,1,0,0,0,1
2022,1,مكتب محافظة الطائف,أنشطة التشييد المتخصصة,1197,176,1,0,1374
2022,1,مكتب محافظة الطائف,أنشطة الخدمات الشخصية الأخرى,1207,73,0,0,1280
2022,1,مكتب محافظة الطائف,أنشطة الخدمات المالية ، فيما عدا تمويل التأمين وصناديق المعاشات,14,0,0,0,14
2022,1,مكتب محافظة الطائف,أنشطة العمل الاجتماعي، دون إقامة، لكبار السن وذوي الإعاقة,32,31,1,0,64
2022,1,مكتب محافظة الطائف,أنشطة المعالجة وخدمات إدارة النفايات الأخرى,0,1,0,0,1
2022,1,مكتب محافظة الطائف,أنشطة المعمارية والهندسية ، والاختبارات الفنية والتحليل,180,79,3,0,262
2022,1,مكتب محافظة الطائف,أنشطة المكاتب الرئيسية ، وألأنشطة الاستشارية في مجال الإدارة,12,4,0,0,16
2022,1,مكتب محافظة الطائف,أنشطة المكتبات ودور المحفوظات، والمتاحف والأنشطة الثقافية الأخرى,36,8,2,0,46
2022,1,مكتب محافظة الطائف,أنشطة المنظمات الدولية,0,1,0,0,1
2022,1,مكتب محافظة الطائف,أنشطة المنظمات ذات العضوية,15,2,1,0,18
2022,1,مكتب محافظة الطائف,أنشطة النشر,10,5,0,0,15
2022,1,مكتب محافظة الطائف,أنشطة تقديم الخدمات للمباني وتجميل المواقع,279,48,8,2,337
2022,1,مكتب محافظة الطائف,أنشطة جمع النفايات ومعالجتها وتصريفها ، واسترجاع المواد,4,0,0,0,4
2022,1,مكتب محافظة الطائف,أنشطة خدمات الأطعمة والمشروبات,2500,557,33,0,3090
2022,1,مكتب محافظة الطائف,أنشطة خدمات المعلومات,8,2,0,0,10
2022,1,مكتب محافظة الطائف,أنشطة خدمات دعم التعدين,19,7,1,0,27
2022,1,مكتب محافظة الطائف,أنشطة زراعة المحاصيل والإنتاج الحيواني والصيد والخدمات المتصلة,746,23,2,0,771
2022,1,مكتب محافظة الطائف,الإدارة العامة والدفاع ؛ والضمان الاجتماعي الإلزامي,18,7,4,0,29
2022,1,مكتب محافظة الطائف,الإقامة,182,51,7,0,240
2022,1,مكتب محافظة الطائف,الأنشطة الإبداعية والفنون وأنشطة الترفيه,9,4,0,0,13
2022,1,مكتب محافظة الطائف,الأنشطة الأخرى للتعدين واستغلال المحاجر,9,1,0,0,10
2022,1,مكتب محافظة الطائف,الأنشطة الإدارية للمكاتب ، وأنشطة الدعم للمكاتب وغير ذلك من أنشطة الدعم للأعمال,66,4,0,0,70
2022,1,مكتب محافظة الطائف,الأنشطة الإيجارية,1069,50,2,0,1121
2022,1,مكتب محافظة الطائف,الأنشطة البيطرية,21,4,0,0,25
2022,1,مكتب محافظة الطائف,الأنشطة الرياضية وأنشطة التسلية والترفيه,62,24,1,0,87
2022,1,مكتب محافظة الطائف,الأنشطة العقارية,74,12,2,0,88
2022,1,مكتب محافظة الطائف,الأنشطة القانونية وأنشطة المحاسبة,11,2,0,0,13
2022,1,مكتب محافظة الطائف,الأنشطة المهنية والعلمية والتقنية الأخرى,43,6,0,0,49
2022,1,مكتب محافظة الطائف,الاتصالات,32,0,0,0,32
2022,1,مكتب محافظة الطائف,البحث والتطوير في المجال العلمي,1,0,0,0,1
2022,1,مكتب محافظة الطائف,التخزين وأنشطة الدعم للنقل,84,6,2,0,92
2022,1,مكتب محافظة الطائف,التعليم,36,30,19,0,85
2022,1,مكتب محافظة الطائف,الرعاية مع الإقامة,1,1,0,0,2
2022,1,مكتب محافظة الطائف,الصحة البشرية,29,101,14,2,146
2022,1,مكتب محافظة الطائف,الصناعة التحويلية الأخرى,31,14,1,1,47
2022,1,مكتب محافظة الطائف,الطباعة واستنساخ وسائط الأعلام المسجّلة,29,11,0,0,40
2022,1,مكتب محافظة الطائف,النقل البري و النقل عبر الأنابيب,713,85,1,0,799
2022,1,مكتب محافظة الطائف,النقل الجوي,15,3,0,0,18
2022,1,مكتب محافظة الطائف,النقل المائي,5,2,0,0,7
2022,1,مكتب محافظة الطائف,الهندسة المدنية,17,3,1,0,21
2022,1,مكتب محافظة الطائف,تجارة التجزئة، باستثناء المركبات ذات المحركات والدراجات النارية,3002,461,22,0,3485
2022,1,مكتب محافظة الطائف,تجارة الجملة ، باستثناء المركبات ذات المحركات والدراجات النارية,937,168,18,0,1123
2022,1,مكتب محافظة الطائف,تجارة الجملة والتجزئة ، وإصلاح المركبات ذات المحركات والدراجات النارية,1483,178,5,0,1666
2022,1,مكتب محافظة الطائف,تجميع المياه ومعالجتها وتوصيلها,143,19,2,0,164
2022,1,مكتب محافظة الطائف,تشييد المباني,2348,498,40,2,2888
2022,1,مكتب محافظة الطائف,تعدين الفحم والليغنيت,3,0,0,0,3
2022,1,مكتب محافظة الطائف,تعدين ركازات الفلزات,21,2,0,0,23
2022,1,مكتب محافظة الطائف,تمويل التأمين وإعادة التأمين وصناديق المعاشات التقاعدية باستثناء الضمان الاجتماعي الإلزامي,0,1,0,0,1
2022,1,مكتب محافظة الطائف,توصيل الكهرباء والغاز والبخار وتكييف الهواء,10,1,0,0,11
2022,1,مكتب محافظة الطائف,صناعة الآلات والمعدات غير المصنفة في موضع أخر,18,1,0,0,19
2022,1,مكتب محافظة الطائف,صناعة المركبات ذات المحركات والمركبات المقطورة ونصف المقطورة,32,2,0,0,34
2022,1,مكتب محافظة الطائف,صناعة معدات النقل الأخرى,5,2,0,0,7
2022,1,مكتب محافظة الطائف,صنع الأثاث,182,28,3,0,213
2022,1,مكتب محافظة الطائف,صنع الحواسيب والمنتجات الإلكترونية والبصرية,107,13,0,0,120
2022,1,مكتب محافظة الطائف,صُنع الخشب ومنتجات الخشب والفلين ، باستثناء الأثاث ، صُنع أصناف من القش ومواد الضفر,188,26,0,0,214
2022,1,مكتب محافظة الطائف,صنع الفلزات القاعدية,109,25,2,0,136
2022,1,مكتب محافظة الطائف,صُنع المشروبات,17,6,0,0,23
2022,1,مكتب محافظة الطائف,صنع المعدات الكهربائية,76,16,0,1,93
2022,1,مكتب محافظة الطائف,صُنع الملبوسات,523,50,2,0,575
2022,1,مكتب محافظة الطائف,صُنع المنتجات الجلدية والمنتجات ذات الصلة,8,0,0,0,8
2022,1,مكتب محافظة الطائف,صنع المنتجات الصيدلانية الأساسية والمستحضرات الصيدلانية,1,0,0,0,1
2022,1,مكتب محافظة الطائف,صُنع المنتجات الغذائية,356,95,4,1,456
2022,1,مكتب محافظة الطائف,صُنع المنسوجات,63,22,0,0,85
2022,1,مكتب محافظة الطائف,صُنع المواد الكيميائية والمنتجات الكيميائية,60,11,3,0,74
2022,1,مكتب محافظة الطائف,صُنع الورق ومنتجات الورق,7,5,0,0,12
2022,1,مكتب محافظة الطائف,صُنع منتجات التبغ,1,0,0,0,1
2022,1,مكتب محافظة الطائف,صنع منتجات المطاط واللدائن,19,7,0,0,26
2022,1,مكتب محافظة الطائف,صنع منتجات المعادن اللافلزية الأخرى,87,24,1,1,113
2022,1,مكتب محافظة الطائف,صنع منتجات المعادن المشكلة ( باستثناء الآلات والمعدات ),516,60,0,0,576
2022,1,مكتب محافظة الطائف,صيد الأسماك وتربية المائيات,12,1,0,0,13
2022,1,مكتب محافظة الطائف,وكالات السفر ومشغّلو الجولات السياحية وخدمات الحجز والأنشطة المتصلة بها,16,3,0,0,19
2022,1,مكتب محافظة بيشة,أبحاث الإعلان والسوق,3,0,0,0,3
2022,1,مكتب محافظة بيشة,إصلاح أجهزة الحاسوب والسلع الشخصية والمنزلية,43,5,0,0,48
2022,1,مكتب محافظة بيشة,إصلاح وتركيب الآلات والمعدات,11,0,0,0,11
2022,1,مكتب محافظة بيشة,أنشطة الاستخدام,8,1,0,0,9
2022,1,مكتب محافظة بيشة,أنشطة الاسر المعيشية التي تستخدم أفراداً للعمل المنزلي,1,0,0,0,1
2022,1,مكتب محافظة بيشة,أنشطة البرمجة الحاسوبية والخبرة الاستشارية وما يتصل بها من أنشطة,2,0,0,0,2
2022,1,مكتب محافظة بيشة,أنشطة التشييد المتخصصة,572,67,1,0,640
2022,1,مكتب محافظة بيشة,أنشطة الخدمات الشخصية الأخرى,226,20,0,0,246
2022,1,مكتب محافظة بيشة,أنشطة الخدمات المالية ، فيما عدا تمويل التأمين وصناديق المعاشات,13,2,0,0,15
2022,1,مكتب محافظة بيشة,أنشطة العمل الاجتماعي، دون إقامة، لكبار السن وذوي الإعاقة,27,9,0,0,36
2022,1,مكتب محافظة بيشة,أنشطة المعمارية والهندسية ، والاختبارات الفنية والتحليل,22,4,2,0,28
2022,1,مكتب محافظة بيشة,أنشطة المكاتب الرئيسية ، وألأنشطة الاستشارية في مجال الإدارة,6,1,0,0,7
2022,1,مكتب محافظة بيشة,أنشطة المكتبات ودور المحفوظات، والمتاحف والأنشطة الثقافية الأخرى,9,3,0,0,12
2022,1,مكتب محافظة بيشة,أنشطة المنظمات ذات العضوية,7,1,0,0,8
2022,1,مكتب محافظة بيشة,أنشطة النشر,3,0,0,0,3
2022,1,مكتب محافظة بيشة,أنشطة تقديم الخدمات للمباني وتجميل المواقع,48,13,0,0,61
2022,1,مكتب محافظة بيشة,أنشطة جمع النفايات ومعالجتها وتصريفها ، واسترجاع المواد,1,0,0,0,1
2022,1,مكتب محافظة بيشة,أنشطة خدمات الأطعمة والمشروبات,566,93,2,0,661
2022,1,مكتب محافظة بيشة,أنشطة خدمات المعلومات,1,0,0,0,1
2022,1,مكتب محافظة بيشة,أنشطة خدمات دعم التعدين,8,0,0,0,8
2022,1,مكتب محافظة بيشة,أنشطة زراعة المحاصيل والإنتاج الحيواني والصيد والخدمات المتصلة,467,15,0,0,482
2022,1,مكتب محافظة بيشة,الإدارة العامة والدفاع ؛ والضمان الاجتماعي الإلزامي,4,4,0,0,8
2022,1,مكتب محافظة بيشة,الإقامة,31,12,1,0,44
2022,1,مكتب محافظة بيشة,الأنشطة الأخرى للتعدين واستغلال المحاجر,7,4,1,0,12
2022,1,مكتب محافظة بيشة,الأنشطة الإدارية للمكاتب ، وأنشطة الدعم للمكاتب وغير ذلك من أنشطة الدعم للأعمال,15,3,0,0,18
2022,1,مكتب محافظة بيشة,الأنشطة الإيجارية,257,7,1,0,265
2022,1,مكتب محافظة بيشة,الأنشطة البيطرية,6,0,0,0,6
2022,1,مكتب محافظة بيشة,الأنشطة الرياضية وأنشطة التسلية والترفيه,9,4,0,0,13
2022,1,مكتب محافظة بيشة,الأنشطة العقارية,6,3,1,0,10
2022,1,مكتب محافظة بيشة,الأنشطة القانونية وأنشطة المحاسبة,1,0,0,0,1
2022,1,مكتب محافظة بيشة,الأنشطة المهنية والعلمية والتقنية الأخرى,4,0,0,0,4
2022,1,مكتب محافظة بيشة,الاتصالات,7,2,0,0,9
2022,1,مكتب محافظة بيشة,البحث والتطوير في المجال العلمي,1,0,0,0,1
2022,1,مكتب محافظة بيشة,التخزين وأنشطة الدعم للنقل,35,4,0,0,39
2022,1,مكتب محافظة بيشة,التعليم,15,7,1,0,23
2022,1,مكتب محافظة بيشة,الرعاية مع الإقامة,4,0,0,0,4
2022,1,مكتب محافظة بيشة,الصحة البشرية,8,13,2,0,23
2022,1,مكتب محافظة بيشة,الصناعة التحويلية الأخرى,2,1,0,0,3
2022,1,مكتب محافظة بيشة,الطباعة واستنساخ وسائط الأعلام المسجّلة,7,0,0,0,7
2022,1,مكتب محافظة بيشة,النقل البري و النقل عبر الأنابيب,309,28,1,0,338
2022,1,مكتب محافظة بيشة,النقل الجوي,1,2,0,0,3
2022,1,مكتب محافظة بيشة,النقل المائي,1,1,0,0,2
2022,1,مكتب محافظة بيشة,الهندسة المدنية,5,2,0,0,7
2022,1,مكتب محافظة بيشة,تجارة التجزئة، باستثناء المركبات ذات المحركات والدراجات النارية,926,163,6,0,1095
2022,1,مكتب محافظة بيشة,تجارة الجملة ، باستثناء المركبات ذات المحركات والدراجات النارية,211,70,1,1,283
2022,1,مكتب محافظة بيشة,تجارة الجملة والتجزئة ، وإصلاح المركبات ذات المحركات والدراجات النارية,423,35,3,0,461
2022,1,مكتب محافظة بيشة,تجميع المياه ومعالجتها وتوصيلها,8,3,0,0,11
2022,1,مكتب محافظة بيشة,تشييد المباني,806,169,7,3,985
2022,1,مكتب محافظة بيشة,تعدين ركازات الفلزات,13,4,0,0,17
2022,1,مكتب محافظة بيشة,توصيل الكهرباء والغاز والبخار وتكييف الهواء,6,2,0,0,8
2022,1,مكتب محافظة بيشة,صناعة الآلات والمعدات غير المصنفة في موضع أخر,5,0,0,0,5
2022,1,مكتب محافظة بيشة,صناعة المركبات ذات المحركات والمركبات المقطورة ونصف المقطورة,8,0,0,0,8
2022,1,مكتب محافظة بيشة,صناعة معدات النقل الأخرى,2,0,0,0,2
2022,1,مكتب محافظة بيشة,صنع الأثاث,48,13,0,0,61
2022,1,مكتب محافظة بيشة,صنع الحواسيب والمنتجات الإلكترونية والبصرية,36,4,0,0,40
2022,1,مكتب محافظة بيشة,صُنع الخشب ومنتجات الخشب والفلين ، باستثناء الأثاث ، صُنع أصناف من القش ومواد الضفر,45,6,0,0,51
2022,1,مكتب محافظة بيشة,صنع الفلزات القاعدية,34,5,0,0,39
2022,1,مكتب محافظة بيشة,صُنع المشروبات,8,0,0,0,8
2022,1,مكتب محافظة بيشة,صنع المعدات الكهربائية,20,0,0,0,20
2022,1,مكتب محافظة بيشة,صُنع الملبوسات,125,17,1,0,143
2022,1,مكتب محافظة بيشة,صُنع المنتجات الجلدية والمنتجات ذات الصلة,4,1,0,0,5
2022,1,مكتب محافظة بيشة,صنع المنتجات الصيدلانية الأساسية والمستحضرات الصيدلانية,1,1,0,0,2
2022,1,مكتب محافظة بيشة,صُنع المنتجات الغذائية,88,13,0,0,101
2022,1,مكتب محافظة بيشة,صُنع المنسوجات,20,2,0,0,22
2022,1,مكتب محافظة بيشة,صُنع المواد الكيميائية والمنتجات الكيميائية,20,2,0,0,22
2022,1,مكتب محافظة بيشة,صُنع الورق ومنتجات الورق,1,0,0,0,1
2022,1,مكتب محافظة بيشة,صنع منتجات المطاط واللدائن,4,5,0,0,9
2022,1,مكتب محافظة بيشة,صنع منتجات المعادن اللافلزية الأخرى,28,10,3,1,42
2022,1,مكتب محافظة بيشة,صنع منتجات المعادن المشكلة ( باستثناء الآلات والمعدات ),94,10,1,0,105
2022,1,مكتب محافظة بيشة,صيد الأسماك وتربية المائيات,11,0,0,0,11
2022,1,مكتب محافظة بيشة,وكالات السفر ومشغّلو الجولات السياحية وخدمات الحجز والأنشطة المتصلة بها,1,0,0,0,1
2022,1,مكتب محافظة حفر الباطن,أبحاث الإعلان والسوق,12,4,0,0,16
2022,1,مكتب محافظة حفر الباطن,إصلاح أجهزة الحاسوب والسلع الشخصية والمنزلية,55,4,0,0,59
2022,1,مكتب محافظة حفر الباطن,إصلاح وتركيب الآلات والمعدات,27,0,0,0,27
2022,1,مكتب محافظة حفر الباطن,أنشطة أنتاج الأفلام والبرامج التلفزيونية والتسجيلات الصوتية و نشرالموسيقى,2,0,0,0,2
2022,1,مكتب محافظة حفر الباطن,أنشطة الأمن والتحقيقات,1,2,1,0,4
2022,1,مكتب محافظة حفر الباطن,أنشطة الاستخدام,16,8,1,1,26
2022,1,مكتب محافظة حفر الباطن,أنشطة الاسر المعيشية التي تستخدم أفراداً للعمل المنزلي,1,0,0,0,1
2022,1,مكتب محافظة حفر الباطن,أنشطة البرمجة الحاسوبية والخبرة الاستشارية وما يتصل بها من أنشطة,3,1,0,0,4
2022,1,مكتب محافظة حفر الباطن,أنشطة البريد ونقل الرسائل والطرود بواسطة مندوبين,2,0,0,0,2
2022,1,مكتب محافظة حفر الباطن,أنشطة التشييد المتخصصة,679,134,10,2,825
2022,1,مكتب محافظة حفر الباطن,أنشطة الخدمات الشخصية الأخرى,541,49,1,0,591
2022,1,مكتب محافظة حفر الباطن,أنشطة الخدمات المالية ، فيما عدا تمويل التأمين وصناديق المعاشات,14,5,0,0,19
2022,1,مكتب محافظة حفر الباطن,أنشطة العمل الاجتماعي، دون إقامة، لكبار السن وذوي الإعاقة,3,3,0,0,6
2022,1,مكتب محافظة حفر الباطن,أنشطة المعمارية والهندسية ، والاختبارات الفنية والتحليل,36,12,2,0,50
2022,1,مكتب محافظة حفر الباطن,أنشطة المكاتب الرئيسية ، وألأنشطة الاستشارية في مجال الإدارة,14,2,0,0,16
2022,1,مكتب محافظة حفر الباطن,أنشطة المكتبات ودور المحفوظات، والمتاحف والأنشطة الثقافية الأخرى,9,4,0,0,13
2022,1,مكتب محافظة حفر الباطن,أنشطة المنظمات ذات العضوية,0,1,0,0,1
2022,1,مكتب محافظة حفر الباطن,أنشطة النشر,13,5,0,0,18
2022,1,مكتب محافظة حفر الباطن,أنشطة تقديم الخدمات للمباني وتجميل المواقع,119,24,2,0,145
2022,1,مكتب محافظة حفر الباطن,أنشطة جمع النفايات ومعالجتها وتصريفها ، واسترجاع المواد,1,0,1,0,2
2022,1,مكتب محافظة حفر الباطن,أنشطة خدمات الأطعمة والمشروبات,1438,298,18,1,1755
2022,1,مكتب محافظة حفر الباطن,أنشطة خدمات المعلومات,5,0,0,0,5
2022,1,مكتب محافظة حفر الباطن,أنشطة خدمات دعم التعدين,9,2,0,0,11
2022,1,مكتب محافظة حفر الباطن,أنشطة زراعة المحاصيل والإنتاج الحيواني والصيد والخدمات المتصلة,193,3,0,0,196
2022,1,مكتب محافظة حفر الباطن,الإدارة العامة والدفاع ؛ والضمان الاجتماعي الإلزامي,7,6,0,0,13
2022,1,مكتب محافظة حفر الباطن,الإقامة,43,15,1,0,59
2022,1,مكتب محافظة حفر الباطن,الأنشطة الأخرى للتعدين واستغلال المحاجر,10,2,0,0,12
2022,1,مكتب محافظة حفر الباطن,الأنشطة الإدارية للمكاتب ، وأنشطة الدعم للمكاتب وغير ذلك من أنشطة الدعم للأعمال,27,4,0,0,31
2022,1,مكتب محافظة حفر الباطن,الأنشطة الإيجارية,483,25,0,0,508
2022,1,مكتب محافظة حفر الباطن,الأنشطة البيطرية,7,1,0,0,8
2022,1,مكتب محافظة حفر الباطن,الأنشطة الرياضية وأنشطة التسلية والترفيه,18,6,0,0,24
2022,1,مكتب محافظة حفر الباطن,الأنشطة العقارية,18,2,0,0,20
2022,1,مكتب محافظة حفر الباطن,الأنشطة القانونية وأنشطة المحاسبة,4,0,0,0,4
2022,1,مكتب محافظة حفر الباطن,الأنشطة المساعدة لأنشطة الخدمات المالية وأنشطة التأمين,1,2,0,0,3
2022,1,مكتب محافظة حفر الباطن,الأنشطة المهنية والعلمية والتقنية الأخرى,8,3,1,0,12
2022,1,مكتب محافظة حفر الباطن,الاتصالات,9,0,0,0,9
2022,1,مكتب محافظة حفر الباطن,التخزين وأنشطة الدعم للنقل,83,26,1,0,110
2022,1,مكتب محافظة حفر الباطن,التعليم,17,24,7,1,49
2022,1,مكتب محافظة حفر الباطن,الصحة البشرية,19,23,9,1,52
2022,1,مكتب محافظة حفر الباطن,الصناعة التحويلية الأخرى,5,1,0,0,6
2022,1,مكتب محافظة حفر الباطن,الطباعة واستنساخ وسائط الأعلام المسجّلة,10,3,0,0,13
2022,1,مكتب محافظة حفر الباطن,النقل البري و النقل عبر الأنابيب,414,69,5,2,490
2022,1,مكتب محافظة حفر الباطن,النقل الجوي,7,5,0,0,12
2022,1,مكتب محافظة حفر الباطن,النقل المائي,5,0,0,0,5
2022,1,مكتب محافظة حفر الباطن,الهندسة المدنية,2,1,0,0,3
2022,1,مكتب محافظة حفر الباطن,تجارة التجزئة، باستثناء المركبات ذات المحركات والدراجات النارية,1206,209,9,2,1426
2022,1,مكتب محافظة حفر الباطن,تجارة الجملة ، باستثناء المركبات ذات المحركات والدراجات النارية,365,76,7,1,449
2022,1,مكتب محافظة حفر الباطن,تجارة الجملة والتجزئة ، وإصلاح المركبات ذات المحركات والدراجات النارية,696,121,6,0,823
2022,1,مكتب محافظة حفر الباطن,تجميع المياه ومعالجتها وتوصيلها,4,2,0,0,6
2022,1,مكتب محافظة حفر الباطن,تشييد المباني,1304,308,36,2,1650
2022,1,مكتب محافظة حفر الباطن,تعدين الفحم والليغنيت,1,0,0,0,1
2022,1,مكتب محافظة حفر الباطن,تعدين ركازات الفلزات,46,7,0,0,53
2022,1,مكتب محافظة حفر الباطن,توصيل الكهرباء والغاز والبخار وتكييف الهواء,4,4,0,0,8
2022,1,مكتب محافظة حفر الباطن,صناعة الآلات والمعدات غير المصنفة في موضع أخر,14,1,0,0,15
2022,1,مكتب محافظة حفر الباطن,صناعة المركبات ذات المحركات والمركبات المقطورة ونصف المقطورة,16,1,0,0,17
2022,1,مكتب محافظة حفر الباطن,صناعة معدات النقل الأخرى,8,0,0,0,8
2022,1,مكتب محافظة حفر الباطن,صنع الأثاث,100,21,0,0,121
2022,1,مكتب محافظة حفر الباطن,صنع الحواسيب والمنتجات الإلكترونية والبصرية,16,3,0,0,19
2022,1,مكتب محافظة حفر الباطن,صُنع الخشب ومنتجات الخشب والفلين ، باستثناء الأثاث ، صُنع أصناف من القش ومواد الضفر,59,10,0,0,69
2022,1,مكتب محافظة حفر الباطن,صنع الفلزات القاعدية,25,10,0,0,35
2022,1,مكتب محافظة حفر الباطن,صُنع المشروبات,9,3,3,0,15
2022,1,مكتب محافظة حفر الباطن,صنع المعدات الكهربائية,70,11,0,0,81
2022,1,مكتب محافظة حفر الباطن,صُنع الملبوسات,298,38,0,0,336
2022,1,مكتب محافظة حفر الباطن,صُنع المنتجات الجلدية والمنتجات ذات الصلة,2,2,1,0,5
2022,1,مكتب محافظة حفر الباطن,صنع المنتجات الصيدلانية الأساسية والمستحضرات الصيدلانية,0,1,0,0,1
2022,1,مكتب محافظة حفر الباطن,صُنع المنتجات الغذائية,120,37,7,1,165
2022,1,مكتب محافظة حفر الباطن,صُنع المنسوجات,59,13,1,0,73
2022,1,مكتب محافظة حفر الباطن,صُنع المواد الكيميائية والمنتجات الكيميائية,24,7,0,0,31
2022,1,مكتب محافظة حفر الباطن,صُنع الورق ومنتجات الورق,4,4,0,0,8
2022,1,مكتب محافظة حفر الباطن,صنع فحم الكوك والمنتجات النفطية المكررة,1,0,0,0,1
2022,1,مكتب محافظة حفر الباطن,صُنع منتجات التبغ,2,1,0,0,3
2022,1,مكتب محافظة حفر الباطن,صنع منتجات المطاط واللدائن,10,5,1,0,16
2022,1,مكتب محافظة حفر الباطن,صنع منتجات المعادن اللافلزية الأخرى,98,31,8,0,137
2022,1,مكتب محافظة حفر الباطن,صنع منتجات المعادن المشكلة ( باستثناء الآلات والمعدات ),121,32,2,0,155
2022,1,مكتب محافظة حفر الباطن,صيد الأسماك وتربية المائيات,8,0,0,0,8
2022,1,مكتب محافظة حفر الباطن,وكالات السفر ومشغّلو الجولات السياحية وخدمات الحجز والأنشطة المتصلة بها,2,3,0,0,5
2022,1,مكتب محافظة ينبع,أبحاث الإعلان والسوق,12,0,0,0,12
2022,1,مكتب محافظة ينبع,إصلاح أجهزة الحاسوب والسلع الشخصية والمنزلية,65,7,0,0,72
2022,1,مكتب محافظة ينبع,إصلاح وتركيب الآلات والمعدات,22,5,0,0,27
2022,1,مكتب محافظة ينبع,أنشطة أنتاج الأفلام والبرامج التلفزيونية والتسجيلات الصوتية و نشرالموسيقى,6,0,0,0,6
2022,1,مكتب محافظة ينبع,أنشطة الاستخدام,11,1,0,0,12
2022,1,مكتب محافظة ينبع,أنشطة الاسر المعيشية التي تستخدم أفراداً للعمل المنزلي,1,0,0,0,1
2022,1,مكتب محافظة ينبع,أنشطة البرمجة الحاسوبية والخبرة الاستشارية وما يتصل بها من أنشطة,5,2,0,0,7
2022,1,مكتب محافظة ينبع,أنشطة البريد ونقل الرسائل والطرود بواسطة مندوبين,1,0,0,0,1
2022,1,مكتب محافظة ينبع,أنشطة التشييد المتخصصة,558,120,9,0,687
2022,1,مكتب محافظة ينبع,أنشطة الخدمات الشخصية الأخرى,346,45,4,0,395
2022,1,مكتب محافظة ينبع,أنشطة الخدمات المالية ، فيما عدا تمويل التأمين وصناديق المعاشات,4,0,0,0,4
2022,1,مكتب محافظة ينبع,أنشطة العمل الاجتماعي، دون إقامة، لكبار السن وذوي الإعاقة,24,8,0,0,32
2022,1,مكتب محافظة ينبع,أنشطة المعمارية والهندسية ، والاختبارات الفنية والتحليل,28,5,0,1,34
2022,1,مكتب محافظة ينبع,أنشطة المكاتب الرئيسية ، وألأنشطة الاستشارية في مجال الإدارة,7,1,0,0,8
2022,1,مكتب محافظة ينبع,أنشطة المكتبات ودور المحفوظات، والمتاحف والأنشطة الثقافية الأخرى,9,1,0,0,10
2022,1,مكتب محافظة ينبع,أنشطة المنظمات الدولية,1,0,0,0,1
2022,1,مكتب محافظة ينبع,أنشطة المنظمات ذات العضوية,9,4,0,0,13
2022,1,مكتب محافظة ينبع,أنشطة النشر,3,1,0,0,4
2022,1,مكتب محافظة ينبع,أنشطة تقديم الخدمات للمباني وتجميل المواقع,114,48,0,1,163
2022,1,مكتب محافظة ينبع,أنشطة خدمات الأطعمة والمشروبات,884,243,10,0,1137
2022,1,مكتب محافظة ينبع,أنشطة خدمات المعلومات,3,2,0,0,5
2022,1,مكتب محافظة ينبع,أنشطة خدمات دعم التعدين,3,4,0,2,9
2022,1,مكتب محافظة ينبع,أنشطة زراعة المحاصيل والإنتاج الحيواني والصيد والخدمات المتصلة,151,9,0,0,160
2022,1,مكتب محافظة ينبع,الإدارة العامة والدفاع ؛ والضمان الاجتماعي الإلزامي,5,13,0,0,18
2022,1,مكتب محافظة ينبع,الإقامة,50,19,4,0,73
2022,1,مكتب محافظة ينبع,الأنشطة الإبداعية والفنون وأنشطة الترفيه,3,1,0,0,4
2022,1,مكتب محافظة ينبع,الأنشطة الأخرى للتعدين واستغلال المحاجر,5,0,0,0,5
2022,1,مكتب محافظة ينبع,الأنشطة الإدارية للمكاتب ، وأنشطة الدعم للمكاتب وغير ذلك من أنشطة الدعم للأعمال,16,0,0,0,16
2022,1,مكتب محافظة ينبع,الأنشطة الإيجارية,178,14,1,0,193
2022,1,مكتب محافظة ينبع,الأنشطة الرياضية وأنشطة التسلية والترفيه,22,7,1,0,30
2022,1,مكتب محافظة ينبع,الأنشطة العقارية,16,1,0,0,17
2022,1,مكتب محافظة ينبع,الأنشطة القانونية وأنشطة المحاسبة,3,0,0,0,3
2022,1,مكتب محافظة ينبع,الأنشطة المهنية والعلمية والتقنية الأخرى,10,1,0,0,11
2022,1,مكتب محافظة ينبع,الاتصالات,8,1,0,0,9
2022,1,مكتب محافظة ينبع,البحث والتطوير في المجال العلمي,0,0,1,0,1
2022,1,مكتب محافظة ينبع,التخزين وأنشطة الدعم للنقل,43,12,2,1,58
2022,1,مكتب محافظة ينبع,التعليم,22,15,9,0,46
2022,1,مكتب محافظة ينبع,الرعاية مع الإقامة,6,1,0,0,7
2022,1,مكتب محافظة ينبع,الصحة البشرية,16,21,4,2,43
2022,1,مكتب محافظة ينبع,الصرف الصحي,1,0,0,0,1
2022,1,مكتب محافظة ينبع,الصناعة التحويلية الأخرى,6,1,0,0,7
2022,1,مكتب محافظة ينبع,الطباعة واستنساخ وسائط الأعلام المسجّلة,15,2,1,0,18
2022,1,مكتب محافظة ينبع,النقل البري و النقل عبر الأنابيب,295,45,10,0,350
2022,1,مكتب محافظة ينبع,النقل الجوي,7,2,0,0,9
2022,1,مكتب محافظة ينبع,النقل المائي,9,1,1,0,11
2022,1,مكتب محافظة ينبع,الهندسة المدنية,6,6,0,0,12
2022,1,مكتب محافظة ينبع,تجارة التجزئة، باستثناء المركبات ذات المحركات والدراجات النارية,990,201,11,2,1204
2022,1,مكتب محافظة ينبع,تجارة الجملة ، باستثناء المركبات ذات المحركات والدراجات النارية,303,91,9,0,403
2022,1,مكتب محافظة ينبع,تجارة الجملة والتجزئة ، وإصلاح المركبات ذات المحركات والدراجات النارية,506,75,1,0,582
2022,1,مكتب محافظة ينبع,تجميع المياه ومعالجتها وتوصيلها,4,2,0,0,6
2022,1,مكتب محافظة ينبع,تشييد المباني,929,373,51,3,1356
2022,1,مكتب محافظة ينبع,تعدين الفحم والليغنيت,1,0,0,0,1
2022,1,مكتب محافظة ينبع,تعدين ركازات الفلزات,4,1,0,0,5
2022,1,مكتب محافظة ينبع,تمويل التأمين وإعادة التأمين وصناديق المعاشات التقاعدية باستثناء الضمان الاجتماعي الإلزامي,1,0,0,0,1
2022,1,مكتب محافظة ينبع,توصيل الكهرباء والغاز والبخار وتكييف الهواء,5,3,0,0,8
2022,1,مكتب محافظة ينبع,صناعة الآلات والمعدات غير المصنفة في موضع أخر,3,1,1,0,5
2022,1,مكتب محافظة ينبع,صناعة المركبات ذات المحركات والمركبات المقطورة ونصف المقطورة,8,1,1,0,10
2022,1,مكتب محافظة ينبع,صناعة معدات النقل الأخرى,5,0,0,0,5
2022,1,مكتب محافظة ينبع,صنع الأثاث,40,3,0,0,43
2022,1,مكتب محافظة ينبع,صنع الحواسيب والمنتجات الإلكترونية والبصرية,9,4,0,0,13
2022,1,مكتب محافظة ينبع,صُنع الخشب ومنتجات الخشب والفلين ، باستثناء الأثاث ، صُنع أصناف من القش ومواد الضفر,35,5,1,0,41
2022,1,مكتب محافظة ينبع,صنع الفلزات القاعدية,21,4,2,0,27
2022,1,مكتب محافظة ينبع,صُنع المشروبات,4,1,0,0,5
2022,1,مكتب محافظة ينبع,صنع المعدات الكهربائية,16,4,1,1,22
2022,1,مكتب محافظة ينبع,صُنع الملبوسات,162,17,0,0,179
2022,1,مكتب محافظة ينبع,صُنع المنتجات الجلدية والمنتجات ذات الصلة,1,0,0,0,1
2022,1,مكتب محافظة ينبع,صُنع المنتجات الغذائية,84,20,7,0,111
2022,1,مكتب محافظة ينبع,صُنع المنسوجات,10,1,1,0,12
2022,1,مكتب محافظة ينبع,صُنع المواد الكيميائية والمنتجات الكيميائية,9,10,7,2,28
2022,1,مكتب محافظة ينبع,صُنع الورق ومنتجات الورق,4,2,1,0,7
2022,1,مكتب محافظة ينبع,صنع فحم الكوك والمنتجات النفطية المكررة,1,1,3,0,5
2022,1,مكتب محافظة ينبع,صُنع منتجات التبغ,1,0,0,0,1
2022,1,مكتب محافظة ينبع,صنع منتجات المطاط واللدائن,7,6,1,1,15
2022,1,مكتب محافظة ينبع,صنع منتجات المعادن اللافلزية الأخرى,30,17,15,4,66
2022,1,مكتب محافظة ينبع,صنع منتجات المعادن المشكلة ( باستثناء الآلات والمعدات ),66,12,3,0,81
2022,1,مكتب محافظة ينبع,صيد الأسماك وتربية المائيات,39,16,0,0,55
2022,1,مكتب محافظة ينبع,وكالات السفر ومشغّلو الجولات السياحية وخدمات الحجز والأنشطة المتصلة بها,6,1,0,0,7
2022,1,مكتب مكة المكرمة,أبحاث الإعلان والسوق,52,4,0,0,56
2022,1,مكتب مكة المكرمة,إصلاح أجهزة الحاسوب والسلع الشخصية والمنزلية,278,37,0,0,315
2022,1,مكتب مكة المكرمة,إصلاح وتركيب الآلات والمعدات,157,10,0,0,167
2022,1,مكتب مكة المكرمة,أنشطة أنتاج الأفلام والبرامج التلفزيونية والتسجيلات الصوتية و نشرالموسيقى,23,3,0,0,26
2022,1,مكتب مكة المكرمة,أنشطة الأمن والتحقيقات,18,6,4,2,30
2022,1,مكتب مكة المكرمة,أنشطة الاستخدام,36,3,0,1,40
2022,1,مكتب مكة المكرمة,أنشطة الاسر المعيشية التي تستخدم أفراداً للعمل المنزلي,3,0,0,0,3
2022,1,مكتب مكة المكرمة,أنشطة البرمجة الحاسوبية والخبرة الاستشارية وما يتصل بها من أنشطة,39,11,0,0,50
2022,1,مكتب مكة المكرمة,أنشطة البرمجة والإذاعة,1,0,0,0,1
2022,1,مكتب مكة المكرمة,أنشطة البريد ونقل الرسائل والطرود بواسطة مندوبين,7,1,0,0,8
2022,1,مكتب مكة المكرمة,أنشطة التشييد المتخصصة,2406,540,37,2,2985
2022,1,مكتب مكة المكرمة,أنشطة الخدمات الشخصية الأخرى,1913,259,9,0,2181
2022,1,مكتب مكة المكرمة,أنشطة الخدمات المالية ، فيما عدا تمويل التأمين وصناديق المعاشات,60,12,0,0,72
2022,1,مكتب مكة المكرمة,أنشطة العمل الاجتماعي، دون إقامة، لكبار السن وذوي الإعاقة,205,109,8,2,324
2022,1,مكتب مكة المكرمة,أنشطة المعالجة وخدمات إدارة النفايات الأخرى,1,0,0,0,1
2022,1,مكتب مكة المكرمة,أنشطة المعمارية والهندسية ، والاختبارات الفنية والتحليل,256,170,6,2,434
2022,1,مكتب مكة المكرمة,أنشطة المكاتب الرئيسية ، وألأنشطة الاستشارية في مجال الإدارة,67,11,0,0,78
2022,1,مكتب مكة المكرمة,أنشطة المكتبات ودور المحفوظات، والمتاحف والأنشطة الثقافية الأخرى,54,14,1,0,69
2022,1,مكتب مكة المكرمة,أنشطة المنظمات الدولية,1,0,0,0,1
2022,1,مكتب مكة المكرمة,أنشطة المنظمات ذات العضوية,42,9,0,0,51
2022,1,مكتب مكة المكرمة,أنشطة النشر,21,1,0,0,22
2022,1,مكتب مكة المكرمة,أنشطة تقديم الخدمات للمباني وتجميل المواقع,780,207,23,2,1012
2022,1,مكتب مكة المكرمة,أنشطة جمع النفايات ومعالجتها وتصريفها ، واسترجاع المواد,3,0,0,0,3
2022,1,مكتب مكة المكرمة,أنشطة خدمات الأطعمة والمشروبات,4262,986,68,4,5320
2022,1,مكتب مكة المكرمة,أنشطة خدمات المعلومات,24,1,0,0,25
2022,1,مكتب مكة المكرمة,أنشطة خدمات دعم التعدين,10,6,1,0,17
2022,1,مكتب مكة المكرمة,أنشطة زراعة المحاصيل والإنتاج الحيواني والصيد والخدمات المتصلة,596,33,1,1,631
2022,1,مكتب مكة المكرمة,الإدارة العامة والدفاع ؛ والضمان الاجتماعي الإلزامي,63,42,3,0,108
2022,1,مكتب مكة المكرمة,الإقامة,356,164,41,7,568
2022,1,مكتب مكة المكرمة,الأنشطة الإبداعية والفنون وأنشطة الترفيه,9,0,0,0,9
2022,1,مكتب مكة المكرمة,الأنشطة الأخرى للتعدين واستغلال المحاجر,11,3,0,0,14
2022,1,مكتب مكة المكرمة,الأنشطة الإدارية للمكاتب ، وأنشطة الدعم للمكاتب وغير ذلك من أنشطة الدعم للأعمال,151,11,0,0,162
2022,1,مكتب مكة المكرمة,الأنشطة الإيجارية,877,39,1,1,918
2022,1,مكتب مكة المكرمة,الأنشطة البيطرية,10,4,0,0,14
2022,1,مكتب مكة المكرمة,الأنشطة الرياضية وأنشطة التسلية والترفيه,69,29,1,0,99
2022,1,مكتب مكة المكرمة,الأنشطة العقارية,200,30,3,0,233
2022,1,مكتب مكة المكرمة,الأنشطة القانونية وأنشطة المحاسبة,42,5,0,0,47
2022,1,مكتب مكة المكرمة,الأنشطة المساعدة لأنشطة الخدمات المالية وأنشطة التأمين,11,10,1,0,22
2022,1,مكتب مكة المكرمة,الأنشطة المهنية والعلمية والتقنية الأخرى,60,12,0,0,72
2022,1,مكتب مكة المكرمة,الاتصالات,46,2,0,0,48
2022,1,مكتب مكة المكرمة,البحث والتطوير في المجال العلمي,2,0,0,0,2
2022,1,مكتب مكة المكرمة,التخزين وأنشطة الدعم للنقل,89,13,2,0,104
2022,1,مكتب مكة المكرمة,التعليم,68,49,22,2,141
2022,1,مكتب مكة المكرمة,الحراجة وقطع الأخشاب,1,1,0,0,2
2022,1,مكتب مكة المكرمة,الرعاية مع الإقامة,13,3,1,0,17
2022,1,مكتب مكة المكرمة,الصحة البشرية,82,125,32,3,242
2022,1,مكتب مكة المكرمة,الصرف الصحي,6,0,1,0,7
2022,1,مكتب مكة المكرمة,الصناعة التحويلية الأخرى,38,12,2,0,52
2022,1,مكتب مكة المكرمة,الطباعة واستنساخ وسائط الأعلام المسجّلة,61,23,3,0,87
2022,1,مكتب مكة المكرمة,النقل البري و النقل عبر الأنابيب,964,145,14,2,1125
2022,1,مكتب مكة المكرمة,النقل الجوي,21,4,1,0,26
2022,1,مكتب مكة المكرمة,النقل المائي,19,1,0,0,20
2022,1,مكتب مكة المكرمة,الهندسة المدنية,51,8,0,1,60
2022,1,مكتب مكة المكرمة,تجارة التجزئة، باستثناء المركبات ذات المحركات والدراجات النارية,5447,1114,52,5,6618
2022,1,مكتب مكة المكرمة,تجارة الجملة ، باستثناء المركبات ذات المحركات والدراجات النارية,1676,445,32,2,2155
2022,1,مكتب مكة المكرمة,تجارة الجملة والتجزئة ، وإصلاح المركبات ذات المحركات والدراجات النارية,2011,318,6,0,2335
2022,1,مكتب مكة المكرمة,تجميع المياه ومعالجتها وتوصيلها,63,24,0,1,88
2022,1,مكتب مكة المكرمة,تشييد المباني,5148,1711,156,12,7027
2022,1,مكتب مكة المكرمة,تعدين ركازات الفلزات,22,3,0,0,25
2022,1,مكتب مكة المكرمة,تمويل التأمين وإعادة التأمين وصناديق المعاشات التقاعدية باستثناء الضمان الاجتماعي الإلزامي,2,2,0,0,4
2022,1,مكتب مكة المكرمة,توصيل الكهرباء والغاز والبخار وتكييف الهواء,9,9,2,0,20
2022,1,مكتب مكة المكرمة,صناعة الآلات والمعدات غير المصنفة في موضع أخر,29,2,0,0,31
2022,1,مكتب مكة المكرمة,صناعة المركبات ذات المحركات والمركبات المقطورة ونصف المقطورة,44,5,1,0,50
2022,1,مكتب مكة المكرمة,صناعة معدات النقل الأخرى,17,0,0,1,18
2022,1,مكتب مكة المكرمة,صنع الأثاث,140,38,1,0,179
2022,1,مكتب مكة المكرمة,صنع الحواسيب والمنتجات الإلكترونية والبصرية,65,18,0,0,83
2022,1,مكتب مكة المكرمة,صُنع الخشب ومنتجات الخشب والفلين ، باستثناء الأثاث ، صُنع أصناف من القش ومواد الضفر,210,38,2,0,250
2022,1,مكتب مكة المكرمة,صنع الفلزات القاعدية,60,25,2,0,87
2022,1,مكتب مكة المكرمة,صُنع المشروبات,20,6,3,0,29
2022,1,مكتب مكة المكرمة,صنع المعدات الكهربائية,89,15,1,0,105
2022,1,مكتب مكة المكرمة,صُنع الملبوسات,697,89,0,0,786
2022,1,مكتب مكة المكرمة,صُنع المنتجات الجلدية والمنتجات ذات الصلة,15,2,0,0,17
2022,1,مكتب مكة المكرمة,صنع المنتجات الصيدلانية الأساسية والمستحضرات الصيدلانية,3,1,0,0,4
2022,1,مكتب مكة المكرمة,صُنع المنتجات الغذائية,535,151,17,2,705
2022,1,مكتب مكة المكرمة,صُنع المنسوجات,117,23,0,0,140
2022,1,مكتب مكة المكرمة,صُنع المواد الكيميائية والمنتجات الكيميائية,72,28,0,0,100
2022,1,مكتب مكة المكرمة,صُنع الورق ومنتجات الورق,4,4,0,0,8
2022,1,مكتب مكة المكرمة,صُنع منتجات التبغ,3,0,0,0,3
2022,1,مكتب مكة المكرمة,صنع منتجات المطاط واللدائن,15,11,2,1,29
2022,1,مكتب مكة المكرمة,صنع منتجات المعادن اللافلزية الأخرى,101,34,9,0,144
2022,1,مكتب مكة المكرمة,صنع منتجات المعادن المشكلة ( باستثناء الآلات والمعدات ),467,88,10,0,565
2022,1,مكتب مكة المكرمة,صيد الأسماك وتربية المائيات,86,15,1,0,102
2022,1,مكتب مكة المكرمة,وكالات السفر ومشغّلو الجولات السياحية وخدمات الحجز والأنشطة المتصلة بها,114,39,3,0,156
2022,1,مكتب منطقة الباحة,أبحاث الإعلان والسوق,3,2,0,0,5
2022,1,مكتب منطقة الباحة,إصلاح أجهزة الحاسوب والسلع الشخصية والمنزلية,41,4,0,0,45
2022,1,مكتب منطقة الباحة,إصلاح وتركيب الآلات والمعدات,14,2,0,0,16
2022,1,مكتب منطقة الباحة,أنشطة أنتاج الأفلام والبرامج التلفزيونية والتسجيلات الصوتية و نشرالموسيقى,2,0,0,0,2
2022,1,مكتب منطقة الباحة,أنشطة الأمن والتحقيقات,1,0,0,0,1
2022,1,مكتب منطقة الباحة,أنشطة الاستخدام,7,1,0,0,8
2022,1,مكتب منطقة الباحة,أنشطة البرمجة الحاسوبية والخبرة الاستشارية وما يتصل بها من أنشطة,1,0,0,0,1
2022,1,مكتب منطقة الباحة,أنشطة التشييد المتخصصة,461,69,0,1,531
2022,1,مكتب منطقة الباحة,أنشطة الخدمات الشخصية الأخرى,264,18,0,0,282
2022,1,مكتب منطقة الباحة,أنشطة الخدمات المالية ، فيما عدا تمويل التأمين وصناديق المعاشات,7,0,0,0,7
2022,1,مكتب منطقة الباحة,أنشطة العمل الاجتماعي، دون إقامة، لكبار السن وذوي الإعاقة,29,15,0,0,44
2022,1,مكتب منطقة الباحة,أنشطة المعمارية والهندسية ، والاختبارات الفنية والتحليل,83,36,5,0,124
2022,1,مكتب منطقة الباحة,أنشطة المكاتب الرئيسية ، وألأنشطة الاستشارية في مجال الإدارة,5,1,0,0,6
2022,1,مكتب منطقة الباحة,أنشطة المكتبات ودور المحفوظات، والمتاحف والأنشطة الثقافية الأخرى,7,2,0,0,9
2022,1,مكتب منطقة الباحة,أنشطة المنظمات الدولية,0,1,0,0,1
2022,1,مكتب منطقة الباحة,أنشطة المنظمات ذات العضوية,12,6,0,0,18
2022,1,مكتب منطقة الباحة,أنشطة النشر,5,2,0,0,7
2022,1,مكتب منطقة الباحة,أنشطة تقديم الخدمات للمباني وتجميل المواقع,57,7,1,0,65
2022,1,مكتب منطقة الباحة,أنشطة جمع النفايات ومعالجتها وتصريفها ، واسترجاع المواد,1,0,0,0,1
2022,1,مكتب منطقة الباحة,أنشطة خدمات الأطعمة والمشروبات,618,169,7,0,794
2022,1,مكتب منطقة الباحة,أنشطة خدمات المعلومات,2,0,0,0,2
2022,1,مكتب منطقة الباحة,أنشطة خدمات دعم التعدين,7,0,0,0,7
2022,1,مكتب منطقة الباحة,أنشطة زراعة المحاصيل والإنتاج الحيواني والصيد والخدمات المتصلة,258,5,0,0,263
2022,1,مكتب منطقة الباحة,الإدارة العامة والدفاع ؛ والضمان الاجتماعي الإلزامي,6,9,1,0,16
2022,1,مكتب منطقة الباحة,الإقامة,45,21,1,0,67
2022,1,مكتب منطقة الباحة,الأنشطة الإبداعية والفنون وأنشطة الترفيه,1,0,0,0,1
2022,1,مكتب منطقة الباحة,الأنشطة الأخرى للتعدين واستغلال المحاجر,2,3,0,0,5
2022,1,مكتب منطقة الباحة,الأنشطة الإدارية للمكاتب ، وأنشطة الدعم للمكاتب وغير ذلك من أنشطة الدعم للأعمال,20,0,0,0,20
2022,1,مكتب منطقة الباحة,الأنشطة الإيجارية,136,4,0,0,140
2022,1,مكتب منطقة الباحة,الأنشطة البيطرية,2,0,0,0,2
2022,1,مكتب منطقة الباحة,الأنشطة الرياضية وأنشطة التسلية والترفيه,24,1,0,0,25
2022,1,مكتب منطقة الباحة,الأنشطة العقارية,8,2,0,0,10
2022,1,مكتب منطقة الباحة,الأنشطة القانونية وأنشطة المحاسبة,5,0,0,0,5
2022,1,مكتب منطقة الباحة,الأنشطة المهنية والعلمية والتقنية الأخرى,5,1,0,0,6
2022,1,مكتب منطقة الباحة,الاتصالات,9,1,0,0,10
2022,1,مكتب منطقة الباحة,التخزين وأنشطة الدعم للنقل,26,1,0,0,27
2022,1,مكتب منطقة الباحة,التعليم,12,7,0,0,19
2022,1,مكتب منطقة الباحة,الرعاية مع الإقامة,2,5,0,0,7
2022,1,مكتب منطقة الباحة,الصحة البشرية,15,20,1,0,36
2022,1,مكتب منطقة الباحة,الصرف الصحي,1,0,0,0,1
2022,1,مكتب منطقة الباحة,الصناعة التحويلية الأخرى,8,0,0,0,8
2022,1,مكتب منطقة الباحة,الطباعة واستنساخ وسائط الأعلام المسجّلة,11,5,0,0,16
2022,1,مكتب منطقة الباحة,النقل البري و النقل عبر الأنابيب,144,17,0,0,161
2022,1,مكتب منطقة الباحة,النقل الجوي,0,2,0,0,2
2022,1,مكتب منطقة الباحة,الهندسة المدنية,7,3,0,0,10
2022,1,مكتب منطقة الباحة,تجارة التجزئة، باستثناء المركبات ذات المحركات والدراجات النارية,1014,230,13,0,1257
2022,1,مكتب منطقة الباحة,تجارة الجملة ، باستثناء المركبات ذات المحركات والدراجات النارية,373,191,6,0,570
2022,1,مكتب منطقة الباحة,تجارة الجملة والتجزئة ، وإصلاح المركبات ذات المحركات والدراجات النارية,383,48,1,0,432
2022,1,مكتب منطقة الباحة,تجميع المياه ومعالجتها وتوصيلها,17,2,0,0,19
2022,1,مكتب منطقة الباحة,تشييد المباني,703,162,12,1,878
2022,1,مكتب منطقة الباحة,تعدين ركازات الفلزات,11,2,0,0,13
2022,1,مكتب منطقة الباحة,توصيل الكهرباء والغاز والبخار وتكييف الهواء,1,1,0,0,2
2022,1,مكتب منطقة الباحة,صناعة الآلات والمعدات غير المصنفة في موضع أخر,5,0,0,0,5
2022,1,مكتب منطقة الباحة,صناعة المركبات ذات المحركات والمركبات المقطورة ونصف المقطورة,4,0,0,0,4
2022,1,مكتب منطقة الباحة,صناعة معدات النقل الأخرى,3,0,0,0,3
2022,1,مكتب منطقة الباحة,صنع الأثاث,47,8,0,0,55
2022,1,مكتب منطقة الباحة,صنع الحواسيب والمنتجات الإلكترونية والبصرية,15,4,0,0,19
2022,1,مكتب منطقة الباحة,صُنع الخشب ومنتجات الخشب والفلين ، باستثناء الأثاث ، صُنع أصناف من القش ومواد الضفر,50,13,0,0,63
2022,1,مكتب منطقة الباحة,صنع الفلزات القاعدية,22,3,0,0,25
2022,1,مكتب منطقة الباحة,صُنع المشروبات,4,2,0,0,6
2022,1,مكتب منطقة الباحة,صنع المعدات الكهربائية,15,2,0,0,17
2022,1,مكتب منطقة الباحة,صُنع الملبوسات,107,15,0,0,122
2022,1,مكتب منطقة الباحة,صُنع المنتجات الجلدية والمنتجات ذات الصلة,1,0,0,0,1
2022,1,مكتب منطقة الباحة,صنع المنتجات الصيدلانية الأساسية والمستحضرات الصيدلانية,2,0,0,0,2
2022,1,مكتب منطقة الباحة,صُنع المنتجات الغذائية,102,11,0,0,113
2022,1,مكتب منطقة الباحة,صُنع المنسوجات,12,2,0,0,14
2022,1,مكتب منطقة الباحة,صُنع المواد الكيميائية والمنتجات الكيميائية,9,1,0,0,10
2022,1,مكتب منطقة الباحة,صُنع الورق ومنتجات الورق,2,0,0,0,2
2022,1,مكتب منطقة الباحة,صنع منتجات المطاط واللدائن,5,1,0,0,6
2022,1,مكتب منطقة الباحة,صنع منتجات المعادن اللافلزية الأخرى,43,19,4,0,66
2022,1,مكتب منطقة الباحة,صنع منتجات المعادن المشكلة ( باستثناء الآلات والمعدات ),122,19,0,0,141
2022,1,مكتب منطقة الباحة,صيد الأسماك وتربية المائيات,4,0,0,0,4
2022,1,مكتب منطقة الباحة,وكالات السفر ومشغّلو الجولات السياحية وخدمات الحجز والأنشطة المتصلة بها,2,0,0,0,2
2022,1,مكتب منطقة الجوف,أبحاث الإعلان والسوق,32,4,0,0,36
2022,1,مكتب منطقة الجوف,إصلاح أجهزة الحاسوب والسلع الشخصية والمنزلية,80,9,1,0,90
2022,1,مكتب منطقة الجوف,إصلاح وتركيب الآلات والمعدات,23,3,0,0,26
2022,1,مكتب منطقة الجوف,أنشطة أنتاج الأفلام والبرامج التلفزيونية والتسجيلات الصوتية و نشرالموسيقى,3,0,0,0,3
2022,1,مكتب منطقة الجوف,أنشطة الأمن والتحقيقات,1,2,0,0,3
2022,1,مكتب منطقة الجوف,أنشطة الاستخدام,13,3,0,0,16
2022,1,مكتب منطقة الجوف,أنشطة البرمجة الحاسوبية والخبرة الاستشارية وما يتصل بها من أنشطة,10,3,0,0,13
2022,1,مكتب منطقة الجوف,أنشطة البرمجة والإذاعة,1,0,0,0,1
2022,1,مكتب منطقة الجوف,أنشطة البريد ونقل الرسائل والطرود بواسطة مندوبين,1,0,0,0,1
2022,1,مكتب منطقة الجوف,أنشطة التشييد المتخصصة,696,175,10,0,881
2022,1,مكتب منطقة الجوف,أنشطة الخدمات الشخصية الأخرى,489,55,1,0,545
2022,1,مكتب منطقة الجوف,أنشطة الخدمات المالية ، فيما عدا تمويل التأمين وصناديق المعاشات,13,0,0,0,13
2022,1,مكتب منطقة الجوف,أنشطة العمل الاجتماعي، دون إقامة، لكبار السن وذوي الإعاقة,17,16,0,0,33
2022,1,مكتب منطقة الجوف,أنشطة المعمارية والهندسية ، والاختبارات الفنية والتحليل,99,40,2,0,141
2022,1,مكتب منطقة الجوف,أنشطة المكاتب الرئيسية ، وألأنشطة الاستشارية في مجال الإدارة,10,1,0,0,11
2022,1,مكتب منطقة الجوف,أنشطة المكتبات ودور المحفوظات، والمتاحف والأنشطة الثقافية الأخرى,10,6,0,0,16
2022,1,مكتب منطقة الجوف,أنشطة المنظمات ذات العضوية,12,5,0,0,17
2022,1,مكتب منطقة الجوف,أنشطة النشر,4,1,0,0,5
2022,1,مكتب منطقة الجوف,أنشطة تقديم الخدمات للمباني وتجميل المواقع,303,85,8,1,397
2022,1,مكتب منطقة الجوف,أنشطة جمع النفايات ومعالجتها وتصريفها ، واسترجاع المواد,2,1,0,0,3
2022,1,مكتب منطقة الجوف,أنشطة خدمات الأطعمة والمشروبات,958,199,6,0,1163
2022,1,مكتب منطقة الجوف,أنشطة خدمات المعلومات,5,2,0,0,7
2022,1,مكتب منطقة الجوف,أنشطة خدمات دعم التعدين,5,1,0,0,6
2022,1,مكتب منطقة الجوف,أنشطة زراعة المحاصيل والإنتاج الحيواني والصيد والخدمات المتصلة,598,27,0,2,627
2022,1,مكتب منطقة الجوف,الإدارة العامة والدفاع ؛ والضمان الاجتماعي الإلزامي,14,6,0,0,20
2022,1,مكتب منطقة الجوف,الإقامة,60,10,1,0,71
2022,1,مكتب منطقة الجوف,الأنشطة الإبداعية والفنون وأنشطة الترفيه,2,0,0,0,2
2022,1,مكتب منطقة الجوف,الأنشطة الأخرى للتعدين واستغلال المحاجر,6,0,0,0,6
2022,1,مكتب منطقة الجوف,الأنشطة الإدارية للمكاتب ، وأنشطة الدعم للمكاتب وغير ذلك من أنشطة الدعم للأعمال,31,1,0,0,32
2022,1,مكتب منطقة الجوف,الأنشطة الإيجارية,558,23,0,0,581
2022,1,مكتب منطقة الجوف,الأنشطة البيطرية,4,3,0,0,7
2022,1,مكتب منطقة الجوف,الأنشطة الرياضية وأنشطة التسلية والترفيه,39,6,0,0,45
2022,1,مكتب منطقة الجوف,الأنشطة العقارية,28,2,1,0,31
2022,1,مكتب منطقة الجوف,الأنشطة القانونية وأنشطة المحاسبة,10,1,0,0,11
2022,1,مكتب منطقة الجوف,الأنشطة المهنية والعلمية والتقنية الأخرى,14,1,0,0,15
2022,1,مكتب منطقة الجوف,الاتصالات,22,1,0,0,23
2022,1,مكتب منطقة الجوف,التخزين وأنشطة الدعم للنقل,115,16,3,0,134
2022,1,مكتب منطقة الجوف,التعليم,19,26,12,0,57
2022,1,مكتب منطقة الجوف,الحراجة وقطع الأخشاب,1,0,0,0,1
2022,1,مكتب منطقة الجوف,الرعاية مع الإقامة,6,2,0,0,8
2022,1,مكتب منطقة الجوف,الصحة البشرية,16,31,7,0,54
2022,1,مكتب منطقة الجوف,الصرف الصحي,4,0,0,0,4
2022,1,مكتب منطقة الجوف,الصناعة التحويلية الأخرى,6,0,0,0,6
2022,1,مكتب منطقة الجوف,الطباعة واستنساخ وسائط الأعلام المسجّلة,15,5,0,0,20
2022,1,مكتب منطقة الجوف,النقل البري و النقل عبر الأنابيب,457,66,1,0,524
2022,1,مكتب منطقة الجوف,النقل الجوي,13,1,0,0,14
2022,1,مكتب منطقة الجوف,الهندسة المدنية,10,4,0,0,14
2022,1,مكتب منطقة الجوف,تجارة التجزئة، باستثناء المركبات ذات المحركات والدراجات النارية,1267,235,10,1,1513
2022,1,مكتب منطقة الجوف,تجارة الجملة ، باستثناء المركبات ذات المحركات والدراجات النارية,378,87,3,1,469
2022,1,مكتب منطقة الجوف,تجارة الجملة والتجزئة ، وإصلاح المركبات ذات المحركات والدراجات النارية,553,108,0,0,661
2022,1,مكتب منطقة الجوف,تجميع المياه ومعالجتها وتوصيلها,9,1,0,0,10
2022,1,مكتب منطقة الجوف,تشييد المباني,938,187,15,1,1141
2022,1,مكتب منطقة الجوف,تعدين الفحم والليغنيت,2,0,0,0,2
2022,1,مكتب منطقة الجوف,تعدين ركازات الفلزات,6,1,0,0,7
2022,1,مكتب منطقة الجوف,توصيل الكهرباء والغاز والبخار وتكييف الهواء,7,1,0,0,8
2022,1,مكتب منطقة الجوف,صناعة الآلات والمعدات غير المصنفة في موضع أخر,15,0,0,0,15
2022,1,مكتب منطقة الجوف,صناعة المركبات ذات المحركات والمركبات المقطورة ونصف المقطورة,14,3,0,0,17
2022,1,مكتب منطقة الجوف,صناعة معدات النقل الأخرى,2,3,0,0,5
2022,1,مكتب منطقة الجوف,صنع الأثاث,92,8,0,0,100
2022,1,مكتب منطقة الجوف,صنع الحواسيب والمنتجات الإلكترونية والبصرية,11,2,0,0,13
2022,1,مكتب منطقة الجوف,صُنع الخشب ومنتجات الخشب والفلين ، باستثناء الأثاث ، صُنع أصناف من القش ومواد الضفر,48,5,0,0,53
2022,1,مكتب منطقة الجوف,صنع الفلزات القاعدية,37,9,0,0,46
2022,1,مكتب منطقة الجوف,صُنع المشروبات,6,4,1,1,12
2022,1,مكتب منطقة الجوف,صنع المعدات الكهربائية,27,3,0,0,30
2022,1,مكتب منطقة الجوف,صُنع الملبوسات,215,19,0,0,234
2022,1,مكتب منطقة الجوف,صُنع المنتجات الجلدية والمنتجات ذات الصلة,2,0,0,0,2
2022,1,مكتب منطقة الجوف,صنع المنتجات الصيدلانية الأساسية والمستحضرات الصيدلانية,2,1,0,0,3
2022,1,مكتب منطقة الجوف,صُنع المنتجات الغذائية,149,48,1,0,198
2022,1,مكتب منطقة الجوف,صُنع المنسوجات,29,9,0,0,38
2022,1,مكتب منطقة الجوف,صُنع المواد الكيميائية والمنتجات الكيميائية,23,3,0,0,26
2022,1,مكتب منطقة الجوف,صُنع الورق ومنتجات الورق,5,1,0,0,6
2022,1,مكتب منطقة الجوف,صنع منتجات المطاط واللدائن,6,4,0,0,10
2022,1,مكتب منطقة الجوف,صنع منتجات المعادن اللافلزية الأخرى,51,23,3,0,77
2022,1,مكتب منطقة الجوف,صنع منتجات المعادن المشكلة ( باستثناء الآلات والمعدات ),123,19,1,0,143
2022,1,مكتب منطقة الجوف,صيد الأسماك وتربية المائيات,8,2,0,0,10
2022,1,مكتب منطقة الجوف,وكالات السفر ومشغّلو الجولات السياحية وخدمات الحجز والأنشطة المتصلة بها,6,3,0,0,9
2022,1,مكتب منطقة الحدود الشمالية,أبحاث الإعلان والسوق,7,1,0,0,8
2022,1,مكتب منطقة الحدود الشمالية,إصلاح أجهزة الحاسوب والسلع الشخصية والمنزلية,47,1,0,0,48
2022,1,مكتب منطقة الحدود الشمالية,إصلاح وتركيب الآلات والمعدات,19,1,0,0,20
2022,1,مكتب منطقة الحدود الشمالية,أنشطة الأمن والتحقيقات,0,2,1,1,4
2022,1,مكتب منطقة الحدود الشمالية,أنشطة الاستخدام,9,1,0,0,10
2022,1,مكتب منطقة الحدود الشمالية,أنشطة الاسر المعيشية التي تستخدم أفراداً للعمل المنزلي,1,0,0,0,1
2022,1,مكتب منطقة الحدود الشمالية,أنشطة البرمجة الحاسوبية والخبرة الاستشارية وما يتصل بها من أنشطة,4,0,0,0,4
2022,1,مكتب منطقة الحدود الشمالية,أنشطة البريد ونقل الرسائل والطرود بواسطة مندوبين,0,1,0,0,1
2022,1,مكتب منطقة الحدود الشمالية,أنشطة التشييد المتخصصة,334,46,2,0,382
2022,1,مكتب منطقة الحدود الشمالية,أنشطة الخدمات الشخصية الأخرى,416,29,0,0,445
2022,1,مكتب منطقة الحدود الشمالية,أنشطة الخدمات المالية ، فيما عدا تمويل التأمين وصناديق المعاشات,9,3,0,0,12
2022,1,مكتب منطقة الحدود الشمالية,أنشطة العمل الاجتماعي، دون إقامة، لكبار السن وذوي الإعاقة,13,10,0,0,23
2022,1,مكتب منطقة الحدود الشمالية,أنشطة المعمارية والهندسية ، والاختبارات الفنية والتحليل,112,30,1,0,143
2022,1,مكتب منطقة الحدود الشمالية,أنشطة المكاتب الرئيسية ، وألأنشطة الاستشارية في مجال الإدارة,7,3,0,0,10
2022,1,مكتب منطقة الحدود الشمالية,أنشطة المكتبات ودور المحفوظات، والمتاحف والأنشطة الثقافية الأخرى,11,3,0,0,14
2022,1,مكتب منطقة الحدود الشمالية,أنشطة المنظمات ذات العضوية,10,1,0,0,11
2022,1,مكتب منطقة الحدود الشمالية,أنشطة تقديم الخدمات للمباني وتجميل المواقع,110,16,1,0,127
2022,1,مكتب منطقة الحدود الشمالية,أنشطة خدمات الأطعمة والمشروبات,860,139,3,0,1002
2022,1,مكتب منطقة الحدود الشمالية,أنشطة خدمات المعلومات,1,2,0,0,3
2022,1,مكتب منطقة الحدود الشمالية,أنشطة خدمات دعم التعدين,1,1,0,0,2
2022,1,مكتب منطقة الحدود الشمالية,أنشطة زراعة المحاصيل والإنتاج الحيواني والصيد والخدمات المتصلة,193,4,0,0,197
2022,1,مكتب منطقة الحدود الشمالية,الإدارة العامة والدفاع ؛ والضمان الاجتماعي الإلزامي,5,1,0,0,6
2022,1,مكتب منطقة الحدود الشمالية,الإقامة,26,12,1,0,39
2022,1,مكتب منطقة الحدود الشمالية,الأنشطة الإبداعية والفنون وأنشطة الترفيه,3,0,0,0,3
2022,1,مكتب منطقة الحدود الشمالية,الأنشطة الأخرى للتعدين واستغلال المحاجر,4,2,0,1,7
2022,1,مكتب منطقة الحدود الشمالية,الأنشطة الإدارية للمكاتب ، وأنشطة الدعم للمكاتب وغير ذلك من أنشطة الدعم للأعمال,34,0,0,0,34
2022,1,مكتب منطقة الحدود الشمالية,الأنشطة الإيجارية,211,7,0,0,218
2022,1,مكتب منطقة الحدود الشمالية,الأنشطة البيطرية,5,2,0,0,7
2022,1,مكتب منطقة الحدود الشمالية,الأنشطة الرياضية وأنشطة التسلية والترفيه,31,7,0,0,38
2022,1,مكتب منطقة الحدود الشمالية,الأنشطة العقارية,26,3,0,0,29
2022,1,مكتب منطقة الحدود الشمالية,الأنشطة القانونية وأنشطة المحاسبة,6,0,0,0,6
2022,1,مكتب منطقة الحدود الشمالية,الأنشطة المهنية والعلمية والتقنية الأخرى,5,0,0,0,5
2022,1,مكتب منطقة الحدود الشمالية,الاتصالات,5,1,0,0,6
2022,1,مكتب منطقة الحدود الشمالية,التخزين وأنشطة الدعم للنقل,27,5,1,0,33
2022,1,مكتب منطقة الحدود الشمالية,التعليم,13,20,4,0,37
2022,1,مكتب منطقة الحدود الشمالية,الرعاية مع الإقامة,3,1,0,0,4
2022,1,مكتب منطقة الحدود الشمالية,الصحة البشرية,18,23,2,0,43
2022,1,مكتب منطقة الحدود الشمالية,الصناعة التحويلية الأخرى,7,1,0,0,8
2022,1,مكتب منطقة الحدود الشمالية,الطباعة واستنساخ وسائط الأعلام المسجّلة,9,3,0,0,12
2022,1,مكتب منطقة الحدود الشمالية,النقل البري و النقل عبر الأنابيب,314,41,1,0,356
2022,1,مكتب منطقة الحدود الشمالية,النقل الجوي,1,2,0,1,4
2022,1,مكتب منطقة الحدود الشمالية,النقل المائي,3,0,0,0,3
2022,1,مكتب منطقة الحدود الشمالية,الهندسة المدنية,7,0,0,0,7
2022,1,مكتب منطقة الحدود الشمالية,تجارة التجزئة، باستثناء المركبات ذات المحركات والدراجات النارية,904,117,8,0,1029
2022,1,مكتب منطقة الحدود الشمالية,تجارة الجملة ، باستثناء المركبات ذات المحركات والدراجات النارية,218,33,1,0,252
2022,1,مكتب منطقة الحدود الشمالية,تجارة الجملة والتجزئة ، وإصلاح المركبات ذات المحركات والدراجات النارية,446,66,1,0,513
2022,1,مكتب منطقة الحدود الشمالية,تجميع المياه ومعالجتها وتوصيلها,11,3,0,0,14
2022,1,مكتب منطقة الحدود الشمالية,تشييد المباني,1243,226,21,4,1494
2022,1,مكتب منطقة الحدود الشمالية,تعدين ركازات الفلزات,7,0,0,0,7
2022,1,مكتب منطقة الحدود الشمالية,توصيل الكهرباء والغاز والبخار وتكييف الهواء,2,2,0,0,4
2022,1,مكتب منطقة الحدود الشمالية,صناعة الآلات والمعدات غير المصنفة في موضع أخر,7,0,0,0,7
2022,1,مكتب منطقة الحدود الشمالية,صناعة المركبات ذات المحركات والمركبات المقطورة ونصف المقطورة,10,1,0,0,11
2022,1,مكتب منطقة الحدود الشمالية,صناعة معدات النقل الأخرى,2,1,0,0,3
2022,1,مكتب منطقة الحدود الشمالية,صنع الأثاث,51,8,0,0,59
2022,1,مكتب منطقة الحدود الشمالية,صنع الحواسيب والمنتجات الإلكترونية والبصرية,15,3,0,0,18
2022,1,مكتب منطقة الحدود الشمالية,صُنع الخشب ومنتجات الخشب والفلين ، باستثناء الأثاث ، صُنع أصناف من القش ومواد الضفر,43,6,0,0,49
2022,1,مكتب منطقة الحدود الشمالية,صنع الفلزات القاعدية,22,5,0,0,27
2022,1,مكتب منطقة الحدود الشمالية,صُنع المشروبات,2,3,0,0,5
2022,1,مكتب منطقة الحدود الشمالية,صنع المعدات الكهربائية,41,6,0,0,47
2022,1,مكتب منطقة الحدود الشمالية,صُنع الملبوسات,216,11,0,0,227
2022,1,مكتب منطقة الحدود الشمالية,صُنع المنتجات الجلدية والمنتجات ذات الصلة,5,2,0,0,7
2022,1,مكتب منطقة الحدود الشمالية,صنع المنتجات الصيدلانية الأساسية والمستحضرات الصيدلانية,0,1,0,0,1
2022,1,مكتب منطقة الحدود الشمالية,صُنع المنتجات الغذائية,115,31,0,0,146
2022,1,مكتب منطقة الحدود الشمالية,صُنع المنسوجات,21,1,0,0,22
2022,1,مكتب منطقة الحدود الشمالية,صُنع المواد الكيميائية والمنتجات الكيميائية,13,0,0,0,13
2022,1,مكتب منطقة الحدود الشمالية,صُنع الورق ومنتجات الورق,2,1,0,0,3
2022,1,مكتب منطقة الحدود الشمالية,صنع فحم الكوك والمنتجات النفطية المكررة,1,0,0,0,1
2022,1,مكتب منطقة الحدود الشمالية,صنع منتجات المطاط واللدائن,1,3,0,0,4
2022,1,مكتب منطقة الحدود الشمالية,صنع منتجات المعادن اللافلزية الأخرى,42,14,0,1,57
2022,1,مكتب منطقة الحدود الشمالية,صنع منتجات المعادن المشكلة ( باستثناء الآلات والمعدات ),58,3,0,0,61
2022,1,مكتب منطقة الحدود الشمالية,صيد الأسماك وتربية المائيات,4,0,0,0,4
2022,1,مكتب منطقة الحدود الشمالية,وكالات السفر ومشغّلو الجولات السياحية وخدمات الحجز والأنشطة المتصلة بها,1,2,0,0,3
2022,1,مكتب منطقة الرياض,أبحاث الإعلان والسوق,512,130,0,0,642
2022,1,مكتب منطقة الرياض,إصلاح أجهزة الحاسوب والسلع الشخصية والمنزلية,884,190,27,7,1108
2022,1,مكتب منطقة الرياض,إصلاح وتركيب الآلات والمعدات,541,99,9,5,654
2022,1,مكتب منطقة الرياض,أنشطة أنتاج الأفلام والبرامج التلفزيونية والتسجيلات الصوتية و نشرالموسيقى,200,84,4,3,291
2022,1,مكتب منطقة الرياض,أنشطة الأمن والتحقيقات,101,41,21,10,173
2022,1,مكتب منطقة الرياض,أنشطة الاستخدام,418,101,17,25,561
2022,1,مكتب منطقة الرياض,أنشطة الاسر المعيشية التي تستخدم أفراداً للعمل المنزلي,15,1,0,0,16
2022,1,مكتب منطقة الرياض,أنشطة البرمجة الحاسوبية والخبرة الاستشارية وما يتصل بها من أنشطة,836,403,50,9,1298
2022,1,مكتب منطقة الرياض,أنشطة البرمجة والإذاعة,10,3,0,0,13
2022,1,مكتب منطقة الرياض,أنشطة البريد ونقل الرسائل والطرود بواسطة مندوبين,136,35,5,0,176
2022,1,مكتب منطقة الرياض,أنشطة التشييد المتخصصة,9973,3183,326,50,13532
2022,1,مكتب منطقة الرياض,أنشطة الخدمات الشخصية الأخرى,6029,1496,130,42,7697
2022,1,مكتب منطقة الرياض,أنشطة الخدمات المالية ، فيما عدا تمويل التأمين وصناديق المعاشات,262,115,21,13,411
2022,1,مكتب منطقة الرياض,أنشطة العمل الاجتماعي، دون إقامة، لكبار السن وذوي الإعاقة,173,168,26,2,369
2022,1,مكتب منطقة الرياض,أنشطة المعالجة وخدمات إدارة النفايات الأخرى,7,1,1,0,9
2022,1,مكتب منطقة الرياض,أنشطة المعمارية والهندسية ، والاختبارات الفنية والتحليل,692,418,92,23,1225
2022,1,مكتب منطقة الرياض,أنشطة المكاتب الرئيسية ، وألأنشطة الاستشارية في مجال الإدارة,895,322,35,6,1258
2022,1,مكتب منطقة الرياض,أنشطة المكتبات ودور المحفوظات، والمتاحف والأنشطة الثقافية الأخرى,100,42,2,0,144
2022,1,مكتب منطقة الرياض,أنشطة المنظمات الدولية,6,4,1,0,11
2022,1,مكتب منطقة الرياض,أنشطة المنظمات ذات العضوية,189,49,4,0,242
2022,1,مكتب منطقة الرياض,أنشطة النشر,188,72,5,1,266
2022,1,مكتب منطقة الرياض,أنشطة تقديم الخدمات للمباني وتجميل المواقع,5632,3105,583,117,9437
2022,1,مكتب منطقة الرياض,أنشطة جمع النفايات ومعالجتها وتصريفها ، واسترجاع المواد,33,8,4,5,50
2022,1,مكتب منطقة الرياض,أنشطة خدمات الأطعمة والمشروبات,9920,3484,420,78,13902
2022,1,مكتب منطقة الرياض,أنشطة خدمات المعلومات,230,87,10,2,329
2022,1,مكتب منطقة الرياض,أنشطة خدمات دعم التعدين,77,35,6,3,121
2022,1,مكتب منطقة الرياض,أنشطة زراعة المحاصيل والإنتاج الحيواني والصيد والخدمات المتصلة,2860,291,87,17,3255
2022,1,مكتب منطقة الرياض,استخراج النفط الخام والغاز الطبيعي,5,0,0,0,5
2022,1,مكتب منطقة الرياض,الإدارة العامة والدفاع ؛ والضمان الاجتماعي الإلزامي,335,213,45,16,609
2022,1,مكتب منطقة الرياض,الإقامة,608,330,79,9,1026
2022,1,مكتب منطقة الرياض,الأنشطة الإبداعية والفنون وأنشطة الترفيه,104,22,3,1,130
2022,1,مكتب منطقة الرياض,الأنشطة الأخرى للتعدين واستغلال المحاجر,126,58,14,4,202
2022,1,مكتب منطقة الرياض,الأنشطة الإدارية للمكاتب ، وأنشطة الدعم للمكاتب وغير ذلك من أنشطة الدعم للأعمال,781,130,15,3,929
2022,1,مكتب منطقة الرياض,الأنشطة الإيجارية,51839,1106,37,3,52985
2022,1,مكتب منطقة الرياض,الأنشطة البيطرية,49,47,5,0,101
2022,1,مكتب منطقة الرياض,الأنشطة الرياضية وأنشطة التسلية والترفيه,499,173,19,5,696
2022,1,مكتب منطقة الرياض,الأنشطة العقارية,1150,454,62,9,1675
2022,1,مكتب منطقة الرياض,الأنشطة القانونية وأنشطة المحاسبة,537,207,14,2,760
2022,1,مكتب منطقة الرياض,الأنشطة المساعدة لأنشطة الخدمات المالية وأنشطة التأمين,78,77,14,2,171
2022,1,مكتب منطقة الرياض,الأنشطة المهنية والعلمية والتقنية الأخرى,373,62,2,0,437
2022,1,مكتب منطقة الرياض,الأنشطة غير المتميزة لإنتاج السلع والخدمات التي تقوم بها الأسر المعيشية الخاصة لإستعمالها الخاص,2,0,0,0,2
2022,1,مكتب منطقة الرياض,الاتصالات,373,165,24,13,575
2022,1,مكتب منطقة الرياض,البحث والتطوير في المجال العلمي,27,11,1,1,40
2022,1,مكتب منطقة الرياض,التخزين وأنشطة الدعم للنقل,899,246,53,21,1219
2022,1,مكتب منطقة الرياض,التعليم,702,425,165,49,1341
2022,1,مكتب منطقة الرياض,الحراجة وقطع الأخشاب,5,5,2,0,12
2022,1,مكتب منطقة الرياض,الرعاية مع الإقامة,33,18,1,0,52
2022,1,مكتب منطقة الرياض,الصحة البشرية,491,611,193,61,1356
2022,1,مكتب منطقة الرياض,الصرف الصحي,33,16,3,2,54
2022,1,مكتب منطقة الرياض,الصناعة التحويلية الأخرى,186,92,18,4,300
2022,1,مكتب منطقة الرياض,الطباعة واستنساخ وسائط الأعلام المسجّلة,346,205,25,5,581
2022,1,مكتب منطقة الرياض,النقل البري و النقل عبر الأنابيب,9241,711,79,20,10051
2022,1,مكتب منطقة الرياض,النقل الجوي,294,73,34,15,416
2022,1,مكتب منطقة الرياض,النقل المائي,90,17,2,0,109
2022,1,مكتب منطقة الرياض,الهندسة المدنية,290,99,29,12,430
2022,1,مكتب منطقة الرياض,تجارة التجزئة، باستثناء المركبات ذات المحركات والدراجات النارية,19368,5940,768,145,26221
2022,1,مكتب منطقة الرياض,تجارة الجملة ، باستثناء المركبات ذات المحركات والدراجات النارية,11412,5371,743,183,17709
2022,1,مكتب منطقة الرياض,تجارة الجملة والتجزئة ، وإصلاح المركبات ذات المحركات والدراجات النارية,6777,1631,73,8,8489
2022,1,مكتب منطقة الرياض,تجميع المياه ومعالجتها وتوصيلها,110,31,8,0,149
2022,1,مكتب منطقة الرياض,تشييد المباني,10996,4763,1032,346,17137
2022,1,مكتب منطقة الرياض,تعدين الفحم والليغنيت,8,2,1,0,11
2022,1,مكتب منطقة الرياض,تعدين ركازات الفلزات,53,40,0,1,94
2022,1,مكتب منطقة الرياض,تمويل التأمين وإعادة التأمين وصناديق المعاشات التقاعدية باستثناء الضمان الاجتماعي الإلزامي,52,53,15,8,128
2022,1,مكتب منطقة الرياض,توصيل الكهرباء والغاز والبخار وتكييف الهواء,96,69,23,15,203
2022,1,مكتب منطقة الرياض,صناعة الآلات والمعدات غير المصنفة في موضع أخر,168,53,10,2,233
2022,1,مكتب منطقة الرياض,صناعة المركبات ذات المحركات والمركبات المقطورة ونصف المقطورة,97,56,3,1,157
2022,1,مكتب منطقة الرياض,صناعة معدات النقل الأخرى,110,45,8,2,165
2022,1,مكتب منطقة الرياض,صنع الأثاث,893,391,41,2,1327
2022,1,مكتب منطقة الرياض,صنع الحواسيب والمنتجات الإلكترونية والبصرية,253,128,29,7,417
2022,1,مكتب منطقة الرياض,صُنع الخشب ومنتجات الخشب والفلين ، باستثناء الأثاث ، صُنع أصناف من القش ومواد الضفر,743,237,35,9,1024
2022,1,مكتب منطقة الرياض,صنع الفلزات القاعدية,501,274,71,18,864
2022,1,مكتب منطقة الرياض,صُنع المشروبات,72,35,16,6,129
2022,1,مكتب منطقة الرياض,صنع المعدات الكهربائية,236,114,27,5,382
2022,1,مكتب منطقة الرياض,صُنع الملبوسات,2156,431,26,1,2614
2022,1,مكتب منطقة الرياض,صُنع المنتجات الجلدية والمنتجات ذات الصلة,72,15,1,0,88
2022,1,مكتب منطقة الرياض,صنع المنتجات الصيدلانية الأساسية والمستحضرات الصيدلانية,53,24,6,1,84
2022,1,مكتب منطقة الرياض,صُنع المنتجات الغذائية,1318,533,79,26,1956
2022,1,مكتب منطقة الرياض,صُنع المنسوجات,193,82,12,9,296
2022,1,مكتب منطقة الرياض,صُنع المواد الكيميائية والمنتجات الكيميائية,410,213,35,2,660
2022,1,مكتب منطقة الرياض,صُنع الورق ومنتجات الورق,80,56,8,0,144
2022,1,مكتب منطقة الرياض,صنع فحم الكوك والمنتجات النفطية المكررة,30,12,1,0,43
2022,1,مكتب منطقة الرياض,صُنع منتجات التبغ,1,0,0,0,1
2022,1,مكتب منطقة الرياض,صنع منتجات المطاط واللدائن,290,192,85,12,579
2022,1,مكتب منطقة الرياض,صنع منتجات المعادن اللافلزية الأخرى,1080,547,97,20,1744
2022,1,مكتب منطقة الرياض,صنع منتجات المعادن المشكلة ( باستثناء الآلات والمعدات ),995,467,102,22,1586
2022,1,مكتب منطقة الرياض,صيد الأسماك وتربية المائيات,1033,7,1,1,1042
2022,1,مكتب منطقة الرياض,وكالات السفر ومشغّلو الجولات السياحية وخدمات الحجز والأنشطة المتصلة بها,233,102,14,5,354
2022,1,مكتب منطقة القصيم,أبحاث الإعلان والسوق,36,9,0,0,45
2022,1,مكتب منطقة القصيم,إصلاح أجهزة الحاسوب والسلع الشخصية والمنزلية,287,38,3,0,328
2022,1,مكتب منطقة القصيم,إصلاح وتركيب الآلات والمعدات,97,10,0,0,107
2022,1,مكتب منطقة القصيم,أنشطة أنتاج الأفلام والبرامج التلفزيونية والتسجيلات الصوتية و نشرالموسيقى,11,2,0,0,13
2022,1,مكتب منطقة القصيم,أنشطة الأمن والتحقيقات,7,5,0,0,12
2022,1,مكتب منطقة القصيم,أنشطة الاستخدام,24,11,1,0,36
2022,1,مكتب منطقة القصيم,أنشطة الاسر المعيشية التي تستخدم أفراداً للعمل المنزلي,5,2,0,0,7
2022,1,مكتب منطقة القصيم,أنشطة البرمجة الحاسوبية والخبرة الاستشارية وما يتصل بها من أنشطة,42,7,0,0,49
2022,1,مكتب منطقة القصيم,أنشطة البرمجة والإذاعة,1,0,0,0,1
2022,1,مكتب منطقة القصيم,أنشطة البريد ونقل الرسائل والطرود بواسطة مندوبين,5,0,0,0,5
2022,1,مكتب منطقة القصيم,أنشطة التشييد المتخصصة,3467,585,85,2,4139
2022,1,مكتب منطقة القصيم,أنشطة الخدمات الشخصية الأخرى,1319,131,8,1,1459
2022,1,مكتب منطقة القصيم,أنشطة الخدمات المالية ، فيما عدا تمويل التأمين وصناديق المعاشات,29,2,1,0,32
2022,1,مكتب منطقة القصيم,أنشطة العمل الاجتماعي، دون إقامة، لكبار السن وذوي الإعاقة,58,51,3,0,112
2022,1,مكتب منطقة القصيم,أنشطة المعمارية والهندسية ، والاختبارات الفنية والتحليل,220,72,9,0,301
2022,1,مكتب منطقة القصيم,أنشطة المكاتب الرئيسية ، وألأنشطة الاستشارية في مجال الإدارة,58,18,2,0,78
2022,1,مكتب منطقة القصيم,أنشطة المكتبات ودور المحفوظات، والمتاحف والأنشطة الثقافية الأخرى,21,14,0,0,35
2022,1,مكتب منطقة القصيم,أنشطة المنظمات الدولية,2,0,0,0,2
2022,1,مكتب منطقة القصيم,أنشطة المنظمات ذات العضوية,33,13,1,0,47
2022,1,مكتب منطقة القصيم,أنشطة النشر,17,7,0,0,24
2022,1,مكتب منطقة القصيم,أنشطة تقديم الخدمات للمباني وتجميل المواقع,1308,285,50,12,1655
2022,1,مكتب منطقة القصيم,أنشطة جمع النفايات ومعالجتها وتصريفها ، واسترجاع المواد,4,5,0,0,9
2022,1,مكتب منطقة القصيم,أنشطة خدمات الأطعمة والمشروبات,3218,894,54,3,4169
2022,1,مكتب منطقة القصيم,أنشطة خدمات المعلومات,15,3,0,0,18
2022,1,مكتب منطقة القصيم,أنشطة خدمات دعم التعدين,8,2,0,0,10
2022,1,مكتب منطقة القصيم,أنشطة زراعة المحاصيل والإنتاج الحيواني والصيد والخدمات المتصلة,1283,87,12,5,1387
2022,1,مكتب منطقة القصيم,الإدارة العامة والدفاع ؛ والضمان الاجتماعي الإلزامي,31,28,2,0,61
2022,1,مكتب منطقة القصيم,الإقامة,99,51,6,1,157
2022,1,مكتب منطقة القصيم,الأنشطة الإبداعية والفنون وأنشطة الترفيه,11,3,0,0,14
2022,1,مكتب منطقة القصيم,الأنشطة الأخرى للتعدين واستغلال المحاجر,15,0,0,0,15
2022,1,مكتب منطقة القصيم,الأنشطة الإدارية للمكاتب ، وأنشطة الدعم للمكاتب وغير ذلك من أنشطة الدعم للأعمال,81,9,4,0,94
2022,1,مكتب منطقة القصيم,الأنشطة الإيجارية,1090,67,3,0,1160
2022,1,مكتب منطقة القصيم,الأنشطة البيطرية,11,5,1,0,17
2022,1,مكتب منطقة القصيم,الأنشطة الرياضية وأنشطة التسلية والترفيه,83,28,0,0,111
2022,1,مكتب منطقة القصيم,الأنشطة العقارية,103,16,1,0,120
2022,1,مكتب منطقة القصيم,الأنشطة القانونية وأنشطة المحاسبة,39,1,0,0,40
2022,1,مكتب منطقة القصيم,الأنشطة المساعدة لأنشطة الخدمات المالية وأنشطة التأمين,2,0,0,0,2
2022,1,مكتب منطقة القصيم,الأنشطة المهنية والعلمية والتقنية الأخرى,22,6,0,0,28
2022,1,مكتب منطقة القصيم,الاتصالات,80,23,1,0,104
2022,1,مكتب منطقة القصيم,البحث والتطوير في المجال العلمي,2,0,0,0,2
2022,1,مكتب منطقة القصيم,التخزين وأنشطة الدعم للنقل,120,34,5,0,159
2022,1,مكتب منطقة القصيم,التعليم,60,38,18,2,118
2022,1,مكتب منطقة القصيم,الحراجة وقطع الأخشاب,4,0,0,0,4
2022,1,مكتب منطقة القصيم,الرعاية مع الإقامة,12,5,0,0,17
2022,1,مكتب منطقة القصيم,الصحة البشرية,44,82,27,4,157
2022,1,مكتب منطقة القصيم,الصرف الصحي,3,1,0,0,4
2022,1,مكتب منطقة القصيم,الصناعة التحويلية الأخرى,30,7,0,0,37
2022,1,مكتب منطقة القصيم,الطباعة واستنساخ وسائط الأعلام المسجّلة,54,26,1,0,81
2022,1,مكتب منطقة القصيم,النقل البري و النقل عبر الأنابيب,875,157,14,2,1048
2022,1,مكتب منطقة القصيم,النقل الجوي,11,9,1,2,23
2022,1,مكتب منطقة القصيم,النقل المائي,11,1,0,0,12
2022,1,مكتب منطقة القصيم,الهندسة المدنية,46,11,5,1,63
2022,1,مكتب منطقة القصيم,تجارة التجزئة، باستثناء المركبات ذات المحركات والدراجات النارية,3408,678,53,6,4145
2022,1,مكتب منطقة القصيم,تجارة الجملة ، باستثناء المركبات ذات المحركات والدراجات النارية,1671,569,55,4,2299
2022,1,مكتب منطقة القصيم,تجارة الجملة والتجزئة ، وإصلاح المركبات ذات المحركات والدراجات النارية,2241,411,18,2,2672
2022,1,مكتب منطقة القصيم,تجميع المياه ومعالجتها وتوصيلها,35,6,0,0,41
2022,1,مكتب منطقة القصيم,تشييد المباني,7441,1856,247,39,9583
2022,1,مكتب منطقة القصيم,تعدين الفحم والليغنيت,3,0,0,0,3
2022,1,مكتب منطقة القصيم,تعدين ركازات الفلزات,42,11,1,0,54
2022,1,مكتب منطقة القصيم,تمويل التأمين وإعادة التأمين وصناديق المعاشات التقاعدية باستثناء الضمان الاجتماعي الإلزامي,2,2,0,0,4
2022,1,مكتب منطقة القصيم,توصيل الكهرباء والغاز والبخار وتكييف الهواء,10,4,0,0,14
2022,1,مكتب منطقة القصيم,صناعة الآلات والمعدات غير المصنفة في موضع أخر,39,8,2,0,49
2022,1,مكتب منطقة القصيم,صناعة المركبات ذات المحركات والمركبات المقطورة ونصف المقطورة,27,6,1,0,34
2022,1,مكتب منطقة القصيم,صناعة معدات النقل الأخرى,20,4,0,0,24
2022,1,مكتب منطقة القصيم,صنع الأثاث,187,62,8,0,257
2022,1,مكتب منطقة القصيم,صنع الحواسيب والمنتجات الإلكترونية والبصرية,51,11,1,0,63
2022,1,مكتب منطقة القصيم,صُنع الخشب ومنتجات الخشب والفلين ، باستثناء الأثاث ، صُنع أصناف من القش ومواد الضفر,247,50,4,0,301
2022,1,مكتب منطقة القصيم,صنع الفلزات القاعدية,232,42,3,0,277
2022,1,مكتب منطقة القصيم,صُنع المشروبات,13,9,3,1,26
2022,1,مكتب منطقة القصيم,صنع المعدات الكهربائية,84,15,3,0,102
2022,1,مكتب منطقة القصيم,صُنع الملبوسات,549,77,5,1,632
2022,1,مكتب منطقة القصيم,صُنع المنتجات الجلدية والمنتجات ذات الصلة,8,0,0,0,8
2022,1,مكتب منطقة القصيم,صنع المنتجات الصيدلانية الأساسية والمستحضرات الصيدلانية,3,4,1,0,8
2022,1,مكتب منطقة القصيم,صُنع المنتجات الغذائية,405,104,35,6,550
2022,1,مكتب منطقة القصيم,صُنع المنسوجات,84,20,1,0,105
2022,1,مكتب منطقة القصيم,صُنع المواد الكيميائية والمنتجات الكيميائية,57,17,3,0,77
2022,1,مكتب منطقة القصيم,صُنع الورق ومنتجات الورق,6,10,4,0,20
2022,1,مكتب منطقة القصيم,صنع فحم الكوك والمنتجات النفطية المكررة,1,1,0,0,2
2022,1,مكتب منطقة القصيم,صُنع منتجات التبغ,2,0,0,0,2
2022,1,مكتب منطقة القصيم,صنع منتجات المطاط واللدائن,24,21,9,1,55
2022,1,مكتب منطقة القصيم,صنع منتجات المعادن اللافلزية الأخرى,164,66,19,3,252
2022,1,مكتب منطقة القصيم,صنع منتجات المعادن المشكلة ( باستثناء الآلات والمعدات ),659,103,10,3,775
2022,1,مكتب منطقة القصيم,صيد الأسماك وتربية المائيات,21,2,0,0,23
2022,1,مكتب منطقة القصيم,وكالات السفر ومشغّلو الجولات السياحية وخدمات الحجز والأنشطة المتصلة بها,43,14,0,0,57
2022,1,مكتب منطقة المدينة المنورة,أبحاث الإعلان والسوق,48,5,0,0,53
2022,1,مكتب منطقة المدينة المنورة,إصلاح أجهزة الحاسوب والسلع الشخصية والمنزلية,166,9,0,0,175
2022,1,مكتب منطقة المدينة المنورة,إصلاح وتركيب الآلات والمعدات,76,8,0,0,84
2022,1,مكتب منطقة المدينة المنورة,أنشطة أنتاج الأفلام والبرامج التلفزيونية والتسجيلات الصوتية و نشرالموسيقى,13,1,0,0,14
2022,1,مكتب منطقة المدينة المنورة,أنشطة الأمن والتحقيقات,8,2,1,0,11
2022,1,مكتب منطقة المدينة المنورة,أنشطة الاستخدام,40,12,0,0,52
2022,1,مكتب منطقة المدينة المنورة,أنشطة الاسر المعيشية التي تستخدم أفراداً للعمل المنزلي,3,0,0,0,3
2022,1,مكتب منطقة المدينة المنورة,أنشطة البرمجة الحاسوبية والخبرة الاستشارية وما يتصل بها من أنشطة,56,9,0,0,65
2022,1,مكتب منطقة المدينة المنورة,أنشطة البرمجة والإذاعة,4,0,0,0,4
2022,1,مكتب منطقة المدينة المنورة,أنشطة البريد ونقل الرسائل والطرود بواسطة مندوبين,6,1,0,0,7
2022,1,مكتب منطقة المدينة المنورة,أنشطة التشييد المتخصصة,1673,343,11,0,2027
2022,1,مكتب منطقة المدينة المنورة,أنشطة الخدمات الشخصية الأخرى,1481,144,3,0,1628
2022,1,مكتب منطقة المدينة المنورة,أنشطة الخدمات المالية ، فيما عدا تمويل التأمين وصناديق المعاشات,25,2,0,0,27
2022,1,مكتب منطقة المدينة المنورة,أنشطة العمل الاجتماعي، دون إقامة، لكبار السن وذوي الإعاقة,70,37,10,0,117
2022,1,مكتب منطقة المدينة المنورة,أنشطة المعمارية والهندسية ، والاختبارات الفنية والتحليل,87,55,4,1,147
2022,1,مكتب منطقة المدينة المنورة,أنشطة المكاتب الرئيسية ، وألأنشطة الاستشارية في مجال الإدارة,58,10,1,0,69
2022,1,مكتب منطقة المدينة المنورة,أنشطة المكتبات ودور المحفوظات، والمتاحف والأنشطة الثقافية الأخرى,65,19,0,0,84
2022,1,مكتب منطقة المدينة المنورة,أنشطة المنظمات ذات العضوية,16,4,3,0,23
2022,1,مكتب منطقة المدينة المنورة,أنشطة النشر,36,13,0,0,49
2022,1,مكتب منطقة المدينة المنورة,أنشطة تقديم الخدمات للمباني وتجميل المواقع,840,231,17,2,1090
2022,1,مكتب منطقة المدينة المنورة,أنشطة جمع النفايات ومعالجتها وتصريفها ، واسترجاع المواد,5,2,0,0,7
2022,1,مكتب منطقة المدينة المنورة,أنشطة خدمات الأطعمة والمشروبات,3356,787,41,2,4186
2022,1,مكتب منطقة المدينة المنورة,أنشطة خدمات المعلومات,15,5,0,0,20
2022,1,مكتب منطقة المدينة المنورة,أنشطة خدمات دعم التعدين,5,8,0,0,13
2022,1,مكتب منطقة المدينة المنورة,أنشطة زراعة المحاصيل والإنتاج الحيواني والصيد والخدمات المتصلة,640,60,3,0,703
2022,1,مكتب منطقة المدينة المنورة,الإدارة العامة والدفاع ؛ والضمان الاجتماعي الإلزامي,48,24,2,0,74
2022,1,مكتب منطقة المدينة المنورة,الإقامة,219,109,32,5,365
2022,1,مكتب منطقة المدينة المنورة,الأنشطة الإبداعية والفنون وأنشطة الترفيه,3,0,0,0,3
2022,1,مكتب منطقة المدينة المنورة,الأنشطة الأخرى للتعدين واستغلال المحاجر,21,6,0,0,27
2022,1,مكتب منطقة المدينة المنورة,الأنشطة الإدارية للمكاتب ، وأنشطة الدعم للمكاتب وغير ذلك من أنشطة الدعم للأعمال,101,7,0,0,108
2022,1,مكتب منطقة المدينة المنورة,الأنشطة الإيجارية,687,46,3,0,736
2022,1,مكتب منطقة المدينة المنورة,الأنشطة البيطرية,15,4,0,0,19
2022,1,مكتب منطقة المدينة المنورة,الأنشطة الرياضية وأنشطة التسلية والترفيه,72,19,1,0,92
2022,1,مكتب منطقة المدينة المنورة,الأنشطة العقارية,163,22,4,0,189
2022,1,مكتب منطقة المدينة المنورة,الأنشطة القانونية وأنشطة المحاسبة,44,10,0,0,54
2022,1,مكتب منطقة المدينة المنورة,الأنشطة المساعدة لأنشطة الخدمات المالية وأنشطة التأمين,11,4,0,0,15
2022,1,مكتب منطقة المدينة المنورة,الأنشطة المهنية والعلمية والتقنية الأخرى,47,13,1,0,61
2022,1,مكتب منطقة المدينة المنورة,الأنشطة غير المتميزة لإنتاج السلع والخدمات التي تقوم بها الأسر المعيشية الخاصة لإستعمالها الخاص,1,0,0,0,1
2022,1,مكتب منطقة المدينة المنورة,الاتصالات,43,3,0,0,46
2022,1,مكتب منطقة المدينة المنورة,البحث والتطوير في المجال العلمي,1,1,0,0,2
2022,1,مكتب منطقة المدينة المنورة,التخزين وأنشطة الدعم للنقل,219,34,1,3,257
2022,1,مكتب منطقة المدينة المنورة,التعليم,80,64,24,1,169
2022,1,مكتب منطقة المدينة المنورة,الحراجة وقطع الأخشاب,1,1,0,0,2
2022,1,مكتب منطقة المدينة المنورة,الرعاية مع الإقامة,10,5,0,0,15
2022,1,مكتب منطقة المدينة المنورة,الصحة البشرية,34,95,24,5,158
2022,1,مكتب منطقة المدينة المنورة,الصرف الصحي,2,2,0,0,4
2022,1,مكتب منطقة المدينة المنورة,الصناعة التحويلية الأخرى,31,14,1,1,47
2022,1,مكتب منطقة المدينة المنورة,الطباعة واستنساخ وسائط الأعلام المسجّلة,55,14,1,0,70
2022,1,مكتب منطقة المدينة المنورة,النقل البري و النقل عبر الأنابيب,673,68,0,0,741
2022,1,مكتب منطقة المدينة المنورة,النقل الجوي,9,2,0,0,11
2022,1,مكتب منطقة المدينة المنورة,النقل المائي,8,0,0,0,8
2022,1,مكتب منطقة المدينة المنورة,الهندسة المدنية,40,4,1,0,45
2022,1,مكتب منطقة المدينة المنورة,تجارة التجزئة، باستثناء المركبات ذات المحركات والدراجات النارية,4920,954,50,4,5928
2022,1,مكتب منطقة المدينة المنورة,تجارة الجملة ، باستثناء المركبات ذات المحركات والدراجات النارية,1573,397,32,2,2004
2022,1,مكتب منطقة المدينة المنورة,تجارة الجملة والتجزئة ، وإصلاح المركبات ذات المحركات والدراجات النارية,1578,218,6,0,1802
2022,1,مكتب منطقة المدينة المنورة,تجميع المياه ومعالجتها وتوصيلها,28,6,1,0,35
2022,1,مكتب منطقة المدينة المنورة,تشييد المباني,3062,849,59,20,3990
2022,1,مكتب منطقة المدينة المنورة,تعدين ركازات الفلزات,19,6,0,0,25
2022,1,مكتب منطقة المدينة المنورة,تمويل التأمين وإعادة التأمين وصناديق المعاشات التقاعدية باستثناء الضمان الاجتماعي الإلزامي,2,1,0,0,3
2022,1,مكتب منطقة المدينة المنورة,توصيل الكهرباء والغاز والبخار وتكييف الهواء,15,9,2,0,26
2022,1,مكتب منطقة المدينة المنورة,صناعة الآلات والمعدات غير المصنفة في موضع أخر,19,3,0,0,22
2022,1,مكتب منطقة المدينة المنورة,صناعة المركبات ذات المحركات والمركبات المقطورة ونصف المقطورة,41,2,0,0,43
2022,1,مكتب منطقة المدينة المنورة,صناعة معدات النقل الأخرى,10,4,0,0,14
2022,1,مكتب منطقة المدينة المنورة,صنع الأثاث,185,39,1,0,225
2022,1,مكتب منطقة المدينة المنورة,صنع الحواسيب والمنتجات الإلكترونية والبصرية,40,11,0,0,51
2022,1,مكتب منطقة المدينة المنورة,صُنع الخشب ومنتجات الخشب والفلين ، باستثناء الأثاث ، صُنع أصناف من القش ومواد الضفر,108,20,0,0,128
2022,1,مكتب منطقة المدينة المنورة,صنع الفلزات القاعدية,91,17,4,1,113
2022,1,مكتب منطقة المدينة المنورة,صُنع المشروبات,16,14,6,1,37
2022,1,مكتب منطقة المدينة المنورة,صنع المعدات الكهربائية,70,15,0,0,85
2022,1,مكتب منطقة المدينة المنورة,صُنع الملبوسات,663,75,3,0,741
2022,1,مكتب منطقة المدينة المنورة,صُنع المنتجات الجلدية والمنتجات ذات الصلة,9,1,1,0,11
2022,1,مكتب منطقة المدينة المنورة,صنع المنتجات الصيدلانية الأساسية والمستحضرات الصيدلانية,5,2,0,0,7
2022,1,مكتب منطقة المدينة المنورة,صُنع المنتجات الغذائية,466,119,5,2,592
2022,1,مكتب منطقة المدينة المنورة,صُنع المنسوجات,81,19,2,0,102
2022,1,مكتب منطقة المدينة المنورة,صُنع المواد الكيميائية والمنتجات الكيميائية,37,13,2,0,52
2022,1,مكتب منطقة المدينة المنورة,صُنع الورق ومنتجات الورق,3,4,1,0,8
2022,1,مكتب منطقة المدينة المنورة,صنع فحم الكوك والمنتجات النفطية المكررة,1,1,0,0,2
2022,1,مكتب منطقة المدينة المنورة,صُنع منتجات التبغ,1,0,0,0,1
2022,1,مكتب منطقة المدينة المنورة,صنع منتجات المطاط واللدائن,28,18,4,0,50
2022,1,مكتب منطقة المدينة المنورة,صنع منتجات المعادن اللافلزية الأخرى,115,47,11,0,173
2022,1,مكتب منطقة المدينة المنورة,صنع منتجات المعادن المشكلة ( باستثناء الآلات والمعدات ),276,52,5,0,333
2022,1,مكتب منطقة المدينة المنورة,صيد الأسماك وتربية المائيات,23,1,0,0,24
2022,1,مكتب منطقة المدينة المنورة,وكالات السفر ومشغّلو الجولات السياحية وخدمات الحجز والأنشطة المتصلة بها,65,14,1,0,80
2022,1,مكتب منطقة تبوك,أبحاث الإعلان والسوق,16,0,1,0,17
2022,1,مكتب منطقة تبوك,إصلاح أجهزة الحاسوب والسلع الشخصية والمنزلية,178,34,0,0,212
2022,1,مكتب منطقة تبوك,إصلاح وتركيب الآلات والمعدات,60,1,0,0,61
2022,1,مكتب منطقة تبوك,أنشطة أنتاج الأفلام والبرامج التلفزيونية والتسجيلات الصوتية و نشرالموسيقى,5,0,0,0,5
2022,1,مكتب منطقة تبوك,أنشطة الأمن والتحقيقات,1,0,0,0,1
2022,1,مكتب منطقة تبوك,أنشطة الاستخدام,22,2,1,0,25
2022,1,مكتب منطقة تبوك,أنشطة الاسر المعيشية التي تستخدم أفراداً للعمل المنزلي,2,1,0,0,3
2022,1,مكتب منطقة تبوك,أنشطة البرمجة الحاسوبية والخبرة الاستشارية وما يتصل بها من أنشطة,7,1,0,0,8
2022,1,مكتب منطقة تبوك,أنشطة البرمجة والإذاعة,1,0,0,0,1
2022,1,مكتب منطقة تبوك,أنشطة البريد ونقل الرسائل والطرود بواسطة مندوبين,4,0,0,0,4
2022,1,مكتب منطقة تبوك,أنشطة التشييد المتخصصة,1140,140,4,0,1284
2022,1,مكتب منطقة تبوك,أنشطة الخدمات الشخصية الأخرى,946,73,2,0,1021
2022,1,مكتب منطقة تبوك,أنشطة الخدمات المالية ، فيما عدا تمويل التأمين وصناديق المعاشات,17,3,0,0,20
2022,1,مكتب منطقة تبوك,أنشطة العمل الاجتماعي، دون إقامة، لكبار السن وذوي الإعاقة,28,12,1,0,41
2022,1,مكتب منطقة تبوك,أنشطة المعمارية والهندسية ، والاختبارات الفنية والتحليل,66,23,1,0,90
2022,1,مكتب منطقة تبوك,أنشطة المكاتب الرئيسية ، وألأنشطة الاستشارية في مجال الإدارة,10,1,0,0,11
2022,1,مكتب منطقة تبوك,أنشطة المكتبات ودور المحفوظات، والمتاحف والأنشطة الثقافية الأخرى,22,9,0,0,31
2022,1,مكتب منطقة تبوك,أنشطة المنظمات ذات العضوية,5,2,0,0,7
2022,1,مكتب منطقة تبوك,أنشطة النشر,7,1,0,0,8
2022,1,مكتب منطقة تبوك,أنشطة تقديم الخدمات للمباني وتجميل المواقع,355,59,5,1,420
2022,1,مكتب منطقة تبوك,أنشطة جمع النفايات ومعالجتها وتصريفها ، واسترجاع المواد,1,0,0,0,1
2022,1,مكتب منطقة تبوك,أنشطة خدمات الأطعمة والمشروبات,1837,369,26,0,2232
2022,1,مكتب منطقة تبوك,أنشطة خدمات المعلومات,9,2,0,0,11
2022,1,مكتب منطقة تبوك,أنشطة خدمات دعم التعدين,2,1,0,0,3
2022,1,مكتب منطقة تبوك,أنشطة زراعة المحاصيل والإنتاج الحيواني والصيد والخدمات المتصلة,559,36,1,2,598
2022,1,مكتب منطقة تبوك,الإدارة العامة والدفاع ؛ والضمان الاجتماعي الإلزامي,9,8,1,0,18
2022,1,مكتب منطقة تبوك,الإقامة,85,32,3,0,120
2022,1,مكتب منطقة تبوك,الأنشطة الإبداعية والفنون وأنشطة الترفيه,1,0,0,0,1
2022,1,مكتب منطقة تبوك,الأنشطة الأخرى للتعدين واستغلال المحاجر,6,2,0,0,8
2022,1,مكتب منطقة تبوك,الأنشطة الإدارية للمكاتب ، وأنشطة الدعم للمكاتب وغير ذلك من أنشطة الدعم للأعمال,45,4,1,0,50
2022,1,مكتب منطقة تبوك,الأنشطة الإيجارية,393,10,0,0,403
2022,1,مكتب منطقة تبوك,الأنشطة البيطرية,6,2,0,0,8
2022,1,مكتب منطقة تبوك,الأنشطة الرياضية وأنشطة التسلية والترفيه,55,9,0,0,64
2022,1,مكتب منطقة تبوك,الأنشطة العقارية,55,6,0,0,61
2022,1,مكتب منطقة تبوك,الأنشطة القانونية وأنشطة المحاسبة,8,1,0,0,9
2022,1,مكتب منطقة تبوك,الأنشطة المساعدة لأنشطة الخدمات المالية وأنشطة التأمين,3,0,0,0,3
2022,1,مكتب منطقة تبوك,الأنشطة المهنية والعلمية والتقنية الأخرى,20,2,0,0,22
2022,1,مكتب منطقة تبوك,الاتصالات,17,1,0,0,18
2022,1,مكتب منطقة تبوك,البحث والتطوير في المجال العلمي,1,0,0,0,1
2022,1,مكتب منطقة تبوك,التخزين وأنشطة الدعم للنقل,74,7,0,0,81
2022,1,مكتب منطقة تبوك,التعليم,35,39,16,2,92
2022,1,مكتب منطقة تبوك,الرعاية مع الإقامة,9,0,1,0,10
2022,1,مكتب منطقة تبوك,الصحة البشرية,22,47,11,1,81
2022,1,مكتب منطقة تبوك,الصرف الصحي,1,0,0,0,1
2022,1,مكتب منطقة تبوك,الصناعة التحويلية الأخرى,14,0,0,0,14
2022,1,مكتب منطقة تبوك,الطباعة واستنساخ وسائط الأعلام المسجّلة,27,7,0,0,34
2022,1,مكتب منطقة تبوك,النقل البري و النقل عبر الأنابيب,467,61,5,0,533
2022,1,مكتب منطقة تبوك,النقل الجوي,8,4,3,0,15
2022,1,مكتب منطقة تبوك,النقل المائي,9,1,0,0,10
2022,1,مكتب منطقة تبوك,الهندسة المدنية,12,2,0,0,14
2022,1,مكتب منطقة تبوك,تجارة التجزئة، باستثناء المركبات ذات المحركات والدراجات النارية,2030,282,13,2,2327
2022,1,مكتب منطقة تبوك,تجارة الجملة ، باستثناء المركبات ذات المحركات والدراجات النارية,579,103,8,0,690
2022,1,مكتب منطقة تبوك,تجارة الجملة والتجزئة ، وإصلاح المركبات ذات المحركات والدراجات النارية,959,135,0,0,1094
2022,1,مكتب منطقة تبوك,تجميع المياه ومعالجتها وتوصيلها,40,4,0,0,44
2022,1,مكتب منطقة تبوك,تشييد المباني,2176,379,26,4,2585
2022,1,مكتب منطقة تبوك,تعدين الفحم والليغنيت,1,0,0,0,1
2022,1,مكتب منطقة تبوك,تعدين ركازات الفلزات,6,2,0,0,8
2022,1,مكتب منطقة تبوك,توصيل الكهرباء والغاز والبخار وتكييف الهواء,9,2,0,0,11
2022,1,مكتب منطقة تبوك,صناعة الآلات والمعدات غير المصنفة في موضع أخر,19,2,0,0,21
2022,1,مكتب منطقة تبوك,صناعة المركبات ذات المحركات والمركبات المقطورة ونصف المقطورة,30,2,0,0,32
2022,1,مكتب منطقة تبوك,صناعة معدات النقل الأخرى,2,1,0,0,3
2022,1,مكتب منطقة تبوك,صنع الأثاث,149,23,0,0,172
2022,1,مكتب منطقة تبوك,صنع الحواسيب والمنتجات الإلكترونية والبصرية,42,4,1,0,47
2022,1,مكتب منطقة تبوك,صُنع الخشب ومنتجات الخشب والفلين ، باستثناء الأثاث ، صُنع أصناف من القش ومواد الضفر,86,22,0,0,108
2022,1,مكتب منطقة تبوك,صنع الفلزات القاعدية,22,3,1,0,26
2022,1,مكتب منطقة تبوك,صُنع المشروبات,25,7,1,0,33
2022,1,مكتب منطقة تبوك,صنع المعدات الكهربائية,44,5,0,0,49
2022,1,مكتب منطقة تبوك,صُنع الملبوسات,624,38,0,0,662
2022,1,مكتب منطقة تبوك,صُنع المنتجات الجلدية والمنتجات ذات الصلة,4,3,0,0,7
2022,1,مكتب منطقة تبوك,صنع المنتجات الصيدلانية الأساسية والمستحضرات الصيدلانية,0,0,0,1,1
2022,1,مكتب منطقة تبوك,صُنع المنتجات الغذائية,196,41,2,2,241
2022,1,مكتب منطقة تبوك,صُنع المنسوجات,42,12,0,0,54
2022,1,مكتب منطقة تبوك,صُنع المواد الكيميائية والمنتجات الكيميائية,21,7,0,0,28
2022,1,مكتب منطقة تبوك,صُنع الورق ومنتجات الورق,2,4,0,0,6
2022,1,مكتب منطقة تبوك,صُنع منتجات التبغ,4,0,0,0,4
2022,1,مكتب منطقة تبوك,صنع منتجات المطاط واللدائن,9,7,1,0,17
2022,1,مكتب منطقة تبوك,صنع منتجات المعادن اللافلزية الأخرى,51,22,0,0,73
2022,1,مكتب منطقة تبوك,صنع منتجات المعادن المشكلة ( باستثناء الآلات والمعدات ),158,36,1,1,196
2022,1,مكتب منطقة تبوك,صيد الأسماك وتربية المائيات,27,10,0,0,37
2022,1,مكتب منطقة تبوك,وكالات السفر ومشغّلو الجولات السياحية وخدمات الحجز والأنشطة المتصلة بها,23,3,0,0,26
2022,1,مكتب منطقة جازان,أبحاث الإعلان والسوق,24,3,0,0,27
2022,1,مكتب منطقة جازان,إصلاح أجهزة الحاسوب والسلع الشخصية والمنزلية,164,13,0,0,177
2022,1,مكتب منطقة جازان,إصلاح وتركيب الآلات والمعدات,160,6,0,0,166
2022,1,مكتب منطقة جازان,أنشطة أنتاج الأفلام والبرامج التلفزيونية والتسجيلات الصوتية و نشرالموسيقى,9,0,0,0,9
2022,1,مكتب منطقة جازان,أنشطة الأمن والتحقيقات,7,1,0,0,8
2022,1,مكتب منطقة جازان,أنشطة الاستخدام,22,2,0,0,24
2022,1,مكتب منطقة جازان,أنشطة الاسر المعيشية التي تستخدم أفراداً للعمل المنزلي,6,0,0,0,6
2022,1,مكتب منطقة جازان,أنشطة البرمجة الحاسوبية والخبرة الاستشارية وما يتصل بها من أنشطة,13,0,0,0,13
2022,1,مكتب منطقة جازان,أنشطة البريد ونقل الرسائل والطرود بواسطة مندوبين,1,0,0,0,1
2022,1,مكتب منطقة جازان,أنشطة التشييد المتخصصة,1304,151,6,1,1462
2022,1,مكتب منطقة جازان,أنشطة الخدمات الشخصية الأخرى,1289,86,0,0,1375
2022,1,مكتب منطقة جازان,أنشطة الخدمات المالية ، فيما عدا تمويل التأمين وصناديق المعاشات,28,5,0,0,33
2022,1,مكتب منطقة جازان,أنشطة العمل الاجتماعي، دون إقامة، لكبار السن وذوي الإعاقة,28,29,2,0,59
2022,1,مكتب منطقة جازان,أنشطة المعالجة وخدمات إدارة النفايات الأخرى,1,0,0,0,1
2022,1,مكتب منطقة جازان,أنشطة المعمارية والهندسية ، والاختبارات الفنية والتحليل,68,21,2,0,91
2022,1,مكتب منطقة جازان,أنشطة المكاتب الرئيسية ، وألأنشطة الاستشارية في مجال الإدارة,26,4,0,0,30
2022,1,مكتب منطقة جازان,أنشطة المكتبات ودور المحفوظات، والمتاحف والأنشطة الثقافية الأخرى,23,10,1,0,34
2022,1,مكتب منطقة جازان,أنشطة المنظمات ذات العضوية,30,4,0,0,34
2022,1,مكتب منطقة جازان,أنشطة النشر,16,2,0,0,18
2022,1,مكتب منطقة جازان,أنشطة تقديم الخدمات للمباني وتجميل المواقع,400,82,2,0,484
2022,1,مكتب منطقة جازان,أنشطة جمع النفايات ومعالجتها وتصريفها ، واسترجاع المواد,1,0,0,0,1
2022,1,مكتب منطقة جازان,أنشطة خدمات الأطعمة والمشروبات,3232,575,18,0,3825
2022,1,مكتب منطقة جازان,أنشطة خدمات المعلومات,12,4,0,0,16
2022,1,مكتب منطقة جازان,أنشطة خدمات دعم التعدين,10,6,0,0,16
2022,1,مكتب منطقة جازان,أنشطة زراعة المحاصيل والإنتاج الحيواني والصيد والخدمات المتصلة,491,31,1,0,523
2022,1,مكتب منطقة جازان,الإدارة العامة والدفاع ؛ والضمان الاجتماعي الإلزامي,20,6,0,0,26
2022,1,مكتب منطقة جازان,الإقامة,194,44,7,0,245
2022,1,مكتب منطقة جازان,الأنشطة الإبداعية والفنون وأنشطة الترفيه,3,0,0,0,3
2022,1,مكتب منطقة جازان,الأنشطة الأخرى للتعدين واستغلال المحاجر,11,4,0,0,15
2022,1,مكتب منطقة جازان,الأنشطة الإدارية للمكاتب ، وأنشطة الدعم للمكاتب وغير ذلك من أنشطة الدعم للأعمال,44,2,0,0,46
2022,1,مكتب منطقة جازان,الأنشطة الإيجارية,1184,26,1,0,1211
2022,1,مكتب منطقة جازان,الأنشطة البيطرية,6,6,0,0,12
2022,1,مكتب منطقة جازان,الأنشطة الرياضية وأنشطة التسلية والترفيه,46,8,1,0,55
2022,1,مكتب منطقة جازان,الأنشطة العقارية,72,14,0,1,87
2022,1,مكتب منطقة جازان,الأنشطة القانونية وأنشطة المحاسبة,15,3,0,0,18
2022,1,مكتب منطقة جازان,الأنشطة المساعدة لأنشطة الخدمات المالية وأنشطة التأمين,1,0,0,0,1
2022,1,مكتب منطقة جازان,الأنشطة المهنية والعلمية والتقنية الأخرى,23,3,0,0,26
2022,1,مكتب منطقة جازان,الأنشطة غير المتميزة لإنتاج السلع والخدمات التي تقوم بها الأسر المعيشية الخاصة لإستعمالها الخاص,1,0,0,0,1
2022,1,مكتب منطقة جازان,الاتصالات,23,4,0,0,27
2022,1,مكتب منطقة جازان,البحث والتطوير في المجال العلمي,1,0,0,0,1
2022,1,مكتب منطقة جازان,التخزين وأنشطة الدعم للنقل,77,18,1,1,97
2022,1,مكتب منطقة جازان,التعليم,47,35,3,0,85
2022,1,مكتب منطقة جازان,الحراجة وقطع الأخشاب,1,1,0,0,2
2022,1,مكتب منطقة جازان,الرعاية مع الإقامة,9,4,0,0,13
2022,1,مكتب منطقة جازان,الصحة البشرية,37,64,12,2,115
2022,1,مكتب منطقة جازان,الصرف الصحي,1,2,0,0,3
2022,1,مكتب منطقة جازان,الصناعة التحويلية الأخرى,15,8,0,0,23
2022,1,مكتب منطقة جازان,الطباعة واستنساخ وسائط الأعلام المسجّلة,17,4,0,0,21
2022,1,مكتب منطقة جازان,النقل البري و النقل عبر الأنابيب,334,34,2,0,370
2022,1,مكتب منطقة جازان,النقل الجوي,8,2,0,0,10
2022,1,مكتب منطقة جازان,النقل المائي,4,2,1,0,7
2022,1,مكتب منطقة جازان,الهندسة المدنية,23,2,2,0,27
2022,1,مكتب منطقة جازان,تجارة التجزئة، باستثناء المركبات ذات المحركات والدراجات النارية,3837,535,16,1,4389
2022,1,مكتب منطقة جازان,تجارة الجملة ، باستثناء المركبات ذات المحركات والدراجات النارية,1370,306,20,1,1697
2022,1,مكتب منطقة جازان,تجارة الجملة والتجزئة ، وإصلاح المركبات ذات المحركات والدراجات النارية,1494,159,5,1,1659
2022,1,مكتب منطقة جازان,تجميع المياه ومعالجتها وتوصيلها,51,7,1,1,60
2022,1,مكتب منطقة جازان,تشييد المباني,2673,433,37,1,3144
2022,1,مكتب منطقة جازان,تعدين ركازات الفلزات,23,6,0,0,29
2022,1,مكتب منطقة جازان,تمويل التأمين وإعادة التأمين وصناديق المعاشات التقاعدية باستثناء الضمان الاجتماعي الإلزامي,1,1,0,0,2
2022,1,مكتب منطقة جازان,توصيل الكهرباء والغاز والبخار وتكييف الهواء,11,9,1,0,21
2022,1,مكتب منطقة جازان,صناعة الآلات والمعدات غير المصنفة في موضع أخر,37,3,0,0,40
2022,1,مكتب منطقة جازان,صناعة المركبات ذات المحركات والمركبات المقطورة ونصف المقطورة,83,4,0,0,87
2022,1,مكتب منطقة جازان,صناعة معدات النقل الأخرى,13,3,0,0,16
2022,1,مكتب منطقة جازان,صنع الأثاث,181,16,0,0,197
2022,1,مكتب منطقة جازان,صنع الحواسيب والمنتجات الإلكترونية والبصرية,40,10,0,0,50
2022,1,مكتب منطقة جازان,صُنع الخشب ومنتجات الخشب والفلين ، باستثناء الأثاث ، صُنع أصناف من القش ومواد الضفر,159,15,0,0,174
2022,1,مكتب منطقة جازان,صنع الفلزات القاعدية,58,14,1,2,75
2022,1,مكتب منطقة جازان,صُنع المشروبات,15,3,3,1,22
2022,1,مكتب منطقة جازان,صنع المعدات الكهربائية,72,6,0,0,78
2022,1,مكتب منطقة جازان,صُنع الملبوسات,424,41,0,0,465
2022,1,مكتب منطقة جازان,صُنع المنتجات الجلدية والمنتجات ذات الصلة,48,1,0,0,49
2022,1,مكتب منطقة جازان,صنع المنتجات الصيدلانية الأساسية والمستحضرات الصيدلانية,6,1,0,0,7
2022,1,مكتب منطقة جازان,صُنع المنتجات الغذائية,288,73,5,0,366
2022,1,مكتب منطقة جازان,صُنع المنسوجات,14,4,0,0,18
2022,1,مكتب منطقة جازان,صُنع المواد الكيميائية والمنتجات الكيميائية,37,9,2,0,48
2022,1,مكتب منطقة جازان,صُنع الورق ومنتجات الورق,3,1,1,0,5
2022,1,مكتب منطقة جازان,صنع فحم الكوك والمنتجات النفطية المكررة,3,0,0,0,3
2022,1,مكتب منطقة جازان,صُنع منتجات التبغ,0,1,0,0,1
2022,1,مكتب منطقة جازان,صنع منتجات المطاط واللدائن,9,9,1,0,19
2022,1,مكتب منطقة جازان,صنع منتجات المعادن اللافلزية الأخرى,106,42,11,2,161
2022,1,مكتب منطقة جازان,صنع منتجات المعادن المشكلة ( باستثناء الآلات والمعدات ),438,18,1,0,457
2022,1,مكتب منطقة جازان,صيد الأسماك وتربية المائيات,128,66,4,0,198
2022,1,مكتب منطقة جازان,وكالات السفر ومشغّلو الجولات السياحية وخدمات الحجز والأنشطة المتصلة بها,20,2,0,0,22
2022,1,مكتب منطقة حائل,أبحاث الإعلان والسوق,20,6,0,0,26
2022,1,مكتب منطقة حائل,إصلاح أجهزة الحاسوب والسلع الشخصية والمنزلية,140,9,0,0,149
2022,1,مكتب منطقة حائل,إصلاح وتركيب الآلات والمعدات,28,2,0,0,30
2022,1,مكتب منطقة حائل,أنشطة أنتاج الأفلام والبرامج التلفزيونية والتسجيلات الصوتية و نشرالموسيقى,8,0,0,0,8
2022,1,مكتب منطقة حائل,أنشطة الأمن والتحقيقات,4,1,0,0,5
2022,1,مكتب منطقة حائل,أنشطة الاستخدام,11,3,0,0,14
2022,1,مكتب منطقة حائل,أنشطة الاسر المعيشية التي تستخدم أفراداً للعمل المنزلي,1,0,0,0,1
2022,1,مكتب منطقة حائل,أنشطة البرمجة الحاسوبية والخبرة الاستشارية وما يتصل بها من أنشطة,6,4,0,0,10
2022,1,مكتب منطقة حائل,أنشطة البريد ونقل الرسائل والطرود بواسطة مندوبين,2,1,0,0,3
2022,1,مكتب منطقة حائل,أنشطة التشييد المتخصصة,1208,178,2,0,1388
2022,1,مكتب منطقة حائل,أنشطة الخدمات الشخصية الأخرى,792,71,1,0,864
2022,1,مكتب منطقة حائل,أنشطة الخدمات المالية ، فيما عدا تمويل التأمين وصناديق المعاشات,25,2,0,0,27
2022,1,مكتب منطقة حائل,أنشطة العمل الاجتماعي، دون إقامة، لكبار السن وذوي الإعاقة,40,21,0,0,61
2022,1,مكتب منطقة حائل,أنشطة المعمارية والهندسية ، والاختبارات الفنية والتحليل,66,16,1,0,83
2022,1,مكتب منطقة حائل,أنشطة المكاتب الرئيسية ، وألأنشطة الاستشارية في مجال الإدارة,21,2,0,0,23
2022,1,مكتب منطقة حائل,أنشطة المكتبات ودور المحفوظات، والمتاحف والأنشطة الثقافية الأخرى,7,2,0,0,9
2022,1,مكتب منطقة حائل,أنشطة المنظمات ذات العضوية,27,4,0,0,31
2022,1,مكتب منطقة حائل,أنشطة النشر,37,0,0,0,37
2022,1,مكتب منطقة حائل,أنشطة تقديم الخدمات للمباني وتجميل المواقع,359,55,8,1,423
2022,1,مكتب منطقة حائل,أنشطة جمع النفايات ومعالجتها وتصريفها ، واسترجاع المواد,3,0,0,0,3
2022,1,مكتب منطقة حائل,أنشطة خدمات الأطعمة والمشروبات,1647,293,18,1,1959
2022,1,مكتب منطقة حائل,أنشطة خدمات المعلومات,9,0,0,0,9
2022,1,مكتب منطقة حائل,أنشطة خدمات دعم التعدين,8,3,0,0,11
2022,1,مكتب منطقة حائل,أنشطة زراعة المحاصيل والإنتاج الحيواني والصيد والخدمات المتصلة,1316,49,6,1,1372
2022,1,مكتب منطقة حائل,الإدارة العامة والدفاع ؛ والضمان الاجتماعي الإلزامي,16,8,0,0,24
2022,1,مكتب منطقة حائل,الإقامة,69,20,1,0,90
2022,1,مكتب منطقة حائل,الأنشطة الإبداعية والفنون وأنشطة الترفيه,2,1,0,0,3
2022,1,مكتب منطقة حائل,الأنشطة الأخرى للتعدين واستغلال المحاجر,29,4,0,0,33
2022,1,مكتب منطقة حائل,الأنشطة الإدارية للمكاتب ، وأنشطة الدعم للمكاتب وغير ذلك من أنشطة الدعم للأعمال,53,5,0,0,58
2022,1,مكتب منطقة حائل,الأنشطة الإيجارية,840,38,1,0,879
2022,1,مكتب منطقة حائل,الأنشطة البيطرية,4,0,1,0,5
2022,1,مكتب منطقة حائل,الأنشطة الرياضية وأنشطة التسلية والترفيه,45,19,0,0,64
2022,1,مكتب منطقة حائل,الأنشطة العقارية,70,8,0,0,78
2022,1,مكتب منطقة حائل,الأنشطة القانونية وأنشطة المحاسبة,7,3,0,0,10
2022,1,مكتب منطقة حائل,الأنشطة المهنية والعلمية والتقنية الأخرى,15,0,1,0,16
2022,1,مكتب منطقة حائل,الاتصالات,27,2,0,0,29
2022,1,مكتب منطقة حائل,التخزين وأنشطة الدعم للنقل,68,14,0,0,82
2022,1,مكتب منطقة حائل,التعليم,32,27,4,0,63
2022,1,مكتب منطقة حائل,الحراجة وقطع الأخشاب,2,0,0,0,2
2022,1,مكتب منطقة حائل,الرعاية مع الإقامة,11,3,0,0,14
2022,1,مكتب منطقة حائل,الصحة البشرية,42,57,16,2,117
2022,1,مكتب منطقة حائل,الصرف الصحي,2,0,0,0,2
2022,1,مكتب منطقة حائل,الصناعة التحويلية الأخرى,12,1,0,0,13
2022,1,مكتب منطقة حائل,الطباعة واستنساخ وسائط الأعلام المسجّلة,43,7,0,0,50
2022,1,مكتب منطقة حائل,النقل البري و النقل عبر الأنابيب,503,39,2,0,544
2022,1,مكتب منطقة حائل,النقل الجوي,22,6,0,0,28
2022,1,مكتب منطقة حائل,النقل المائي,3,0,0,0,3
2022,1,مكتب منطقة حائل,الهندسة المدنية,14,6,1,0,21
2022,1,مكتب منطقة حائل,تجارة التجزئة، باستثناء المركبات ذات المحركات والدراجات النارية,1626,290,16,0,1932
2022,1,مكتب منطقة حائل,تجارة الجملة ، باستثناء المركبات ذات المحركات والدراجات النارية,490,99,8,2,599
2022,1,مكتب منطقة حائل,تجارة الجملة والتجزئة ، وإصلاح المركبات ذات المحركات والدراجات النارية,796,148,2,0,946
2022,1,مكتب منطقة حائل,تجميع المياه ومعالجتها وتوصيلها,18,2,1,0,21
2022,1,مكتب منطقة حائل,تشييد المباني,2857,588,58,8,3511
2022,1,مكتب منطقة حائل,تعدين الفحم والليغنيت,2,0,0,0,2
2022,1,مكتب منطقة حائل,تعدين ركازات الفلزات,5,0,0,0,5
2022,1,مكتب منطقة حائل,تمويل التأمين وإعادة التأمين وصناديق المعاشات التقاعدية باستثناء الضمان الاجتماعي الإلزامي,1,0,0,0,1
2022,1,مكتب منطقة حائل,توصيل الكهرباء والغاز والبخار وتكييف الهواء,15,5,2,0,22
2022,1,مكتب منطقة حائل,صناعة الآلات والمعدات غير المصنفة في موضع أخر,23,3,0,0,26
2022,1,مكتب منطقة حائل,صناعة المركبات ذات المحركات والمركبات المقطورة ونصف المقطورة,38,3,0,0,41
2022,1,مكتب منطقة حائل,صناعة معدات النقل الأخرى,5,0,0,0,5
2022,1,مكتب منطقة حائل,صنع الأثاث,131,23,0,0,154
2022,1,مكتب منطقة حائل,صنع الحواسيب والمنتجات الإلكترونية والبصرية,36,4,0,0,40
2022,1,مكتب منطقة حائل,صُنع الخشب ومنتجات الخشب والفلين ، باستثناء الأثاث ، صُنع أصناف من القش ومواد الضفر,61,8,1,0,70
2022,1,مكتب منطقة حائل,صنع الفلزات القاعدية,87,27,3,0,117
2022,1,مكتب منطقة حائل,صُنع المشروبات,7,7,0,0,14
2022,1,مكتب منطقة حائل,صنع المعدات الكهربائية,45,3,0,0,48
2022,1,مكتب منطقة حائل,صُنع الملبوسات,324,35,0,0,359
2022,1,مكتب منطقة حائل,صُنع المنتجات الجلدية والمنتجات ذات الصلة,6,2,0,0,8
2022,1,مكتب منطقة حائل,صنع المنتجات الصيدلانية الأساسية والمستحضرات الصيدلانية,3,0,0,0,3
2022,1,مكتب منطقة حائل,صُنع المنتجات الغذائية,200,35,7,0,242
2022,1,مكتب منطقة حائل,صُنع المنسوجات,53,22,0,0,75
2022,1,مكتب منطقة حائل,صُنع المواد الكيميائية والمنتجات الكيميائية,85,34,0,0,119
2022,1,مكتب منطقة حائل,صُنع الورق ومنتجات الورق,4,3,0,0,7
2022,1,مكتب منطقة حائل,صنع منتجات المطاط واللدائن,13,7,3,0,23
2022,1,مكتب منطقة حائل,صنع منتجات المعادن اللافلزية الأخرى,109,35,8,1,153
2022,1,مكتب منطقة حائل,صنع منتجات المعادن المشكلة ( باستثناء الآلات والمعدات ),114,37,0,0,151
2022,1,مكتب منطقة حائل,صيد الأسماك وتربية المائيات,32,0,0,0,32
2022,1,مكتب منطقة حائل,وكالات السفر ومشغّلو الجولات السياحية وخدمات الحجز والأنشطة المتصلة بها,10,1,0,0,11
2022,1,مكتب منطقة عسير,أبحاث الإعلان والسوق,42,2,0,0,44
2022,1,مكتب منطقة عسير,إصلاح أجهزة الحاسوب والسلع الشخصية والمنزلية,231,33,1,0,265
2022,1,مكتب منطقة عسير,إصلاح وتركيب الآلات والمعدات,66,3,1,0,70
2022,1,مكتب منطقة عسير,أنشطة أنتاج الأفلام والبرامج التلفزيونية والتسجيلات الصوتية و نشرالموسيقى,13,0,0,0,13
2022,1,مكتب منطقة عسير,أنشطة الأمن والتحقيقات,12,4,2,1,19
2022,1,مكتب منطقة عسير,أنشطة الاستخدام,42,7,0,1,50
2022,1,مكتب منطقة عسير,أنشطة البرمجة الحاسوبية والخبرة الاستشارية وما يتصل بها من أنشطة,18,6,0,0,24
2022,1,مكتب منطقة عسير,أنشطة البرمجة والإذاعة,7,3,0,0,10
2022,1,مكتب منطقة عسير,أنشطة البريد ونقل الرسائل والطرود بواسطة مندوبين,7,2,0,0,9
2022,1,مكتب منطقة عسير,أنشطة التشييد المتخصصة,1858,262,10,1,2131
2022,1,مكتب منطقة عسير,أنشطة الخدمات الشخصية الأخرى,1246,122,3,0,1371
2022,1,مكتب منطقة عسير,أنشطة الخدمات المالية ، فيما عدا تمويل التأمين وصناديق المعاشات,20,1,0,0,21
2022,1,مكتب منطقة عسير,أنشطة العمل الاجتماعي، دون إقامة، لكبار السن وذوي الإعاقة,49,42,5,0,96
2022,1,مكتب منطقة عسير,أنشطة المعمارية والهندسية ، والاختبارات الفنية والتحليل,120,45,3,1,169
2022,1,مكتب منطقة عسير,أنشطة المكاتب الرئيسية ، وألأنشطة الاستشارية في مجال الإدارة,24,2,1,0,27
2022,1,مكتب منطقة عسير,أنشطة المكتبات ودور المحفوظات، والمتاحف والأنشطة الثقافية الأخرى,31,18,1,0,50
2022,1,مكتب منطقة عسير,أنشطة المنظمات ذات العضوية,24,6,0,0,30
2022,1,مكتب منطقة عسير,أنشطة النشر,16,1,1,0,18
2022,1,مكتب منطقة عسير,أنشطة تقديم الخدمات للمباني وتجميل المواقع,433,72,5,2,512
2022,1,مكتب منطقة عسير,أنشطة جمع النفايات ومعالجتها وتصريفها ، واسترجاع المواد,7,1,0,0,8
2022,1,مكتب منطقة عسير,أنشطة خدمات الأطعمة والمشروبات,3743,913,62,4,4722
2022,1,مكتب منطقة عسير,أنشطة خدمات المعلومات,19,3,0,0,22
2022,1,مكتب منطقة عسير,أنشطة خدمات دعم التعدين,25,5,1,0,31
2022,1,مكتب منطقة عسير,أنشطة زراعة المحاصيل والإنتاج الحيواني والصيد والخدمات المتصلة,1200,39,2,0,1241
2022,1,مكتب منطقة عسير,الإدارة العامة والدفاع ؛ والضمان الاجتماعي الإلزامي,12,13,1,0,26
2022,1,مكتب منطقة عسير,الإقامة,247,75,5,1,328
2022,1,مكتب منطقة عسير,الأنشطة الإبداعية والفنون وأنشطة الترفيه,3,0,0,0,3
2022,1,مكتب منطقة عسير,الأنشطة الأخرى للتعدين واستغلال المحاجر,18,5,0,0,23
2022,1,مكتب منطقة عسير,الأنشطة الإدارية للمكاتب ، وأنشطة الدعم للمكاتب وغير ذلك من أنشطة الدعم للأعمال,98,6,1,1,106
2022,1,مكتب منطقة عسير,الأنشطة الإيجارية,1044,71,2,1,1118
2022,1,مكتب منطقة عسير,الأنشطة البيطرية,10,6,2,0,18
2022,1,مكتب منطقة عسير,الأنشطة الرياضية وأنشطة التسلية والترفيه,85,32,0,0,117
2022,1,مكتب منطقة عسير,الأنشطة العقارية,110,20,1,0,131
2022,1,مكتب منطقة عسير,الأنشطة القانونية وأنشطة المحاسبة,28,4,0,0,32
2022,1,مكتب منطقة عسير,الأنشطة المساعدة لأنشطة الخدمات المالية وأنشطة التأمين,5,0,0,0,5
2022,1,مكتب منطقة عسير,الأنشطة المهنية والعلمية والتقنية الأخرى,30,4,2,0,36
2022,1,مكتب منطقة عسير,الأنشطة غير المتميزة لإنتاج السلع والخدمات التي تقوم بها الأسر المعيشية الخاصة لإستعمالها الخاص,1,0,0,0,1
2022,1,مكتب منطقة عسير,الاتصالات,24,2,0,0,26
2022,1,مكتب منطقة عسير,التخزين وأنشطة الدعم للنقل,90,27,3,0,120
2022,1,مكتب منطقة عسير,التعليم,37,38,13,1,89
2022,1,مكتب منطقة عسير,الرعاية مع الإقامة,13,3,0,0,16
2022,1,مكتب منطقة عسير,الصحة البشرية,68,96,37,6,207
2022,1,مكتب منطقة عسير,الصرف الصحي,1,2,1,0,4
2022,1,مكتب منطقة عسير,الصناعة التحويلية الأخرى,24,12,1,0,37
2022,1,مكتب منطقة عسير,الطباعة واستنساخ وسائط الأعلام المسجّلة,32,13,1,0,46
2022,1,مكتب منطقة عسير,النقل البري و النقل عبر الأنابيب,1271,161,6,2,1440
2022,1,مكتب منطقة عسير,النقل الجوي,13,1,0,0,14
2022,1,مكتب منطقة عسير,النقل المائي,11,0,0,0,11
2022,1,مكتب منطقة عسير,الهندسة المدنية,36,10,2,0,48
2022,1,مكتب منطقة عسير,تجارة التجزئة، باستثناء المركبات ذات المحركات والدراجات النارية,3877,706,47,4,4634
2022,1,مكتب منطقة عسير,تجارة الجملة ، باستثناء المركبات ذات المحركات والدراجات النارية,1059,250,19,3,1331
2022,1,مكتب منطقة عسير,تجارة الجملة والتجزئة ، وإصلاح المركبات ذات المحركات والدراجات النارية,1750,360,12,0,2122
2022,1,مكتب منطقة عسير,تجميع المياه ومعالجتها وتوصيلها,103,27,0,0,130
2022,1,مكتب منطقة عسير,تشييد المباني,5955,1386,115,17,7473
2022,1,مكتب منطقة عسير,تعدين ركازات الفلزات,89,17,0,0,106
2022,1,مكتب منطقة عسير,تمويل التأمين وإعادة التأمين وصناديق المعاشات التقاعدية باستثناء الضمان الاجتماعي الإلزامي,2,2,1,0,5
2022,1,مكتب منطقة عسير,توصيل الكهرباء والغاز والبخار وتكييف الهواء,9,8,1,1,19
2022,1,مكتب منطقة عسير,صناعة الآلات والمعدات غير المصنفة في موضع أخر,39,6,0,0,45
2022,1,مكتب منطقة عسير,صناعة المركبات ذات المحركات والمركبات المقطورة ونصف المقطورة,38,4,1,0,43
2022,1,مكتب منطقة عسير,صناعة معدات النقل الأخرى,8,1,0,0,9
2022,1,مكتب منطقة عسير,صنع الأثاث,238,30,0,0,268
2022,1,مكتب منطقة عسير,صنع الحواسيب والمنتجات الإلكترونية والبصرية,64,21,0,0,85
2022,1,مكتب منطقة عسير,صُنع الخشب ومنتجات الخشب والفلين ، باستثناء الأثاث ، صُنع أصناف من القش ومواد الضفر,247,57,1,0,305
2022,1,مكتب منطقة عسير,صنع الفلزات القاعدية,110,31,0,0,141
2022,1,مكتب منطقة عسير,صُنع المشروبات,22,8,1,0,31
2022,1,مكتب منطقة عسير,صنع المعدات الكهربائية,49,10,0,0,59
2022,1,مكتب منطقة عسير,صُنع الملبوسات,543,57,1,0,601
2022,1,مكتب منطقة عسير,صُنع المنتجات الجلدية والمنتجات ذات الصلة,10,3,0,0,13
2022,1,مكتب منطقة عسير,صنع المنتجات الصيدلانية الأساسية والمستحضرات الصيدلانية,2,1,0,0,3
2022,1,مكتب منطقة عسير,صُنع المنتجات الغذائية,338,109,10,1,458
2022,1,مكتب منطقة عسير,صُنع المنسوجات,38,11,2,0,51
2022,1,مكتب منطقة عسير,صُنع المواد الكيميائية والمنتجات الكيميائية,49,22,5,0,76
2022,1,مكتب منطقة عسير,صُنع الورق ومنتجات الورق,8,4,1,0,13
2022,1,مكتب منطقة عسير,صنع فحم الكوك والمنتجات النفطية المكررة,2,0,0,0,2
2022,1,مكتب منطقة عسير,صُنع منتجات التبغ,1,0,0,0,1
2022,1,مكتب منطقة عسير,صنع منتجات المطاط واللدائن,35,12,2,1,50
2022,1,مكتب منطقة عسير,صنع منتجات المعادن اللافلزية الأخرى,155,86,17,2,260
2022,1,مكتب منطقة عسير,صنع منتجات المعادن المشكلة ( باستثناء الآلات والمعدات ),363,33,3,0,399
2022,1,مكتب منطقة عسير,صيد الأسماك وتربية المائيات,83,16,0,0,99
2022,1,مكتب منطقة عسير,وكالات السفر ومشغّلو الجولات السياحية وخدمات الحجز والأنشطة المتصلة بها,19,5,0,0,24
2022,1,مكتب منطقة مكة المكرمة/جدة,أبحاث الإعلان والسوق,258,43,1,0,302
2022,1,مكتب منطقة مكة المكرمة/جدة,إصلاح أجهزة الحاسوب والسلع الشخصية والمنزلية,511,86,7,1,605
2022,1,مكتب منطقة مكة المكرمة/جدة,إصلاح وتركيب الآلات والمعدات,241,51,13,1,306
2022,1,مكتب منطقة مكة المكرمة/جدة,أنشطة أنتاج الأفلام والبرامج التلفزيونية والتسجيلات الصوتية و نشرالموسيقى,102,21,0,0,123
2022,1,مكتب منطقة مكة المكرمة/جدة,أنشطة الأمن والتحقيقات,38,20,8,3,69
2022,1,مكتب منطقة مكة المكرمة/جدة,أنشطة الاستخدام,147,28,5,3,183
2022,1,مكتب منطقة مكة المكرمة/جدة,أنشطة الاسر المعيشية التي تستخدم أفراداً للعمل المنزلي,8,0,0,0,8
2022,1,مكتب منطقة مكة المكرمة/جدة,أنشطة البرمجة الحاسوبية والخبرة الاستشارية وما يتصل بها من أنشطة,335,128,11,3,477
2022,1,مكتب منطقة مكة المكرمة/جدة,أنشطة البرمجة والإذاعة,3,2,0,0,5
2022,1,مكتب منطقة مكة المكرمة/جدة,أنشطة البريد ونقل الرسائل والطرود بواسطة مندوبين,29,4,0,0,33
2022,1,مكتب منطقة مكة المكرمة/جدة,أنشطة التشييد المتخصصة,5552,1745,132,23,7452
2022,1,مكتب منطقة مكة المكرمة/جدة,أنشطة الخدمات الشخصية الأخرى,3267,523,32,4,3826
2022,1,مكتب منطقة مكة المكرمة/جدة,أنشطة الخدمات المالية ، فيما عدا تمويل التأمين وصناديق المعاشات,90,32,6,2,130
2022,1,مكتب منطقة مكة المكرمة/جدة,أنشطة العمل الاجتماعي، دون إقامة، لكبار السن وذوي الإعاقة,138,133,13,0,284
2022,1,مكتب منطقة مكة المكرمة/جدة,أنشطة المعالجة وخدمات إدارة النفايات الأخرى,3,2,0,0,5
2022,1,مكتب منطقة مكة المكرمة/جدة,أنشطة المعمارية والهندسية ، والاختبارات الفنية والتحليل,398,238,19,6,661
2022,1,مكتب منطقة مكة المكرمة/جدة,أنشطة المكاتب الرئيسية ، وألأنشطة الاستشارية في مجال الإدارة,354,171,3,0,528
2022,1,مكتب منطقة مكة المكرمة/جدة,أنشطة المكتبات ودور المحفوظات، والمتاحف والأنشطة الثقافية الأخرى,63,44,3,1,111
2022,1,مكتب منطقة مكة المكرمة/جدة,أنشطة المنظمات الدولية,1,1,1,0,3
2022,1,مكتب منطقة مكة المكرمة/جدة,أنشطة المنظمات ذات العضوية,34,13,0,0,47
2022,1,مكتب منطقة مكة المكرمة/جدة,أنشطة النشر,90,19,3,0,112
2022,1,مكتب منطقة مكة المكرمة/جدة,أنشطة تقديم الخدمات للمباني وتجميل المواقع,1902,854,84,33,2873
2022,1,مكتب منطقة مكة المكرمة/جدة,أنشطة جمع النفايات ومعالجتها وتصريفها ، واسترجاع المواد,29,9,2,0,40
2022,1,مكتب منطقة مكة المكرمة/جدة,أنشطة خدمات الأطعمة والمشروبات,6381,1981,243,31,8636
2022,1,مكتب منطقة مكة المكرمة/جدة,أنشطة خدمات المعلومات,119,39,4,0,162
2022,1,مكتب منطقة مكة المكرمة/جدة,أنشطة خدمات دعم التعدين,40,22,5,5,72
2022,1,مكتب منطقة مكة المكرمة/جدة,أنشطة زراعة المحاصيل والإنتاج الحيواني والصيد والخدمات المتصلة,583,89,8,2,682
2022,1,مكتب منطقة مكة المكرمة/جدة,استخراج النفط الخام والغاز الطبيعي,2,0,0,0,2
2022,1,مكتب منطقة مكة المكرمة/جدة,الإدارة العامة والدفاع ؛ والضمان الاجتماعي الإلزامي,284,153,17,2,456
2022,1,مكتب منطقة مكة المكرمة/جدة,الإقامة,394,305,37,6,742
2022,1,مكتب منطقة مكة المكرمة/جدة,الأنشطة الإبداعية والفنون وأنشطة الترفيه,62,14,1,0,77
2022,1,مكتب منطقة مكة المكرمة/جدة,الأنشطة الأخرى للتعدين واستغلال المحاجر,54,17,4,2,77
2022,1,مكتب منطقة مكة المكرمة/جدة,الأنشطة الإدارية للمكاتب ، وأنشطة الدعم للمكاتب وغير ذلك من أنشطة الدعم للأعمال,551,62,9,0,622
2022,1,مكتب منطقة مكة المكرمة/جدة,الأنشطة الإيجارية,1128,144,14,3,1289
2022,1,مكتب منطقة مكة المكرمة/جدة,الأنشطة البيطرية,23,17,3,0,43
2022,1,مكتب منطقة مكة المكرمة/جدة,الأنشطة الرياضية وأنشطة التسلية والترفيه,290,100,10,1,401
2022,1,مكتب منطقة مكة المكرمة/جدة,الأنشطة العقارية,677,219,33,1,930
2022,1,مكتب منطقة مكة المكرمة/جدة,الأنشطة القانونية وأنشطة المحاسبة,262,96,7,1,366
2022,1,مكتب منطقة مكة المكرمة/جدة,الأنشطة المساعدة لأنشطة الخدمات المالية وأنشطة التأمين,25,17,7,0,49
2022,1,مكتب منطقة مكة المكرمة/جدة,الأنشطة المهنية والعلمية والتقنية الأخرى,206,28,1,0,235
2022,1,مكتب منطقة مكة المكرمة/جدة,الأنشطة غير المتميزة لإنتاج السلع والخدمات التي تقوم بها الأسر المعيشية الخاصة لإستعمالها الخاص,2,0,0,0,2
2022,1,مكتب منطقة مكة المكرمة/جدة,الاتصالات,144,47,4,0,195
2022,1,مكتب منطقة مكة المكرمة/جدة,البحث والتطوير في المجال العلمي,13,4,2,0,19
2022,1,مكتب منطقة مكة المكرمة/جدة,التخزين وأنشطة الدعم للنقل,425,195,43,11,674
2022,1,مكتب منطقة مكة المكرمة/جدة,التعليم,244,272,89,14,619
2022,1,مكتب منطقة مكة المكرمة/جدة,الحراجة وقطع الأخشاب,5,0,0,1,6
2022,1,مكتب منطقة مكة المكرمة/جدة,الرعاية مع الإقامة,11,11,0,0,22
2022,1,مكتب منطقة مكة المكرمة/جدة,الصحة البشرية,256,365,128,32,781
2022,1,مكتب منطقة مكة المكرمة/جدة,الصرف الصحي,11,14,2,1,28
2022,1,مكتب منطقة مكة المكرمة/جدة,الصناعة التحويلية الأخرى,97,82,8,3,190
2022,1,مكتب منطقة مكة المكرمة/جدة,الطباعة واستنساخ وسائط الأعلام المسجّلة,202,133,26,2,363
2022,1,مكتب منطقة مكة المكرمة/جدة,النقل البري و النقل عبر الأنابيب,1335,377,57,12,1781
2022,1,مكتب منطقة مكة المكرمة/جدة,النقل الجوي,45,51,18,10,124
2022,1,مكتب منطقة مكة المكرمة/جدة,النقل المائي,72,38,10,4,124
2022,1,مكتب منطقة مكة المكرمة/جدة,الهندسة المدنية,98,38,14,1,151
2022,1,مكتب منطقة مكة المكرمة/جدة,تجارة التجزئة، باستثناء المركبات ذات المحركات والدراجات النارية,11216,3099,281,67,14663
2022,1,مكتب منطقة مكة المكرمة/جدة,تجارة الجملة ، باستثناء المركبات ذات المحركات والدراجات النارية,8915,4528,482,90,14015
2022,1,مكتب منطقة مكة المكرمة/جدة,تجارة الجملة والتجزئة ، وإصلاح المركبات ذات المحركات والدراجات النارية,3282,831,57,19,4189
2022,1,مكتب منطقة مكة المكرمة/جدة,تجميع المياه ومعالجتها وتوصيلها,59,26,2,3,90
2022,1,مكتب منطقة مكة المكرمة/جدة,تشييد المباني,8372,3235,403,108,12118
2022,1,مكتب منطقة مكة المكرمة/جدة,تعدين الفحم والليغنيت,7,2,0,0,9
2022,1,مكتب منطقة مكة المكرمة/جدة,تعدين ركازات الفلزات,33,15,6,3,57
2022,1,مكتب منطقة مكة المكرمة/جدة,تمويل التأمين وإعادة التأمين وصناديق المعاشات التقاعدية باستثناء الضمان الاجتماعي الإلزامي,8,27,9,4,48
2022,1,مكتب منطقة مكة المكرمة/جدة,توصيل الكهرباء والغاز والبخار وتكييف الهواء,48,30,12,7,97
2022,1,مكتب منطقة مكة المكرمة/جدة,صناعة الآلات والمعدات غير المصنفة في موضع أخر,72,21,7,1,101
2022,1,مكتب منطقة مكة المكرمة/جدة,صناعة المركبات ذات المحركات والمركبات المقطورة ونصف المقطورة,70,28,6,0,104
2022,1,مكتب منطقة مكة المكرمة/جدة,صناعة معدات النقل الأخرى,58,20,2,2,82
2022,1,مكتب منطقة مكة المكرمة/جدة,صنع الأثاث,238,105,21,2,366
2022,1,مكتب منطقة مكة المكرمة/جدة,صنع الحواسيب والمنتجات الإلكترونية والبصرية,133,68,17,2,220
2022,1,مكتب منطقة مكة المكرمة/جدة,صُنع الخشب ومنتجات الخشب والفلين ، باستثناء الأثاث ، صُنع أصناف من القش ومواد الضفر,253,67,17,3,340
2022,1,مكتب منطقة مكة المكرمة/جدة,صنع الفلزات القاعدية,102,110,37,7,256
2022,1,مكتب منطقة مكة المكرمة/جدة,صُنع المشروبات,60,43,12,6,121
2022,1,مكتب منطقة مكة المكرمة/جدة,صنع المعدات الكهربائية,150,73,11,2,236
2022,1,مكتب منطقة مكة المكرمة/جدة,صُنع الملبوسات,1052,186,13,2,1253
2022,1,مكتب منطقة مكة المكرمة/جدة,صُنع المنتجات الجلدية والمنتجات ذات الصلة,14,10,2,0,26
2022,1,مكتب منطقة مكة المكرمة/جدة,صنع المنتجات الصيدلانية الأساسية والمستحضرات الصيدلانية,13,11,7,1,32
2022,1,مكتب منطقة مكة المكرمة/جدة,صُنع المنتجات الغذائية,730,387,66,23,1206
2022,1,مكتب منطقة مكة المكرمة/جدة,صُنع المنسوجات,81,37,15,2,135
2022,1,مكتب منطقة مكة المكرمة/جدة,صُنع المواد الكيميائية والمنتجات الكيميائية,216,137,37,4,394
2022,1,مكتب منطقة مكة المكرمة/جدة,صُنع الورق ومنتجات الورق,38,46,12,5,101
2022,1,مكتب منطقة مكة المكرمة/جدة,صنع فحم الكوك والمنتجات النفطية المكررة,11,14,3,0,28
2022,1,مكتب منطقة مكة المكرمة/جدة,صُنع منتجات التبغ,5,3,0,0,8
2022,1,مكتب منطقة مكة المكرمة/جدة,صنع منتجات المطاط واللدائن,85,107,49,9,250
2022,1,مكتب منطقة مكة المكرمة/جدة,صنع منتجات المعادن اللافلزية الأخرى,160,97,31,13,301
2022,1,مكتب منطقة مكة المكرمة/جدة,صنع منتجات المعادن المشكلة ( باستثناء الآلات والمعدات ),315,116,40,8,479
2022,1,مكتب منطقة مكة المكرمة/جدة,صيد الأسماك وتربية المائيات,196,57,0,0,253
2022,1,مكتب منطقة مكة المكرمة/جدة,وكالات السفر ومشغّلو الجولات السياحية وخدمات الحجز والأنشطة المتصلة بها,175,89,8,0,272
2022,1,مكتب منطقة نجران,أبحاث الإعلان والسوق,11,2,0,0,13
2022,1,مكتب منطقة نجران,إصلاح أجهزة الحاسوب والسلع الشخصية والمنزلية,68,6,0,0,74
2022,1,مكتب منطقة نجران,إصلاح وتركيب الآلات والمعدات,41,5,0,1,47
2022,1,مكتب منطقة نجران,أنشطة أنتاج الأفلام والبرامج التلفزيونية والتسجيلات الصوتية و نشرالموسيقى,2,0,0,0,2
2022,1,مكتب منطقة نجران,أنشطة الأمن والتحقيقات,2,0,0,1,3
2022,1,مكتب منطقة نجران,أنشطة الاستخدام,16,3,0,0,19
2022,1,مكتب منطقة نجران,أنشطة الاسر المعيشية التي تستخدم أفراداً للعمل المنزلي,5,0,0,0,5
2022,1,مكتب منطقة نجران,أنشطة البرمجة الحاسوبية والخبرة الاستشارية وما يتصل بها من أنشطة,5,1,0,0,6
2022,1,مكتب منطقة نجران,أنشطة البريد ونقل الرسائل والطرود بواسطة مندوبين,1,0,0,0,1
2022,1,مكتب منطقة نجران,أنشطة التشييد المتخصصة,1436,238,11,6,1691
2022,1,مكتب منطقة نجران,أنشطة الخدمات الشخصية الأخرى,534,38,0,0,572
2022,1,مكتب منطقة نجران,أنشطة الخدمات المالية ، فيما عدا تمويل التأمين وصناديق المعاشات,20,1,0,0,21
2022,1,مكتب منطقة نجران,أنشطة العمل الاجتماعي، دون إقامة، لكبار السن وذوي الإعاقة,21,6,0,0,27
2022,1,مكتب منطقة نجران,أنشطة المعالجة وخدمات إدارة النفايات الأخرى,0,1,0,0,1
2022,1,مكتب منطقة نجران,أنشطة المعمارية والهندسية ، والاختبارات الفنية والتحليل,50,18,2,0,70
2022,1,مكتب منطقة نجران,أنشطة المكاتب الرئيسية ، وألأنشطة الاستشارية في مجال الإدارة,13,2,0,0,15
2022,1,مكتب منطقة نجران,أنشطة المكتبات ودور المحفوظات، والمتاحف والأنشطة الثقافية الأخرى,23,2,0,0,25
2022,1,مكتب منطقة نجران,أنشطة المنظمات الدولية,2,0,0,0,2
2022,1,مكتب منطقة نجران,أنشطة المنظمات ذات العضوية,18,0,0,0,18
2022,1,مكتب منطقة نجران,أنشطة النشر,16,4,0,0,20
2022,1,مكتب منطقة نجران,أنشطة تقديم الخدمات للمباني وتجميل المواقع,185,30,4,4,223
2022,1,مكتب منطقة نجران,أنشطة جمع النفايات ومعالجتها وتصريفها ، واسترجاع المواد,4,0,0,0,4
2022,1,مكتب منطقة نجران,أنشطة خدمات الأطعمة والمشروبات,1241,235,14,2,1492
2022,1,مكتب منطقة نجران,أنشطة خدمات المعلومات,1,1,0,0,2
2022,1,مكتب منطقة نجران,أنشطة خدمات دعم التعدين,4,3,0,0,7
2022,1,مكتب منطقة نجران,أنشطة زراعة المحاصيل والإنتاج الحيواني والصيد والخدمات المتصلة,852,24,4,0,880
2022,1,مكتب منطقة نجران,استخراج النفط الخام والغاز الطبيعي,2,0,0,0,2
2022,1,مكتب منطقة نجران,الإدارة العامة والدفاع ؛ والضمان الاجتماعي الإلزامي,51,17,1,0,69
2022,1,مكتب منطقة نجران,الإقامة,81,22,1,1,105
2022,1,مكتب منطقة نجران,الأنشطة الإبداعية والفنون وأنشطة الترفيه,3,0,0,0,3
2022,1,مكتب منطقة نجران,الأنشطة الأخرى للتعدين واستغلال المحاجر,7,0,0,0,7
2022,1,مكتب منطقة نجران,الأنشطة الإدارية للمكاتب ، وأنشطة الدعم للمكاتب وغير ذلك من أنشطة الدعم للأعمال,39,2,0,0,41
2022,1,مكتب منطقة نجران,الأنشطة الإيجارية,1240,73,2,1,1316
2022,1,مكتب منطقة نجران,الأنشطة البيطرية,3,3,0,0,6
2022,1,مكتب منطقة نجران,الأنشطة الرياضية وأنشطة التسلية والترفيه,24,13,0,1,38
2022,1,مكتب منطقة نجران,الأنشطة العقارية,33,4,0,0,37
2022,1,مكتب منطقة نجران,الأنشطة القانونية وأنشطة المحاسبة,4,0,0,0,4
2022,1,مكتب منطقة نجران,الأنشطة المساعدة لأنشطة الخدمات المالية وأنشطة التأمين,0,1,0,0,1
2022,1,مكتب منطقة نجران,الأنشطة المهنية والعلمية والتقنية الأخرى,20,0,0,0,20
2022,1,مكتب منطقة نجران,الاتصالات,18,1,0,0,19
2022,1,مكتب منطقة نجران,التخزين وأنشطة الدعم للنقل,235,64,2,0,301
2022,1,مكتب منطقة نجران,التعليم,16,16,6,0,38
2022,1,مكتب منطقة نجران,الرعاية مع الإقامة,3,1,0,0,4
2022,1,مكتب منطقة نجران,الصحة البشرية,17,48,12,1,78
2022,1,مكتب منطقة نجران,الصناعة التحويلية الأخرى,6,1,1,0,8
2022,1,مكتب منطقة نجران,الطباعة واستنساخ وسائط الأعلام المسجّلة,10,2,0,0,12
2022,1,مكتب منطقة نجران,النقل البري و النقل عبر الأنابيب,813,88,0,1,902
2022,1,مكتب منطقة نجران,النقل الجوي,6,3,0,0,9
2022,1,مكتب منطقة نجران,النقل المائي,11,1,0,0,12
2022,1,مكتب منطقة نجران,الهندسة المدنية,11,4,4,3,22
2022,1,مكتب منطقة نجران,تجارة التجزئة، باستثناء المركبات ذات المحركات والدراجات النارية,1591,361,23,2,1977
2022,1,مكتب منطقة نجران,تجارة الجملة ، باستثناء المركبات ذات المحركات والدراجات النارية,470,99,11,1,581
2022,1,مكتب منطقة نجران,تجارة الجملة والتجزئة ، وإصلاح المركبات ذات المحركات والدراجات النارية,550,110,3,0,663
2022,1,مكتب منطقة نجران,تجميع المياه ومعالجتها وتوصيلها,19,5,0,0,24
2022,1,مكتب منطقة نجران,تشييد المباني,2376,535,69,13,2993
2022,1,مكتب منطقة نجران,تعدين الفحم والليغنيت,1,0,0,0,1
2022,1,مكتب منطقة نجران,تعدين ركازات الفلزات,10,1,1,0,12
2022,1,مكتب منطقة نجران,توصيل الكهرباء والغاز والبخار وتكييف الهواء,3,1,1,0,5
2022,1,مكتب منطقة نجران,صناعة الآلات والمعدات غير المصنفة في موضع أخر,10,2,0,0,12
2022,1,مكتب منطقة نجران,صناعة المركبات ذات المحركات والمركبات المقطورة ونصف المقطورة,15,2,0,0,17
2022,1,مكتب منطقة نجران,صناعة معدات النقل الأخرى,8,3,0,0,11
2022,1,مكتب منطقة نجران,صنع الأثاث,85,22,1,0,108
2022,1,مكتب منطقة نجران,صنع الحواسيب والمنتجات الإلكترونية والبصرية,15,2,0,0,17
2022,1,مكتب منطقة نجران,صُنع الخشب ومنتجات الخشب والفلين ، باستثناء الأثاث ، صُنع أصناف من القش ومواد الضفر,77,9,0,0,86
2022,1,مكتب منطقة نجران,صنع الفلزات القاعدية,81,17,1,1,100
2022,1,مكتب منطقة نجران,صُنع المشروبات,5,0,1,0,6
2022,1,مكتب منطقة نجران,صنع المعدات الكهربائية,14,2,0,0,16
2022,1,مكتب منطقة نجران,صُنع الملبوسات,311,26,0,0,337
2022,1,مكتب منطقة نجران,صُنع المنتجات الجلدية والمنتجات ذات الصلة,4,0,0,0,4
2022,1,مكتب منطقة نجران,صنع المنتجات الصيدلانية الأساسية والمستحضرات الصيدلانية,3,0,0,0,3
2022,1,مكتب منطقة نجران,صُنع المنتجات الغذائية,134,25,1,0,160
2022,1,مكتب منطقة نجران,صُنع المنسوجات,35,7,0,0,42
2022,1,مكتب منطقة نجران,صُنع المواد الكيميائية والمنتجات الكيميائية,17,5,1,0,23
2022,1,مكتب منطقة نجران,صُنع الورق ومنتجات الورق,14,3,1,0,18
2022,1,مكتب منطقة نجران,صنع منتجات المطاط واللدائن,21,2,0,0,23
2022,1,مكتب منطقة نجران,صنع منتجات المعادن اللافلزية الأخرى,61,20,7,1,89
2022,1,مكتب منطقة نجران,صنع منتجات المعادن المشكلة ( باستثناء الآلات والمعدات ),155,22,4,0,181
2022,1,مكتب منطقة نجران,صيد الأسماك وتربية المائيات,37,1,0,0,38
2022,1,مكتب منطقة نجران,وكالات السفر ومشغّلو الجولات السياحية وخدمات الحجز والأنشطة المتصلة بها,6,2,0,0,8
2022,1,المركز الرئيسي,أنشطة التشييد المتخصصة,1,0,0,0,1
2022,1,المركز الرئيسي,أنشطة الخدمات الشخصية الأخرى,1,0,0,0,1
2022,1,المركز الرئيسي,أنشطة خدمات الأطعمة والمشروبات,4,1,0,0,5
2022,1,المركز الرئيسي,أنشطة زراعة المحاصيل والإنتاج الحيواني والصيد والخدمات المتصلة,2,2,0,0,4
2022,1,المركز الرئيسي,الأنشطة الإيجارية,2,0,0,0,2
2022,1,المركز الرئيسي,الأنشطة القانونية وأنشطة المحاسبة,1,0,0,0,1
2022,1,المركز الرئيسي,التخزين وأنشطة الدعم للنقل,1,0,0,0,1
2022,1,المركز الرئيسي,النقل البري و النقل عبر الأنابيب,1,0,0,0,1
2022,1,المركز الرئيسي,تجارة التجزئة، باستثناء المركبات ذات المحركات والدراجات النارية,5,0,0,0,5
2022,1,المركز الرئيسي,تجارة الجملة ، باستثناء المركبات ذات المحركات والدراجات النارية,1,0,0,0,1
2022,1,المركز الرئيسي,تجارة الجملة والتجزئة ، وإصلاح المركبات ذات المحركات والدراجات النارية,1,0,0,0,1
2022,1,المركز الرئيسي,تشييد المباني,2,1,0,0,3
2022,1,المركز الرئيسي,صُنع الملبوسات,1,0,0,0,1
2022,1,المركز الرئيسي,صُنع المنتجات الغذائية,0,1,0,0,1
2022,1,المركز الرئيسي,صيد الأسماك وتربية المائيات,0,1,0,0,1
2022,1,مكتب المنطقة الشرقية,أبحاث الإعلان والسوق,177,33,1,0,211
2022,1,مكتب المنطقة الشرقية,إصلاح أجهزة الحاسوب والسلع الشخصية والمنزلية,332,67,8,2,409
2022,1,مكتب المنطقة الشرقية,إصلاح وتركيب الآلات والمعدات,251,95,8,2,356
2022,1,مكتب المنطقة الشرقية,أنشطة أنتاج الأفلام والبرامج التلفزيونية والتسجيلات الصوتية و نشرالموسيقى,28,7,0,0,35
2022,1,مكتب المنطقة الشرقية,أنشطة الأمن والتحقيقات,26,23,9,6,64
2022,1,مكتب المنطقة الشرقية,أنشطة الاستخدام,97,23,6,6,132
2022,1,مكتب المنطقة الشرقية,أنشطة الاسر المعيشية التي تستخدم أفراداً للعمل المنزلي,3,0,0,0,3
2022,1,مكتب المنطقة الشرقية,أنشطة البرمجة الحاسوبية والخبرة الاستشارية وما يتصل بها من أنشطة,148,55,9,1,213
2022,1,مكتب المنطقة الشرقية,أنشطة البرمجة والإذاعة,1,1,0,0,2
2022,1,مكتب المنطقة الشرقية,أنشطة البريد ونقل الرسائل والطرود بواسطة مندوبين,17,2,1,0,20
2022,1,مكتب المنطقة الشرقية,أنشطة التشييد المتخصصة,2910,1029,123,20,4082
2022,1,مكتب المنطقة الشرقية,أنشطة الخدمات الشخصية الأخرى,2398,401,27,3,2829
2022,1,مكتب المنطقة الشرقية,أنشطة الخدمات المالية ، فيما عدا تمويل التأمين وصناديق المعاشات,48,18,6,1,73
2022,1,مكتب المنطقة الشرقية,أنشطة العمل الاجتماعي، دون إقامة، لكبار السن وذوي الإعاقة,75,77,4,0,156
2022,1,مكتب المنطقة الشرقية,أنشطة المعالجة وخدمات إدارة النفايات الأخرى,3,2,1,0,6
2022,1,مكتب المنطقة الشرقية,أنشطة المعمارية والهندسية ، والاختبارات الفنية والتحليل,210,174,41,19,444
2022,1,مكتب المنطقة الشرقية,أنشطة المكاتب الرئيسية ، وألأنشطة الاستشارية في مجال الإدارة,164,57,8,1,230
2022,1,مكتب المنطقة الشرقية,أنشطة المكتبات ودور المحفوظات، والمتاحف والأنشطة الثقافية الأخرى,51,25,0,0,76
2022,1,مكتب المنطقة الشرقية,أنشطة المنظمات الدولية,0,1,0,0,1
2022,1,مكتب المنطقة الشرقية,أنشطة المنظمات ذات العضوية,23,4,1,0,28
2022,1,مكتب المنطقة الشرقية,أنشطة النشر,37,12,0,0,49
2022,1,مكتب المنطقة الشرقية,أنشطة تقديم الخدمات للمباني وتجميل المواقع,1452,772,121,42,2387
2022,1,مكتب المنطقة الشرقية,أنشطة جمع النفايات ومعالجتها وتصريفها ، واسترجاع المواد,17,18,2,2,39
2022,1,مكتب المنطقة الشرقية,أنشطة خدمات الأطعمة والمشروبات,4136,1638,172,23,5969
2022,1,مكتب المنطقة الشرقية,أنشطة خدمات المعلومات,49,19,1,0,69
2022,1,مكتب المنطقة الشرقية,أنشطة خدمات دعم التعدين,129,128,67,39,363
2022,1,مكتب المنطقة الشرقية,أنشطة زراعة المحاصيل والإنتاج الحيواني والصيد والخدمات المتصلة,531,63,8,0,602
2022,1,مكتب المنطقة الشرقية,استخراج النفط الخام والغاز الطبيعي,1,1,1,0,3
2022,1,مكتب المنطقة الشرقية,الإدارة العامة والدفاع ؛ والضمان الاجتماعي الإلزامي,188,114,28,4,334
2022,1,مكتب المنطقة الشرقية,الإقامة,178,165,19,1,363
2022,1,مكتب المنطقة الشرقية,الأنشطة الإبداعية والفنون وأنشطة الترفيه,19,0,0,0,19
2022,1,مكتب المنطقة الشرقية,الأنشطة الأخرى للتعدين واستغلال المحاجر,46,30,10,1,87
2022,1,مكتب المنطقة الشرقية,الأنشطة الإدارية للمكاتب ، وأنشطة الدعم للمكاتب وغير ذلك من أنشطة الدعم للأعمال,222,37,2,1,262
2022,1,مكتب المنطقة الشرقية,الأنشطة الإيجارية,719,143,24,5,891
2022,1,مكتب المنطقة الشرقية,الأنشطة البيطرية,10,7,2,0,19
2022,1,مكتب المنطقة الشرقية,الأنشطة الرياضية وأنشطة التسلية والترفيه,174,69,3,1,247
2022,1,مكتب المنطقة الشرقية,الأنشطة العقارية,295,138,11,1,445
2022,1,مكتب المنطقة الشرقية,الأنشطة القانونية وأنشطة المحاسبة,114,47,3,0,164
2022,1,مكتب المنطقة الشرقية,الأنشطة المساعدة لأنشطة الخدمات المالية وأنشطة التأمين,12,13,2,1,28
2022,1,مكتب المنطقة الشرقية,الأنشطة المهنية والعلمية والتقنية الأخرى,97,17,0,0,114
2022,1,مكتب المنطقة الشرقية,الأنشطة غير المتميزة لإنتاج السلع والخدمات التي تقوم بها الأسر المعيشية الخاصة لإستعمالها الخاص,1,1,0,0,2
2022,1,مكتب المنطقة الشرقية,الاتصالات,63,18,0,0,81
2022,1,مكتب المنطقة الشرقية,البحث والتطوير في المجال العلمي,4,3,1,0,8
2022,1,مكتب المنطقة الشرقية,التخزين وأنشطة الدعم للنقل,335,131,34,3,503
2022,1,مكتب المنطقة الشرقية,التعليم,165,175,55,13,408
2022,1,مكتب المنطقة الشرقية,الحراجة وقطع الأخشاب,2,1,0,0,3
2022,1,مكتب المنطقة الشرقية,الرعاية مع الإقامة,9,6,0,1,16
2022,1,مكتب المنطقة الشرقية,الصحة البشرية,105,161,58,25,349
2022,1,مكتب المنطقة الشرقية,الصرف الصحي,11,9,1,1,22
2022,1,مكتب المنطقة الشرقية,الصناعة التحويلية الأخرى,70,41,4,0,115
2022,1,مكتب المنطقة الشرقية,الطباعة واستنساخ وسائط الأعلام المسجّلة,105,79,7,0,191
2022,1,مكتب المنطقة الشرقية,النقل البري و النقل عبر الأنابيب,1054,347,80,24,1505
2022,1,مكتب المنطقة الشرقية,النقل الجوي,73,71,30,6,180
2022,1,مكتب المنطقة الشرقية,النقل المائي,31,19,6,0,56
2022,1,مكتب المنطقة الشرقية,الهندسة المدنية,126,75,24,3,228
2022,1,مكتب المنطقة الشرقية,تجارة التجزئة، باستثناء المركبات ذات المحركات والدراجات النارية,6213,2005,203,38,8459
2022,1,مكتب المنطقة الشرقية,تجارة الجملة ، باستثناء المركبات ذات المحركات والدراجات النارية,2778,1422,209,49,4458
2022,1,مكتب المنطقة الشرقية,تجارة الجملة والتجزئة ، وإصلاح المركبات ذات المحركات والدراجات النارية,2529,800,37,5,3371
2022,1,مكتب المنطقة الشرقية,تجميع المياه ومعالجتها وتوصيلها,30,14,1,1,46
2022,1,مكتب المنطقة الشرقية,تشييد المباني,4636,2682,552,210,8080
2022,1,مكتب المنطقة الشرقية,تعدين الفحم والليغنيت,5,0,0,0,5
2022,1,مكتب المنطقة الشرقية,تعدين ركازات الفلزات,90,76,11,1,178
2022,1,مكتب المنطقة الشرقية,تمويل التأمين وإعادة التأمين وصناديق المعاشات التقاعدية باستثناء الضمان الاجتماعي الإلزامي,5,12,3,3,23
2022,1,مكتب المنطقة الشرقية,توصيل الكهرباء والغاز والبخار وتكييف الهواء,40,53,15,4,112
2022,1,مكتب المنطقة الشرقية,صناعة الآلات والمعدات غير المصنفة في موضع أخر,46,42,10,2,100
2022,1,مكتب المنطقة الشرقية,صناعة المركبات ذات المحركات والمركبات المقطورة ونصف المقطورة,21,12,1,0,34
2022,1,مكتب المنطقة الشرقية,صناعة معدات النقل الأخرى,20,14,3,1,38
2022,1,مكتب المنطقة الشرقية,صنع الأثاث,317,116,9,1,443
2022,1,مكتب المنطقة الشرقية,صنع الحواسيب والمنتجات الإلكترونية والبصرية,104,47,9,3,163
2022,1,مكتب المنطقة الشرقية,صُنع الخشب ومنتجات الخشب والفلين ، باستثناء الأثاث ، صُنع أصناف من القش ومواد الضفر,297,164,19,5,485
2022,1,مكتب المنطقة الشرقية,صنع الفلزات القاعدية,118,112,50,11,291
2022,1,مكتب المنطقة الشرقية,صُنع المشروبات,20,17,3,1,41
2022,1,مكتب المنطقة الشرقية,صنع المعدات الكهربائية,181,78,16,3,278
2022,1,مكتب المنطقة الشرقية,صُنع الملبوسات,813,178,5,0,996
2022,1,مكتب المنطقة الشرقية,صُنع المنتجات الجلدية والمنتجات ذات الصلة,6,1,0,0,7
2022,1,مكتب المنطقة الشرقية,صنع المنتجات الصيدلانية الأساسية والمستحضرات الصيدلانية,5,3,3,0,11
2022,1,مكتب المنطقة الشرقية,صُنع المنتجات الغذائية,481,228,53,10,772
2022,1,مكتب المنطقة الشرقية,صُنع المنسوجات,155,81,8,0,244
2022,1,مكتب المنطقة الشرقية,صُنع المواد الكيميائية والمنتجات الكيميائية,131,81,16,0,228
2022,1,مكتب المنطقة الشرقية,صُنع الورق ومنتجات الورق,28,20,10,3,61
2022,1,مكتب المنطقة الشرقية,صنع فحم الكوك والمنتجات النفطية المكررة,14,13,4,2,33
2022,1,مكتب المنطقة الشرقية,صُنع منتجات التبغ,2,1,0,0,3
2022,1,مكتب المنطقة الشرقية,صنع منتجات المطاط واللدائن,55,85,61,9,210
2022,1,مكتب المنطقة الشرقية,صنع منتجات المعادن اللافلزية الأخرى,179,119,36,9,343
2022,1,مكتب المنطقة الشرقية,صنع منتجات المعادن المشكلة ( باستثناء الآلات والمعدات ),427,268,73,17,785
2022,1,مكتب المنطقة الشرقية,صيد الأسماك وتربية المائيات,281,169,5,0,455
2022,1,مكتب المنطقة الشرقية,وكالات السفر ومشغّلو الجولات السياحية وخدمات الحجز والأنشطة المتصلة بها,83,37,7,0,127
2022,1,مكتب محافظة الأحساء,أبحاث الإعلان والسوق,22,5,0,0,27
2022,1,مكتب محافظة الأحساء,إصلاح أجهزة الحاسوب والسلع الشخصية والمنزلية,136,20,2,0,158
2022,1,مكتب محافظة الأحساء,إصلاح وتركيب الآلات والمعدات,73,5,0,0,78
2022,1,مكتب محافظة الأحساء,أنشطة أنتاج الأفلام والبرامج التلفزيونية والتسجيلات الصوتية و نشرالموسيقى,8,0,0,0,8
2022,1,مكتب محافظة الأحساء,أنشطة الأمن والتحقيقات,5,1,1,1,8
2022,1,مكتب محافظة الأحساء,أنشطة الاستخدام,30,4,0,0,34
2022,1,مكتب محافظة الأحساء,أنشطة الاسر المعيشية التي تستخدم أفراداً للعمل المنزلي,1,0,0,0,1
2022,1,مكتب محافظة الأحساء,أنشطة البرمجة الحاسوبية والخبرة الاستشارية وما يتصل بها من أنشطة,9,4,0,0,13
2022,1,مكتب محافظة الأحساء,أنشطة البرمجة والإذاعة,1,0,0,0,1
2022,1,مكتب محافظة الأحساء,أنشطة البريد ونقل الرسائل والطرود بواسطة مندوبين,1,2,0,0,3
2022,1,مكتب محافظة الأحساء,أنشطة التشييد المتخصصة,982,209,10,2,1203
2022,1,مكتب محافظة الأحساء,أنشطة الخدمات الشخصية الأخرى,1008,128,3,1,1140
2022,1,مكتب محافظة الأحساء,أنشطة الخدمات المالية ، فيما عدا تمويل التأمين وصناديق المعاشات,23,2,1,0,26
2022,1,مكتب محافظة الأحساء,أنشطة العمل الاجتماعي، دون إقامة، لكبار السن وذوي الإعاقة,21,21,2,0,44
2022,1,مكتب محافظة الأحساء,أنشطة المعالجة وخدمات إدارة النفايات الأخرى,0,1,0,0,1
2022,1,مكتب محافظة الأحساء,أنشطة المعمارية والهندسية ، والاختبارات الفنية والتحليل,35,33,4,0,72
2022,1,مكتب محافظة الأحساء,أنشطة المكاتب الرئيسية ، وألأنشطة الاستشارية في مجال الإدارة,29,3,0,0,32
2022,1,مكتب محافظة الأحساء,أنشطة المكتبات ودور المحفوظات، والمتاحف والأنشطة الثقافية الأخرى,33,9,0,0,42
2022,1,مكتب محافظة الأحساء,أنشطة المنظمات ذات العضوية,6,1,1,0,8
2022,1,مكتب محافظة الأحساء,أنشطة النشر,3,1,0,0,4
2022,1,مكتب محافظة الأحساء,أنشطة تقديم الخدمات للمباني وتجميل المواقع,191,55,3,0,249
2022,1,مكتب محافظة الأحساء,أنشطة جمع النفايات ومعالجتها وتصريفها ، واسترجاع المواد,3,2,0,0,5
2022,1,مكتب محافظة الأحساء,أنشطة خدمات الأطعمة والمشروبات,1480,588,29,1,2098
2022,1,مكتب محافظة الأحساء,أنشطة خدمات المعلومات,8,2,0,0,10
2022,1,مكتب محافظة الأحساء,أنشطة خدمات دعم التعدين,8,13,0,0,21
2022,1,مكتب محافظة الأحساء,أنشطة زراعة المحاصيل والإنتاج الحيواني والصيد والخدمات المتصلة,436,47,6,0,489
2022,1,مكتب محافظة الأحساء,الإدارة العامة والدفاع ؛ والضمان الاجتماعي الإلزامي,27,14,1,0,42
2022,1,مكتب محافظة الأحساء,الإقامة,56,26,4,0,86
2022,1,مكتب محافظة الأحساء,الأنشطة الإبداعية والفنون وأنشطة الترفيه,6,1,0,0,7
2022,1,مكتب محافظة الأحساء,الأنشطة الأخرى للتعدين واستغلال المحاجر,17,2,0,0,19
2022,1,مكتب محافظة الأحساء,الأنشطة الإدارية للمكاتب ، وأنشطة الدعم للمكاتب وغير ذلك من أنشطة الدعم للأعمال,49,10,0,0,59
2022,1,مكتب محافظة الأحساء,الأنشطة الإيجارية,320,45,5,2,372
2022,1,مكتب محافظة الأحساء,الأنشطة البيطرية,6,1,0,0,7
2022,1,مكتب محافظة الأحساء,الأنشطة الرياضية وأنشطة التسلية والترفيه,38,15,1,0,54
2022,1,مكتب محافظة الأحساء,الأنشطة العقارية,43,9,1,0,53
2022,1,مكتب محافظة الأحساء,الأنشطة القانونية وأنشطة المحاسبة,14,2,1,0,17
2022,1,مكتب محافظة الأحساء,الأنشطة المساعدة لأنشطة الخدمات المالية وأنشطة التأمين,2,0,0,0,2
2022,1,مكتب محافظة الأحساء,الأنشطة المهنية والعلمية والتقنية الأخرى,35,1,0,0,36
2022,1,مكتب محافظة الأحساء,الاتصالات,21,5,0,0,26
2022,1,مكتب محافظة الأحساء,التخزين وأنشطة الدعم للنقل,69,18,1,0,88
2022,1,مكتب محافظة الأحساء,التعليم,40,31,12,1,84
2022,1,مكتب محافظة الأحساء,الرعاية مع الإقامة,3,0,1,0,4
2022,1,مكتب محافظة الأحساء,الصحة البشرية,35,59,14,6,114
2022,1,مكتب محافظة الأحساء,الصرف الصحي,2,0,0,0,2
2022,1,مكتب محافظة الأحساء,الصناعة التحويلية الأخرى,24,3,0,0,27
2022,1,مكتب محافظة الأحساء,الطباعة واستنساخ وسائط الأعلام المسجّلة,35,6,1,1,43
2022,1,مكتب محافظة الأحساء,النقل البري و النقل عبر الأنابيب,254,42,8,2,306
2022,1,مكتب محافظة الأحساء,النقل الجوي,12,4,1,0,17
2022,1,مكتب محافظة الأحساء,النقل المائي,3,0,0,0,3
2022,1,مكتب محافظة الأحساء,الهندسة المدنية,21,8,3,2,34
2022,1,مكتب محافظة الأحساء,تجارة التجزئة، باستثناء المركبات ذات المحركات والدراجات النارية,2112,473,34,3,2622
2022,1,مكتب محافظة الأحساء,تجارة الجملة ، باستثناء المركبات ذات المحركات والدراجات النارية,573,146,10,2,731
2022,1,مكتب محافظة الأحساء,تجارة الجملة والتجزئة ، وإصلاح المركبات ذات المحركات والدراجات النارية,852,204,7,0,1063
2022,1,مكتب محافظة الأحساء,تجميع المياه ومعالجتها وتوصيلها,12,6,0,0,18
2022,1,مكتب محافظة الأحساء,تشييد المباني,1664,645,54,14,2377
2022,1,مكتب محافظة الأحساء,تعدين الفحم والليغنيت,2,1,0,0,3
2022,1,مكتب محافظة الأحساء,تعدين ركازات الفلزات,27,8,1,1,37
2022,1,مكتب محافظة الأحساء,تمويل التأمين وإعادة التأمين وصناديق المعاشات التقاعدية باستثناء الضمان الاجتماعي الإلزامي,0,1,0,0,1
2022,1,مكتب محافظة الأحساء,توصيل الكهرباء والغاز والبخار وتكييف الهواء,11,4,0,0,15
2022,1,مكتب محافظة الأحساء,صناعة الآلات والمعدات غير المصنفة في موضع أخر,17,6,1,0,24
2022,1,مكتب محافظة الأحساء,صناعة المركبات ذات المحركات والمركبات المقطورة ونصف المقطورة,10,1,0,0,11
2022,1,مكتب محافظة الأحساء,صناعة معدات النقل الأخرى,14,1,0,0,15
2022,1,مكتب محافظة الأحساء,صنع الأثاث,142,41,1,0,184
2022,1,مكتب محافظة الأحساء,صنع الحواسيب والمنتجات الإلكترونية والبصرية,88,22,0,0,110
2022,1,مكتب محافظة الأحساء,صُنع الخشب ومنتجات الخشب والفلين ، باستثناء الأثاث ، صُنع أصناف من القش ومواد الضفر,57,21,1,1,80
2022,1,مكتب محافظة الأحساء,صنع الفلزات القاعدية,57,13,0,0,70
2022,1,مكتب محافظة الأحساء,صُنع المشروبات,5,9,0,0,14
2022,1,مكتب محافظة الأحساء,صنع المعدات الكهربائية,52,20,2,0,74
2022,1,مكتب محافظة الأحساء,صُنع الملبوسات,532,69,2,0,603
2022,1,مكتب محافظة الأحساء,صُنع المنتجات الجلدية والمنتجات ذات الصلة,7,0,0,0,7
2022,1,مكتب محافظة الأحساء,صنع المنتجات الصيدلانية الأساسية والمستحضرات الصيدلانية,3,3,0,0,6
2022,1,مكتب محافظة الأحساء,صُنع المنتجات الغذائية,252,81,14,4,351
2022,1,مكتب محافظة الأحساء,صُنع المنسوجات,38,6,1,0,45
2022,1,مكتب محافظة الأحساء,صُنع المواد الكيميائية والمنتجات الكيميائية,32,6,5,0,43
2022,1,مكتب محافظة الأحساء,صُنع الورق ومنتجات الورق,3,2,1,0,6
2022,1,مكتب محافظة الأحساء,صنع فحم الكوك والمنتجات النفطية المكررة,0,2,1,0,3
2022,1,مكتب محافظة الأحساء,صُنع منتجات التبغ,2,1,0,0,3
2022,1,مكتب محافظة الأحساء,صنع منتجات المطاط واللدائن,12,6,4,1,23
2022,1,مكتب محافظة الأحساء,صنع منتجات المعادن اللافلزية الأخرى,64,43,12,0,119
2022,1,مكتب محافظة الأحساء,صنع منتجات المعادن المشكلة ( باستثناء الآلات والمعدات ),116,64,6,1,187
2022,1,مكتب محافظة الأحساء,صيد الأسماك وتربية المائيات,17,2,1,0,20
2022,1,مكتب محافظة الأحساء,وكالات السفر ومشغّلو الجولات السياحية وخدمات الحجز والأنشطة المتصلة بها,17,4,0,0,21
2022,1,مكتب محافظة الجبيل,أبحاث الإعلان والسوق,28,5,0,0,33
2022,1,مكتب محافظة الجبيل,إصلاح أجهزة الحاسوب والسلع الشخصية والمنزلية,51,14,2,1,68
2022,1,مكتب محافظة الجبيل,إصلاح وتركيب الآلات والمعدات,58,33,4,0,95
2022,1,مكتب محافظة الجبيل,أنشطة أنتاج الأفلام والبرامج التلفزيونية والتسجيلات الصوتية و نشرالموسيقى,4,0,0,0,4
2022,1,مكتب محافظة الجبيل,أنشطة الأمن والتحقيقات,7,0,2,0,9
2022,1,مكتب محافظة الجبيل,أنشطة الاستخدام,12,3,0,1,16
2022,1,مكتب محافظة الجبيل,أنشطة الاسر المعيشية التي تستخدم أفراداً للعمل المنزلي,1,0,0,0,1
2022,1,مكتب محافظة الجبيل,أنشطة البرمجة الحاسوبية والخبرة الاستشارية وما يتصل بها من أنشطة,11,5,0,0,16
2022,1,مكتب محافظة الجبيل,أنشطة البريد ونقل الرسائل والطرود بواسطة مندوبين,1,0,0,0,1
2022,1,مكتب محافظة الجبيل,أنشطة التشييد المتخصصة,804,312,32,18,1166
2022,1,مكتب محافظة الجبيل,أنشطة الخدمات الشخصية الأخرى,517,82,5,1,605
2022,1,مكتب محافظة الجبيل,أنشطة الخدمات المالية ، فيما عدا تمويل التأمين وصناديق المعاشات,10,2,1,0,13
2022,1,مكتب محافظة الجبيل,أنشطة العمل الاجتماعي، دون إقامة، لكبار السن وذوي الإعاقة,11,7,1,0,19
2022,1,مكتب محافظة الجبيل,أنشطة المعالجة وخدمات إدارة النفايات الأخرى,1,2,0,0,3
2022,1,مكتب محافظة الجبيل,أنشطة المعمارية والهندسية ، والاختبارات الفنية والتحليل,49,16,1,3,69
2022,1,مكتب محافظة الجبيل,أنشطة المكاتب الرئيسية ، وألأنشطة الاستشارية في مجال الإدارة,15,3,0,0,18
2022,1,مكتب محافظة الجبيل,أنشطة المكتبات ودور المحفوظات، والمتاحف والأنشطة الثقافية الأخرى,11,2,1,0,14
2022,1,مكتب محافظة الجبيل,أنشطة المنظمات الدولية,1,0,0,0,1
2022,1,مكتب محافظة الجبيل,أنشطة المنظمات ذات العضوية,2,3,1,0,6
2022,1,مكتب محافظة الجبيل,أنشطة النشر,32,4,0,0,36
2022,1,مكتب محافظة الجبيل,أنشطة تقديم الخدمات للمباني وتجميل المواقع,257,121,24,5,407
2022,1,مكتب محافظة الجبيل,أنشطة جمع النفايات ومعالجتها وتصريفها ، واسترجاع المواد,3,1,1,1,6
2022,1,مكتب محافظة الجبيل,أنشطة خدمات الأطعمة والمشروبات,1028,342,15,2,1387
2022,1,مكتب محافظة الجبيل,أنشطة خدمات المعلومات,4,1,0,0,5
2022,1,مكتب محافظة الجبيل,أنشطة خدمات دعم التعدين,21,22,10,10,63
2022,1,مكتب محافظة الجبيل,أنشطة زراعة المحاصيل والإنتاج الحيواني والصيد والخدمات المتصلة,407,25,2,0,434
2022,1,مكتب محافظة الجبيل,الإدارة العامة والدفاع ؛ والضمان الاجتماعي الإلزامي,16,6,3,0,25
2022,1,مكتب محافظة الجبيل,الإقامة,51,29,5,0,85
2022,1,مكتب محافظة الجبيل,الأنشطة الأخرى للتعدين واستغلال المحاجر,6,6,3,2,17
2022,1,مكتب محافظة الجبيل,الأنشطة الإدارية للمكاتب ، وأنشطة الدعم للمكاتب وغير ذلك من أنشطة الدعم للأعمال,29,2,0,0,31
2022,1,مكتب محافظة الجبيل,الأنشطة الإيجارية,421,44,4,1,470
2022,1,مكتب محافظة الجبيل,الأنشطة البيطرية,5,1,0,0,6
2022,1,مكتب محافظة الجبيل,الأنشطة الرياضية وأنشطة التسلية والترفيه,32,10,0,0,42
2022,1,مكتب محافظة الجبيل,الأنشطة العقارية,37,9,0,0,46
2022,1,مكتب محافظة الجبيل,الأنشطة القانونية وأنشطة المحاسبة,7,3,0,0,10
2022,1,مكتب محافظة الجبيل,الأنشطة المساعدة لأنشطة الخدمات المالية وأنشطة التأمين,2,0,0,0,2
2022,1,مكتب محافظة الجبيل,الأنشطة المهنية والعلمية والتقنية الأخرى,21,3,0,0,24
2022,1,مكتب محافظة الجبيل,الاتصالات,20,4,0,0,24
2022,1,مكتب محافظة الجبيل,البحث والتطوير في المجال العلمي,1,1,0,0,2
2022,1,مكتب محافظة الجبيل,التخزين وأنشطة الدعم للنقل,66,18,3,1,88
2022,1,مكتب محافظة الجبيل,التعليم,30,17,11,0,58
2022,1,مكتب محافظة الجبيل,الحراجة وقطع الأخشاب,2,0,0,0,2
2022,1,مكتب محافظة الجبيل,الرعاية مع الإقامة,3,3,0,0,6
2022,1,مكتب محافظة الجبيل,الصحة البشرية,22,19,13,6,60
2022,1,مكتب محافظة الجبيل,الصرف الصحي,2,2,1,1,6
2022,1,مكتب محافظة الجبيل,الصناعة التحويلية الأخرى,7,5,0,0,12
2022,1,مكتب محافظة الجبيل,الطباعة واستنساخ وسائط الأعلام المسجّلة,14,10,1,0,25
2022,1,مكتب محافظة الجبيل,النقل البري و النقل عبر الأنابيب,257,75,4,1,337
2022,1,مكتب محافظة الجبيل,النقل الجوي,11,6,0,2,19
2022,1,مكتب محافظة الجبيل,النقل المائي,8,1,0,0,9
2022,1,مكتب محافظة الجبيل,الهندسة المدنية,46,34,7,1,88
2022,1,مكتب محافظة الجبيل,تجارة التجزئة، باستثناء المركبات ذات المحركات والدراجات النارية,1271,255,20,2,1548
2022,1,مكتب محافظة الجبيل,تجارة الجملة ، باستثناء المركبات ذات المحركات والدراجات النارية,567,181,19,6,773
2022,1,مكتب محافظة الجبيل,تجارة الجملة والتجزئة ، وإصلاح المركبات ذات المحركات والدراجات النارية,691,114,4,0,809
2022,1,مكتب محافظة الجبيل,تجميع المياه ومعالجتها وتوصيلها,4,6,0,0,10
2022,1,مكتب محافظة الجبيل,تشييد المباني,1341,707,136,41,2225
2022,1,مكتب محافظة الجبيل,تعدين الفحم والليغنيت,0,2,0,0,2
2022,1,مكتب محافظة الجبيل,تعدين ركازات الفلزات,44,12,1,1,58
2022,1,مكتب محافظة الجبيل,تمويل التأمين وإعادة التأمين وصناديق المعاشات التقاعدية باستثناء الضمان الاجتماعي الإلزامي,0,1,0,0,1
2022,1,مكتب محافظة الجبيل,توصيل الكهرباء والغاز والبخار وتكييف الهواء,12,13,2,1,28
2022,1,مكتب محافظة الجبيل,صناعة الآلات والمعدات غير المصنفة في موضع أخر,17,17,4,0,38
2022,1,مكتب محافظة الجبيل,صناعة المركبات ذات المحركات والمركبات المقطورة ونصف المقطورة,11,3,0,0,14
2022,1,مكتب محافظة الجبيل,صناعة معدات النقل الأخرى,12,5,1,0,18
2022,1,مكتب محافظة الجبيل,صنع الأثاث,46,7,0,0,53
2022,1,مكتب محافظة الجبيل,صنع الحواسيب والمنتجات الإلكترونية والبصرية,27,7,4,2,40
2022,1,مكتب محافظة الجبيل,صُنع الخشب ومنتجات الخشب والفلين ، باستثناء الأثاث ، صُنع أصناف من القش ومواد الضفر,73,18,4,0,95
2022,1,مكتب محافظة الجبيل,صنع الفلزات القاعدية,64,27,16,5,112
2022,1,مكتب محافظة الجبيل,صُنع المشروبات,2,1,0,0,3
2022,1,مكتب محافظة الجبيل,صنع المعدات الكهربائية,66,21,4,1,92
2022,1,مكتب محافظة الجبيل,صُنع الملبوسات,191,21,1,0,213
2022,1,مكتب محافظة الجبيل,صُنع المنتجات الجلدية والمنتجات ذات الصلة,0,1,0,0,1
2022,1,مكتب محافظة الجبيل,صنع المنتجات الصيدلانية الأساسية والمستحضرات الصيدلانية,1,0,0,0,1
2022,1,مكتب محافظة الجبيل,صُنع المنتجات الغذائية,121,40,3,1,165
2022,1,مكتب محافظة الجبيل,صُنع المنسوجات,51,13,1,0,65
2022,1,مكتب محافظة الجبيل,صُنع المواد الكيميائية والمنتجات الكيميائية,24,22,18,3,67
2022,1,مكتب محافظة الجبيل,صُنع الورق ومنتجات الورق,1,1,0,0,2
2022,1,مكتب محافظة الجبيل,صنع فحم الكوك والمنتجات النفطية المكررة,2,5,0,1,8
2022,1,مكتب محافظة الجبيل,صُنع منتجات التبغ,2,0,0,0,2
2022,1,مكتب محافظة الجبيل,صنع منتجات المطاط واللدائن,16,27,10,10,63
2022,1,مكتب محافظة الجبيل,صنع منتجات المعادن اللافلزية الأخرى,54,29,11,2,96
2022,1,مكتب محافظة الجبيل,صنع منتجات المعادن المشكلة ( باستثناء الآلات والمعدات ),164,54,22,6,246
2022,1,مكتب محافظة الجبيل,صيد الأسماك وتربية المائيات,92,86,1,0,179
2022,1,مكتب محافظة الجبيل,وكالات السفر ومشغّلو الجولات السياحية وخدمات الحجز والأنشطة المتصلة بها,6,2,0,0,8
2022,1,مكتب محافظة الخرج,أبحاث الإعلان والسوق,16,5,0,0,21
2022,1,مكتب محافظة الخرج,إصلاح أجهزة الحاسوب والسلع الشخصية والمنزلية,98,6,0,0,104
2022,1,مكتب محافظة الخرج,إصلاح وتركيب الآلات والمعدات,48,5,1,0,54
2022,1,مكتب محافظة الخرج,أنشطة أنتاج الأفلام والبرامج التلفزيونية والتسجيلات الصوتية و نشرالموسيقى,2,0,0,0,2
2022,1,مكتب محافظة الخرج,أنشطة الأمن والتحقيقات,3,2,0,0,5
2022,1,مكتب محافظة الخرج,أنشطة الاستخدام,17,6,1,0,24
2022,1,مكتب محافظة الخرج,أنشطة البرمجة الحاسوبية والخبرة الاستشارية وما يتصل بها من أنشطة,5,0,0,0,5
2022,1,مكتب محافظة الخرج,أنشطة البرمجة والإذاعة,2,0,0,0,2
2022,1,مكتب محافظة الخرج,أنشطة البريد ونقل الرسائل والطرود بواسطة مندوبين,3,0,0,0,3
2022,1,مكتب محافظة الخرج,أنشطة التشييد المتخصصة,1111,182,12,1,1306
2022,1,مكتب محافظة الخرج,أنشطة الخدمات الشخصية الأخرى,636,63,2,0,701
2022,1,مكتب محافظة الخرج,أنشطة الخدمات المالية ، فيما عدا تمويل التأمين وصناديق المعاشات,31,6,0,0,37
2022,1,مكتب محافظة الخرج,أنشطة العمل الاجتماعي، دون إقامة، لكبار السن وذوي الإعاقة,20,18,0,0,38
2022,1,مكتب محافظة الخرج,أنشطة المعمارية والهندسية ، والاختبارات الفنية والتحليل,30,7,1,1,39
2022,1,مكتب محافظة الخرج,أنشطة المكاتب الرئيسية ، وألأنشطة الاستشارية في مجال الإدارة,16,4,0,0,20
2022,1,مكتب محافظة الخرج,أنشطة المكتبات ودور المحفوظات، والمتاحف والأنشطة الثقافية الأخرى,21,1,0,0,22
2022,1,مكتب محافظة الخرج,أنشطة المنظمات ذات العضوية,13,3,0,0,16
2022,1,مكتب محافظة الخرج,أنشطة النشر,9,3,0,0,12
2022,1,مكتب محافظة الخرج,أنشطة تقديم الخدمات للمباني وتجميل المواقع,209,52,7,0,268
2022,1,مكتب محافظة الخرج,أنشطة جمع النفايات ومعالجتها وتصريفها ، واسترجاع المواد,2,1,1,0,4
2022,1,مكتب محافظة الخرج,أنشطة خدمات الأطعمة والمشروبات,1195,251,10,0,1456
2022,1,مكتب محافظة الخرج,أنشطة خدمات المعلومات,9,0,0,0,9
2022,1,مكتب محافظة الخرج,أنشطة خدمات دعم التعدين,11,3,0,0,14
2022,1,مكتب محافظة الخرج,أنشطة زراعة المحاصيل والإنتاج الحيواني والصيد والخدمات المتصلة,1847,109,15,1,1972
2022,1,مكتب محافظة الخرج,الإدارة العامة والدفاع ؛ والضمان الاجتماعي الإلزامي,17,8,0,0,25
2022,1,مكتب محافظة الخرج,الإقامة,58,12,0,0,70
2022,1,مكتب محافظة الخرج,الأنشطة الإبداعية والفنون وأنشطة الترفيه,7,0,1,0,8
2022,1,مكتب محافظة الخرج,الأنشطة الأخرى للتعدين واستغلال المحاجر,20,4,0,0,24
2022,1,مكتب محافظة الخرج,الأنشطة الإدارية للمكاتب ، وأنشطة الدعم للمكاتب وغير ذلك من أنشطة الدعم للأعمال,44,5,0,0,49
2022,1,مكتب محافظة الخرج,الأنشطة الإيجارية,685,29,1,0,715
2022,1,مكتب محافظة الخرج,الأنشطة البيطرية,9,3,0,0,12
2022,1,مكتب محافظة الخرج,الأنشطة الرياضية وأنشطة التسلية والترفيه,35,10,0,0,45
2022,1,مكتب محافظة الخرج,الأنشطة العقارية,95,18,0,1,114
2022,1,مكتب محافظة الخرج,الأنشطة القانونية وأنشطة المحاسبة,5,0,0,0,5
2022,1,مكتب محافظة الخرج,الأنشطة المساعدة لأنشطة الخدمات المالية وأنشطة التأمين,2,1,0,0,3
2022,1,مكتب محافظة الخرج,الأنشطة المهنية والعلمية والتقنية الأخرى,14,0,0,0,14
2022,1,مكتب محافظة الخرج,الاتصالات,15,1,1,0,17
2022,1,مكتب محافظة الخرج,التخزين وأنشطة الدعم للنقل,76,11,0,0,87
2022,1,مكتب محافظة الخرج,التعليم,32,14,7,0,53
2022,1,مكتب محافظة الخرج,الحراجة وقطع الأخشاب,1,0,0,0,1
2022,1,مكتب محافظة الخرج,الرعاية مع الإقامة,1,1,0,0,2
2022,1,مكتب محافظة الخرج,الصحة البشرية,22,25,7,2,56
2022,1,مكتب محافظة الخرج,الصرف الصحي,1,1,0,0,2
2022,1,مكتب محافظة الخرج,الصناعة التحويلية الأخرى,11,6,1,0,18
2022,1,مكتب محافظة الخرج,الطباعة واستنساخ وسائط الأعلام المسجّلة,18,3,0,0,21
2022,1,مكتب محافظة الخرج,النقل البري و النقل عبر الأنابيب,957,106,7,0,1070
2022,1,مكتب محافظة الخرج,النقل الجوي,16,5,0,0,21
2022,1,مكتب محافظة الخرج,النقل المائي,12,0,0,0,12
2022,1,مكتب محافظة الخرج,الهندسة المدنية,8,8,2,2,20
2022,1,مكتب محافظة الخرج,تجارة التجزئة، باستثناء المركبات ذات المحركات والدراجات النارية,1855,294,13,1,2163
2022,1,مكتب محافظة الخرج,تجارة الجملة ، باستثناء المركبات ذات المحركات والدراجات النارية,789,209,15,0,1013
2022,1,مكتب محافظة الخرج,تجارة الجملة والتجزئة ، وإصلاح المركبات ذات المحركات والدراجات النارية,856,133,3,0,992
2022,1,مكتب محافظة الخرج,تجميع المياه ومعالجتها وتوصيلها,13,3,0,1,17
2022,1,مكتب محافظة الخرج,تشييد المباني,1765,447,37,5,2254
2022,1,مكتب محافظة الخرج,تعدين الفحم والليغنيت,0,1,0,0,1
2022,1,مكتب محافظة الخرج,تعدين ركازات الفلزات,15,2,0,0,17
2022,1,مكتب محافظة الخرج,توصيل الكهرباء والغاز والبخار وتكييف الهواء,7,5,1,0,13
2022,1,مكتب محافظة الخرج,صناعة الآلات والمعدات غير المصنفة في موضع أخر,22,7,0,0,29
2022,1,مكتب محافظة الخرج,صناعة المركبات ذات المحركات والمركبات المقطورة ونصف المقطورة,21,4,1,0,26
2022,1,مكتب محافظة الخرج,صناعة معدات النقل الأخرى,8,4,1,0,13
2022,1,مكتب محافظة الخرج,صنع الأثاث,76,16,1,1,94
2022,1,مكتب محافظة الخرج,صنع الحواسيب والمنتجات الإلكترونية والبصرية,37,3,0,0,40
2022,1,مكتب محافظة الخرج,صُنع الخشب ومنتجات الخشب والفلين ، باستثناء الأثاث ، صُنع أصناف من القش ومواد الضفر,82,17,2,0,101
2022,1,مكتب محافظة الخرج,صنع الفلزات القاعدية,107,28,3,0,138
2022,1,مكتب محافظة الخرج,صُنع المشروبات,11,8,4,7,30
2022,1,مكتب محافظة الخرج,صنع المعدات الكهربائية,50,7,1,0,58
2022,1,مكتب محافظة الخرج,صُنع الملبوسات,348,34,1,0,383
2022,1,مكتب محافظة الخرج,صُنع المنتجات الجلدية والمنتجات ذات الصلة,6,0,0,0,6
2022,1,مكتب محافظة الخرج,صنع المنتجات الصيدلانية الأساسية والمستحضرات الصيدلانية,3,5,0,0,8
2022,1,مكتب محافظة الخرج,صُنع المنتجات الغذائية,190,68,11,0,269
2022,1,مكتب محافظة الخرج,صُنع المنسوجات,33,10,0,0,43
2022,1,مكتب محافظة الخرج,صُنع المواد الكيميائية والمنتجات الكيميائية,52,19,5,0,76
2022,1,مكتب محافظة الخرج,صُنع الورق ومنتجات الورق,8,4,5,0,17
2022,1,مكتب محافظة الخرج,صنع فحم الكوك والمنتجات النفطية المكررة,0,3,0,0,3
2022,1,مكتب محافظة الخرج,صُنع منتجات التبغ,0,1,0,0,1
2022,1,مكتب محافظة الخرج,صنع منتجات المطاط واللدائن,18,16,5,1,40
2022,1,مكتب محافظة الخرج,صنع منتجات المعادن اللافلزية الأخرى,63,41,12,0,116
2022,1,مكتب محافظة الخرج,صنع منتجات المعادن المشكلة ( باستثناء الآلات والمعدات ),126,32,4,1,163
2022,1,مكتب محافظة الخرج,صيد الأسماك وتربية المائيات,35,1,0,0,36
2022,1,مكتب محافظة الخرج,وكالات السفر ومشغّلو الجولات السياحية وخدمات الحجز والأنشطة المتصلة بها,4,1,0,0,5
2022,1,مكتب محافظة الدوادمي,أبحاث الإعلان والسوق,4,2,0,0,6
2022,1,مكتب محافظة الدوادمي,إصلاح أجهزة الحاسوب والسلع الشخصية والمنزلية,37,9,0,0,46
2022,1,مكتب محافظة الدوادمي,إصلاح وتركيب الآلات والمعدات,13,4,0,0,17
2022,1,مكتب محافظة الدوادمي,أنشطة أنتاج الأفلام والبرامج التلفزيونية والتسجيلات الصوتية و نشرالموسيقى,2,0,0,0,2
2022,1,مكتب محافظة الدوادمي,أنشطة الأمن والتحقيقات,1,0,0,0,1
2022,1,مكتب محافظة الدوادمي,أنشطة الاستخدام,10,1,0,0,11
2022,1,مكتب محافظة الدوادمي,أنشطة الاسر المعيشية التي تستخدم أفراداً للعمل المنزلي,2,0,0,0,2
2022,1,مكتب محافظة الدوادمي,أنشطة البرمجة الحاسوبية والخبرة الاستشارية وما يتصل بها من أنشطة,5,0,0,0,5
2022,1,مكتب محافظة الدوادمي,أنشطة البرمجة والإذاعة,0,2,0,0,2
2022,1,مكتب محافظة الدوادمي,أنشطة البريد ونقل الرسائل والطرود بواسطة مندوبين,2,2,0,0,4
2022,1,مكتب محافظة الدوادمي,أنشطة التشييد المتخصصة,739,111,5,0,855
2022,1,مكتب محافظة الدوادمي,أنشطة الخدمات الشخصية الأخرى,382,31,2,0,415
2022,1,مكتب محافظة الدوادمي,أنشطة الخدمات المالية ، فيما عدا تمويل التأمين وصناديق المعاشات,20,2,0,0,22
2022,1,مكتب محافظة الدوادمي,أنشطة العمل الاجتماعي، دون إقامة، لكبار السن وذوي الإعاقة,17,1,1,0,19
2022,1,مكتب محافظة الدوادمي,أنشطة المعمارية والهندسية ، والاختبارات الفنية والتحليل,28,5,0,0,33
2022,1,مكتب محافظة الدوادمي,أنشطة المكاتب الرئيسية ، وألأنشطة الاستشارية في مجال الإدارة,7,0,0,0,7
2022,1,مكتب محافظة الدوادمي,أنشطة المكتبات ودور المحفوظات، والمتاحف والأنشطة الثقافية الأخرى,6,1,0,0,7
2022,1,مكتب محافظة الدوادمي,أنشطة المنظمات ذات العضوية,7,0,0,0,7
2022,1,مكتب محافظة الدوادمي,أنشطة النشر,2,0,0,0,2
2022,1,مكتب محافظة الدوادمي,أنشطة تقديم الخدمات للمباني وتجميل المواقع,759,145,12,1,917
2022,1,مكتب محافظة الدوادمي,أنشطة جمع النفايات ومعالجتها وتصريفها ، واسترجاع المواد,2,0,0,0,2
2022,1,مكتب محافظة الدوادمي,أنشطة خدمات الأطعمة والمشروبات,655,78,5,0,738
2022,1,مكتب محافظة الدوادمي,أنشطة خدمات المعلومات,4,0,0,0,4
2022,1,مكتب محافظة الدوادمي,أنشطة خدمات دعم التعدين,1,2,0,0,3
2022,1,مكتب محافظة الدوادمي,أنشطة زراعة المحاصيل والإنتاج الحيواني والصيد والخدمات المتصلة,1745,33,0,0,1778
2022,1,مكتب محافظة الدوادمي,الإدارة العامة والدفاع ؛ والضمان الاجتماعي الإلزامي,6,3,0,0,9
2022,1,مكتب محافظة الدوادمي,الإقامة,37,6,0,0,43
2022,1,مكتب محافظة الدوادمي,الأنشطة الإبداعية والفنون وأنشطة الترفيه,3,0,0,0,3
2022,1,مكتب محافظة الدوادمي,الأنشطة الأخرى للتعدين واستغلال المحاجر,3,2,1,0,6
2022,1,مكتب محافظة الدوادمي,الأنشطة الإدارية للمكاتب ، وأنشطة الدعم للمكاتب وغير ذلك من أنشطة الدعم للأعمال,14,1,0,0,15
2022,1,مكتب محافظة الدوادمي,الأنشطة الإيجارية,1139,30,1,1,1171
2022,1,مكتب محافظة الدوادمي,الأنشطة البيطرية,8,0,0,0,8
2022,1,مكتب محافظة الدوادمي,الأنشطة الرياضية وأنشطة التسلية والترفيه,24,5,0,0,29
2022,1,مكتب محافظة الدوادمي,الأنشطة العقارية,33,5,0,0,38
2022,1,مكتب محافظة الدوادمي,الأنشطة القانونية وأنشطة المحاسبة,1,0,0,0,1
2022,1,مكتب محافظة الدوادمي,الأنشطة المساعدة لأنشطة الخدمات المالية وأنشطة التأمين,1,0,0,0,1
2022,1,مكتب محافظة الدوادمي,الأنشطة المهنية والعلمية والتقنية الأخرى,7,1,0,0,8
2022,1,مكتب محافظة الدوادمي,الاتصالات,5,0,1,0,6
2022,1,مكتب محافظة الدوادمي,التخزين وأنشطة الدعم للنقل,62,4,0,0,66
2022,1,مكتب محافظة الدوادمي,التعليم,19,12,2,0,33
2022,1,مكتب محافظة الدوادمي,الحراجة وقطع الأخشاب,1,0,0,0,1
2022,1,مكتب محافظة الدوادمي,الصحة البشرية,18,7,3,0,28
2022,1,مكتب محافظة الدوادمي,الصرف الصحي,1,0,0,0,1
2022,1,مكتب محافظة الدوادمي,الصناعة التحويلية الأخرى,11,1,0,0,12
2022,1,مكتب محافظة الدوادمي,الطباعة واستنساخ وسائط الأعلام المسجّلة,7,1,0,0,8
2022,1,مكتب محافظة الدوادمي,النقل البري و النقل عبر الأنابيب,779,67,5,0,851
2022,1,مكتب محافظة الدوادمي,النقل الجوي,14,3,0,0,17
2022,1,مكتب محافظة الدوادمي,النقل المائي,4,0,0,0,4
2022,1,مكتب محافظة الدوادمي,الهندسة المدنية,3,2,2,0,7
2022,1,مكتب محافظة الدوادمي,تجارة التجزئة، باستثناء المركبات ذات المحركات والدراجات النارية,757,90,2,0,849
2022,1,مكتب محافظة الدوادمي,تجارة الجملة ، باستثناء المركبات ذات المحركات والدراجات النارية,313,68,4,0,385
2022,1,مكتب محافظة الدوادمي,تجارة الجملة والتجزئة ، وإصلاح المركبات ذات المحركات والدراجات النارية,613,57,5,1,676
2022,1,مكتب محافظة الدوادمي,تجميع المياه ومعالجتها وتوصيلها,7,3,1,0,11
2022,1,مكتب محافظة الدوادمي,تشييد المباني,830,172,23,3,1028
2022,1,مكتب محافظة الدوادمي,تعدين ركازات الفلزات,6,0,0,0,6
2022,1,مكتب محافظة الدوادمي,توصيل الكهرباء والغاز والبخار وتكييف الهواء,6,0,1,0,7
2022,1,مكتب محافظة الدوادمي,صناعة الآلات والمعدات غير المصنفة في موضع أخر,7,0,0,0,7
2022,1,مكتب محافظة الدوادمي,صناعة المركبات ذات المحركات والمركبات المقطورة ونصف المقطورة,11,0,0,0,11
2022,1,مكتب محافظة الدوادمي,صناعة معدات النقل الأخرى,4,1,0,0,5
2022,1,مكتب محافظة الدوادمي,صنع الأثاث,47,10,0,0,57
2022,1,مكتب محافظة الدوادمي,صنع الحواسيب والمنتجات الإلكترونية والبصرية,11,0,0,0,11
2022,1,مكتب محافظة الدوادمي,صُنع الخشب ومنتجات الخشب والفلين ، باستثناء الأثاث ، صُنع أصناف من القش ومواد الضفر,57,8,2,0,67
2022,1,مكتب محافظة الدوادمي,صنع الفلزات القاعدية,59,7,0,0,66
2022,1,مكتب محافظة الدوادمي,صُنع المشروبات,7,1,0,0,8
2022,1,مكتب محافظة الدوادمي,صنع المعدات الكهربائية,24,4,0,0,28
2022,1,مكتب محافظة الدوادمي,صُنع الملبوسات,189,16,1,0,206
2022,1,مكتب محافظة الدوادمي,صُنع المنتجات الجلدية والمنتجات ذات الصلة,4,0,0,0,4
2022,1,مكتب محافظة الدوادمي,صنع المنتجات الصيدلانية الأساسية والمستحضرات الصيدلانية,0,1,0,0,1
2022,1,مكتب محافظة الدوادمي,صُنع المنتجات الغذائية,89,13,0,0,102
2022,1,مكتب محافظة الدوادمي,صُنع المنسوجات,28,3,0,0,31
2022,1,مكتب محافظة الدوادمي,صُنع المواد الكيميائية والمنتجات الكيميائية,15,3,0,0,18
2022,1,مكتب محافظة الدوادمي,صُنع الورق ومنتجات الورق,1,0,0,0,1
2022,1,مكتب محافظة الدوادمي,صنع منتجات المطاط واللدائن,7,2,1,0,10
2022,1,مكتب محافظة الدوادمي,صنع منتجات المعادن اللافلزية الأخرى,63,24,0,0,87
2022,1,مكتب محافظة الدوادمي,صنع منتجات المعادن المشكلة ( باستثناء الآلات والمعدات ),84,13,0,0,97
2022,1,مكتب محافظة الدوادمي,صيد الأسماك وتربية المائيات,44,0,0,0,44
2022,1,مكتب محافظة الدوادمي,وكالات السفر ومشغّلو الجولات السياحية وخدمات الحجز والأنشطة المتصلة بها,2,0,0,0,2
2022,1,مكتب محافظة الطائف,أبحاث الإعلان والسوق,33,2,0,0,35
2022,1,مكتب محافظة الطائف,إصلاح أجهزة الحاسوب والسلع الشخصية والمنزلية,176,14,0,0,190
2022,1,مكتب محافظة الطائف,إصلاح وتركيب الآلات والمعدات,77,4,0,0,81
2022,1,مكتب محافظة الطائف,أنشطة أنتاج الأفلام والبرامج التلفزيونية والتسجيلات الصوتية و نشرالموسيقى,19,3,0,0,22
2022,1,مكتب محافظة الطائف,أنشطة الأمن والتحقيقات,9,2,0,0,11
2022,1,مكتب محافظة الطائف,أنشطة الاستخدام,28,3,0,0,31
2022,1,مكتب محافظة الطائف,أنشطة الاسر المعيشية التي تستخدم أفراداً للعمل المنزلي,3,0,0,0,3
2022,1,مكتب محافظة الطائف,أنشطة البرمجة الحاسوبية والخبرة الاستشارية وما يتصل بها من أنشطة,9,3,0,0,12
2022,1,مكتب محافظة الطائف,أنشطة البرمجة والإذاعة,1,0,1,0,2
2022,1,مكتب محافظة الطائف,أنشطة البريد ونقل الرسائل والطرود بواسطة مندوبين,1,0,0,0,1
2022,1,مكتب محافظة الطائف,أنشطة التشييد المتخصصة,1277,167,1,0,1445
2022,1,مكتب محافظة الطائف,أنشطة الخدمات الشخصية الأخرى,1247,75,0,0,1322
2022,1,مكتب محافظة الطائف,أنشطة الخدمات المالية ، فيما عدا تمويل التأمين وصناديق المعاشات,12,0,0,0,12
2022,1,مكتب محافظة الطائف,أنشطة العمل الاجتماعي، دون إقامة، لكبار السن وذوي الإعاقة,33,30,1,0,64
2022,1,مكتب محافظة الطائف,أنشطة المعالجة وخدمات إدارة النفايات الأخرى,0,1,0,0,1
2022,1,مكتب محافظة الطائف,أنشطة المعمارية والهندسية ، والاختبارات الفنية والتحليل,188,72,3,0,263
2022,1,مكتب محافظة الطائف,أنشطة المكاتب الرئيسية ، وألأنشطة الاستشارية في مجال الإدارة,11,4,0,0,15
2022,1,مكتب محافظة الطائف,أنشطة المكتبات ودور المحفوظات، والمتاحف والأنشطة الثقافية الأخرى,36,7,2,0,45
2022,1,مكتب محافظة الطائف,أنشطة المنظمات الدولية,0,1,0,0,1
2022,1,مكتب محافظة الطائف,أنشطة المنظمات ذات العضوية,17,2,1,0,20
2022,1,مكتب محافظة الطائف,أنشطة النشر,11,5,0,0,16
2022,1,مكتب محافظة الطائف,أنشطة تقديم الخدمات للمباني وتجميل المواقع,285,47,8,1,341
2022,1,مكتب محافظة الطائف,أنشطة جمع النفايات ومعالجتها وتصريفها ، واسترجاع المواد,8,0,0,0,8
2022,1,مكتب محافظة الطائف,أنشطة خدمات الأطعمة والمشروبات,2762,565,34,0,3361
2022,1,مكتب محافظة الطائف,أنشطة خدمات المعلومات,8,2,0,0,10
2022,1,مكتب محافظة الطائف,أنشطة خدمات دعم التعدين,20,5,1,0,26
2022,1,مكتب محافظة الطائف,أنشطة زراعة المحاصيل والإنتاج الحيواني والصيد والخدمات المتصلة,875,22,2,0,899
2022,1,مكتب محافظة الطائف,الإدارة العامة والدفاع ؛ والضمان الاجتماعي الإلزامي,16,6,4,0,26
2022,1,مكتب محافظة الطائف,الإقامة,211,48,7,0,266
2022,1,مكتب محافظة الطائف,الأنشطة الإبداعية والفنون وأنشطة الترفيه,9,5,0,0,14
2022,1,مكتب محافظة الطائف,الأنشطة الأخرى للتعدين واستغلال المحاجر,14,1,0,0,15
2022,1,مكتب محافظة الطائف,الأنشطة الإدارية للمكاتب ، وأنشطة الدعم للمكاتب وغير ذلك من أنشطة الدعم للأعمال,74,7,0,0,81
2022,1,مكتب محافظة الطائف,الأنشطة الإيجارية,1147,51,2,0,1200
2022,1,مكتب محافظة الطائف,الأنشطة البيطرية,23,4,0,0,27
2022,1,مكتب محافظة الطائف,الأنشطة الرياضية وأنشطة التسلية والترفيه,57,28,1,0,86
2022,1,مكتب محافظة الطائف,الأنشطة العقارية,85,11,1,0,97
2022,1,مكتب محافظة الطائف,الأنشطة القانونية وأنشطة المحاسبة,13,2,0,0,15
2022,1,مكتب محافظة الطائف,الأنشطة المهنية والعلمية والتقنية الأخرى,48,5,0,0,53
2022,1,مكتب محافظة الطائف,الاتصالات,30,1,0,0,31
2022,1,مكتب محافظة الطائف,البحث والتطوير في المجال العلمي,1,0,0,0,1
2022,1,مكتب محافظة الطائف,التخزين وأنشطة الدعم للنقل,92,7,2,0,101
2022,1,مكتب محافظة الطائف,التعليم,35,32,19,0,86
2022,1,مكتب محافظة الطائف,الرعاية مع الإقامة,1,1,0,0,2
2022,1,مكتب محافظة الطائف,الصحة البشرية,31,105,14,2,152
2022,1,مكتب محافظة الطائف,الصناعة التحويلية الأخرى,31,15,1,1,48
2022,1,مكتب محافظة الطائف,الطباعة واستنساخ وسائط الأعلام المسجّلة,31,11,0,0,42
2022,1,مكتب محافظة الطائف,النقل البري و النقل عبر الأنابيب,740,87,0,0,827
2022,1,مكتب محافظة الطائف,النقل الجوي,14,3,0,0,17
2022,1,مكتب محافظة الطائف,النقل المائي,8,1,0,0,9
2022,1,مكتب محافظة الطائف,الهندسة المدنية,19,3,1,0,23
2022,1,مكتب محافظة الطائف,تجارة التجزئة، باستثناء المركبات ذات المحركات والدراجات النارية,3339,462,22,0,3823
2022,1,مكتب محافظة الطائف,تجارة الجملة ، باستثناء المركبات ذات المحركات والدراجات النارية,965,172,18,0,1155
2022,1,مكتب محافظة الطائف,تجارة الجملة والتجزئة ، وإصلاح المركبات ذات المحركات والدراجات النارية,1595,170,4,0,1769
2022,1,مكتب محافظة الطائف,تجميع المياه ومعالجتها وتوصيلها,147,19,2,0,168
2022,1,مكتب محافظة الطائف,تشييد المباني,2452,488,42,3,2985
2022,1,مكتب محافظة الطائف,تعدين الفحم والليغنيت,4,0,0,0,4
2022,1,مكتب محافظة الطائف,تعدين ركازات الفلزات,22,2,0,0,24
2022,1,مكتب محافظة الطائف,تمويل التأمين وإعادة التأمين وصناديق المعاشات التقاعدية باستثناء الضمان الاجتماعي الإلزامي,0,1,0,0,1
2022,1,مكتب محافظة الطائف,توصيل الكهرباء والغاز والبخار وتكييف الهواء,12,0,0,0,12
2022,1,مكتب محافظة الطائف,صناعة الآلات والمعدات غير المصنفة في موضع أخر,21,1,0,0,22
2022,1,مكتب محافظة الطائف,صناعة المركبات ذات المحركات والمركبات المقطورة ونصف المقطورة,34,2,0,0,36
2022,1,مكتب محافظة الطائف,صناعة معدات النقل الأخرى,5,2,0,0,7
2022,1,مكتب محافظة الطائف,صنع الأثاث,192,27,3,0,222
2022,1,مكتب محافظة الطائف,صنع الحواسيب والمنتجات الإلكترونية والبصرية,107,12,0,0,119
2022,1,مكتب محافظة الطائف,صُنع الخشب ومنتجات الخشب والفلين ، باستثناء الأثاث ، صُنع أصناف من القش ومواد الضفر,198,25,0,0,223
2022,1,مكتب محافظة الطائف,صنع الفلزات القاعدية,112,21,2,0,135
2022,1,مكتب محافظة الطائف,صُنع المشروبات,18,5,0,0,23
2022,1,مكتب محافظة الطائف,صنع المعدات الكهربائية,77,16,0,0,93
2022,1,مكتب محافظة الطائف,صُنع الملبوسات,549,49,2,0,600
2022,1,مكتب محافظة الطائف,صُنع المنتجات الجلدية والمنتجات ذات الصلة,8,0,0,0,8
2022,1,مكتب محافظة الطائف,صنع المنتجات الصيدلانية الأساسية والمستحضرات الصيدلانية,1,0,0,0,1
2022,1,مكتب محافظة الطائف,صُنع المنتجات الغذائية,386,91,4,1,482
2022,1,مكتب محافظة الطائف,صُنع المنسوجات,69,19,1,0,89
2022,1,مكتب محافظة الطائف,صُنع المواد الكيميائية والمنتجات الكيميائية,61,11,2,0,74
2022,1,مكتب محافظة الطائف,صُنع الورق ومنتجات الورق,7,3,0,0,10
2022,1,مكتب محافظة الطائف,صُنع منتجات التبغ,1,0,0,0,1
2022,1,مكتب محافظة الطائف,صنع منتجات المطاط واللدائن,20,8,0,0,28
2022,1,مكتب محافظة الطائف,صنع منتجات المعادن اللافلزية الأخرى,95,25,2,1,123
2022,1,مكتب محافظة الطائف,صنع منتجات المعادن المشكلة ( باستثناء الآلات والمعدات ),582,55,0,0,637
2022,1,مكتب محافظة الطائف,صيد الأسماك وتربية المائيات,32,2,0,0,34
2022,1,مكتب محافظة الطائف,وكالات السفر ومشغّلو الجولات السياحية وخدمات الحجز والأنشطة المتصلة بها,20,4,0,0,24
2022,1,مكتب محافظة بيشة,أبحاث الإعلان والسوق,5,1,0,0,6
2022,1,مكتب محافظة بيشة,إصلاح أجهزة الحاسوب والسلع الشخصية والمنزلية,54,1,0,0,55
2022,1,مكتب محافظة بيشة,إصلاح وتركيب الآلات والمعدات,14,0,0,0,14
2022,1,مكتب محافظة بيشة,أنشطة الأمن والتحقيقات,1,0,0,0,1
2022,1,مكتب محافظة بيشة,أنشطة الاستخدام,8,1,0,0,9
2022,1,مكتب محافظة بيشة,أنشطة الاسر المعيشية التي تستخدم أفراداً للعمل المنزلي,2,0,0,0,2
2022,1,مكتب محافظة بيشة,أنشطة البرمجة الحاسوبية والخبرة الاستشارية وما يتصل بها من أنشطة,2,0,0,0,2
2022,1,مكتب محافظة بيشة,أنشطة البريد ونقل الرسائل والطرود بواسطة مندوبين,2,0,0,0,2
2022,1,مكتب محافظة بيشة,أنشطة التشييد المتخصصة,592,68,1,0,661
2022,1,مكتب محافظة بيشة,أنشطة الخدمات الشخصية الأخرى,246,17,0,0,263
2022,1,مكتب محافظة بيشة,أنشطة الخدمات المالية ، فيما عدا تمويل التأمين وصناديق المعاشات,12,1,0,0,13
2022,1,مكتب محافظة بيشة,أنشطة العمل الاجتماعي، دون إقامة، لكبار السن وذوي الإعاقة,28,9,0,0,37
2022,1,مكتب محافظة بيشة,أنشطة المعمارية والهندسية ، والاختبارات الفنية والتحليل,23,3,2,0,28
2022,1,مكتب محافظة بيشة,أنشطة المكاتب الرئيسية ، وألأنشطة الاستشارية في مجال الإدارة,7,1,0,0,8
2022,1,مكتب محافظة بيشة,أنشطة المكتبات ودور المحفوظات، والمتاحف والأنشطة الثقافية الأخرى,9,3,0,0,12
2022,1,مكتب محافظة بيشة,أنشطة المنظمات ذات العضوية,8,1,0,0,9
2022,1,مكتب محافظة بيشة,أنشطة النشر,4,0,0,0,4
2022,1,مكتب محافظة بيشة,أنشطة تقديم الخدمات للمباني وتجميل المواقع,49,12,0,0,61
2022,1,مكتب محافظة بيشة,أنشطة جمع النفايات ومعالجتها وتصريفها ، واسترجاع المواد,1,0,0,0,1
2022,1,مكتب محافظة بيشة,أنشطة خدمات الأطعمة والمشروبات,631,96,2,0,729
2022,1,مكتب محافظة بيشة,أنشطة خدمات المعلومات,1,0,0,0,1
2022,1,مكتب محافظة بيشة,أنشطة خدمات دعم التعدين,8,0,0,0,8
2022,1,مكتب محافظة بيشة,أنشطة زراعة المحاصيل والإنتاج الحيواني والصيد والخدمات المتصلة,583,16,0,0,599
2022,1,مكتب محافظة بيشة,الإدارة العامة والدفاع ؛ والضمان الاجتماعي الإلزامي,4,4,0,0,8
2022,1,مكتب محافظة بيشة,الإقامة,33,11,1,0,45
2022,1,مكتب محافظة بيشة,الأنشطة الإبداعية والفنون وأنشطة الترفيه,1,0,0,0,1
2022,1,مكتب محافظة بيشة,الأنشطة الأخرى للتعدين واستغلال المحاجر,11,4,1,0,16
2022,1,مكتب محافظة بيشة,الأنشطة الإدارية للمكاتب ، وأنشطة الدعم للمكاتب وغير ذلك من أنشطة الدعم للأعمال,22,3,0,0,25
2022,1,مكتب محافظة بيشة,الأنشطة الإيجارية,290,6,1,0,297
2022,1,مكتب محافظة بيشة,الأنشطة البيطرية,6,0,0,0,6
2022,1,مكتب محافظة بيشة,الأنشطة الرياضية وأنشطة التسلية والترفيه,12,3,0,0,15
2022,1,مكتب محافظة بيشة,الأنشطة العقارية,8,3,1,0,12
2022,1,مكتب محافظة بيشة,الأنشطة القانونية وأنشطة المحاسبة,1,0,0,0,1
2022,1,مكتب محافظة بيشة,الأنشطة المساعدة لأنشطة الخدمات المالية وأنشطة التأمين,1,0,0,0,1
2022,1,مكتب محافظة بيشة,الأنشطة المهنية والعلمية والتقنية الأخرى,4,0,0,0,4
2022,1,مكتب محافظة بيشة,الاتصالات,7,2,0,0,9
2022,1,مكتب محافظة بيشة,البحث والتطوير في المجال العلمي,1,0,0,0,1
2022,1,مكتب محافظة بيشة,التخزين وأنشطة الدعم للنقل,36,3,0,0,39
2022,1,مكتب محافظة بيشة,التعليم,18,7,1,0,26
2022,1,مكتب محافظة بيشة,الرعاية مع الإقامة,4,0,0,0,4
2022,1,مكتب محافظة بيشة,الصحة البشرية,10,13,2,0,25
2022,1,مكتب محافظة بيشة,الصناعة التحويلية الأخرى,3,1,0,0,4
2022,1,مكتب محافظة بيشة,الطباعة واستنساخ وسائط الأعلام المسجّلة,7,0,0,0,7
2022,1,مكتب محافظة بيشة,النقل البري و النقل عبر الأنابيب,322,35,1,0,358
2022,1,مكتب محافظة بيشة,النقل الجوي,1,2,0,0,3
2022,1,مكتب محافظة بيشة,النقل المائي,2,0,0,0,2
2022,1,مكتب محافظة بيشة,الهندسة المدنية,7,2,0,0,9
2022,1,مكتب محافظة بيشة,تجارة التجزئة، باستثناء المركبات ذات المحركات والدراجات النارية,1003,158,6,0,1167
2022,1,مكتب محافظة بيشة,تجارة الجملة ، باستثناء المركبات ذات المحركات والدراجات النارية,226,68,1,1,296
2022,1,مكتب محافظة بيشة,تجارة الجملة والتجزئة ، وإصلاح المركبات ذات المحركات والدراجات النارية,449,48,0,0,497
2022,1,مكتب محافظة بيشة,تجميع المياه ومعالجتها وتوصيلها,9,2,0,0,11
2022,1,مكتب محافظة بيشة,تشييد المباني,828,173,7,3,1011
2022,1,مكتب محافظة بيشة,تعدين ركازات الفلزات,14,3,0,0,17
2022,1,مكتب محافظة بيشة,توصيل الكهرباء والغاز والبخار وتكييف الهواء,6,2,0,0,8
2022,1,مكتب محافظة بيشة,صناعة الآلات والمعدات غير المصنفة في موضع أخر,7,0,0,0,7
2022,1,مكتب محافظة بيشة,صناعة المركبات ذات المحركات والمركبات المقطورة ونصف المقطورة,9,0,0,0,9
2022,1,مكتب محافظة بيشة,صناعة معدات النقل الأخرى,2,0,0,0,2
2022,1,مكتب محافظة بيشة,صنع الأثاث,51,14,0,0,65
2022,1,مكتب محافظة بيشة,صنع الحواسيب والمنتجات الإلكترونية والبصرية,37,3,0,0,40
2022,1,مكتب محافظة بيشة,صُنع الخشب ومنتجات الخشب والفلين ، باستثناء الأثاث ، صُنع أصناف من القش ومواد الضفر,49,5,0,0,54
2022,1,مكتب محافظة بيشة,صنع الفلزات القاعدية,31,5,0,0,36
2022,1,مكتب محافظة بيشة,صُنع المشروبات,7,1,0,0,8
2022,1,مكتب محافظة بيشة,صنع المعدات الكهربائية,19,0,0,0,19
2022,1,مكتب محافظة بيشة,صُنع الملبوسات,133,16,0,0,149
2022,1,مكتب محافظة بيشة,صُنع المنتجات الجلدية والمنتجات ذات الصلة,5,0,0,0,5
2022,1,مكتب محافظة بيشة,صنع المنتجات الصيدلانية الأساسية والمستحضرات الصيدلانية,2,1,0,0,3
2022,1,مكتب محافظة بيشة,صُنع المنتجات الغذائية,87,14,1,0,102
2022,1,مكتب محافظة بيشة,صُنع المنسوجات,20,2,0,0,22
2022,1,مكتب محافظة بيشة,صُنع المواد الكيميائية والمنتجات الكيميائية,19,3,0,0,22
2022,1,مكتب محافظة بيشة,صُنع الورق ومنتجات الورق,1,0,0,0,1
2022,1,مكتب محافظة بيشة,صنع منتجات المطاط واللدائن,7,5,0,0,12
2022,1,مكتب محافظة بيشة,صنع منتجات المعادن اللافلزية الأخرى,35,12,4,2,53
2022,1,مكتب محافظة بيشة,صنع منتجات المعادن المشكلة ( باستثناء الآلات والمعدات ),112,9,0,0,121
2022,1,مكتب محافظة بيشة,صيد الأسماك وتربية المائيات,16,0,0,0,16
2022,1,مكتب محافظة بيشة,وكالات السفر ومشغّلو الجولات السياحية وخدمات الحجز والأنشطة المتصلة بها,2,0,0,0,2
2022,1,مكتب محافظة حفر الباطن,أبحاث الإعلان والسوق,17,3,0,0,20
2022,1,مكتب محافظة حفر الباطن,إصلاح أجهزة الحاسوب والسلع الشخصية والمنزلية,64,5,0,0,69
2022,1,مكتب محافظة حفر الباطن,إصلاح وتركيب الآلات والمعدات,28,0,0,0,28
2022,1,مكتب محافظة حفر الباطن,أنشطة أنتاج الأفلام والبرامج التلفزيونية والتسجيلات الصوتية و نشرالموسيقى,3,0,0,0,3
2022,1,مكتب محافظة حفر الباطن,أنشطة الأمن والتحقيقات,1,2,1,0,4
2022,1,مكتب محافظة حفر الباطن,أنشطة الاستخدام,19,7,2,1,29
2022,1,مكتب محافظة حفر الباطن,أنشطة الاسر المعيشية التي تستخدم أفراداً للعمل المنزلي,1,0,0,0,1
2022,1,مكتب محافظة حفر الباطن,أنشطة البرمجة الحاسوبية والخبرة الاستشارية وما يتصل بها من أنشطة,4,0,0,0,4
2022,1,مكتب محافظة حفر الباطن,أنشطة البريد ونقل الرسائل والطرود بواسطة مندوبين,2,0,0,0,2
2022,1,مكتب محافظة حفر الباطن,أنشطة التشييد المتخصصة,706,128,9,1,844
2022,1,مكتب محافظة حفر الباطن,أنشطة الخدمات الشخصية الأخرى,567,49,2,0,618
2022,1,مكتب محافظة حفر الباطن,أنشطة الخدمات المالية ، فيما عدا تمويل التأمين وصناديق المعاشات,14,5,0,0,19
2022,1,مكتب محافظة حفر الباطن,أنشطة العمل الاجتماعي، دون إقامة، لكبار السن وذوي الإعاقة,3,3,0,0,6
2022,1,مكتب محافظة حفر الباطن,أنشطة المعمارية والهندسية ، والاختبارات الفنية والتحليل,41,10,2,0,53
2022,1,مكتب محافظة حفر الباطن,أنشطة المكاتب الرئيسية ، وألأنشطة الاستشارية في مجال الإدارة,15,2,0,0,17
2022,1,مكتب محافظة حفر الباطن,أنشطة المكتبات ودور المحفوظات، والمتاحف والأنشطة الثقافية الأخرى,9,4,0,0,13
2022,1,مكتب محافظة حفر الباطن,أنشطة المنظمات ذات العضوية,1,1,0,0,2
2022,1,مكتب محافظة حفر الباطن,أنشطة النشر,12,5,0,0,17
2022,1,مكتب محافظة حفر الباطن,أنشطة تقديم الخدمات للمباني وتجميل المواقع,113,25,2,0,140
2022,1,مكتب محافظة حفر الباطن,أنشطة جمع النفايات ومعالجتها وتصريفها ، واسترجاع المواد,2,0,1,0,3
2022,1,مكتب محافظة حفر الباطن,أنشطة خدمات الأطعمة والمشروبات,1606,289,16,1,1912
2022,1,مكتب محافظة حفر الباطن,أنشطة خدمات المعلومات,5,0,0,0,5
2022,1,مكتب محافظة حفر الباطن,أنشطة خدمات دعم التعدين,11,0,0,0,11
2022,1,مكتب محافظة حفر الباطن,أنشطة زراعة المحاصيل والإنتاج الحيواني والصيد والخدمات المتصلة,253,6,0,0,259
2022,1,مكتب محافظة حفر الباطن,الإدارة العامة والدفاع ؛ والضمان الاجتماعي الإلزامي,6,6,0,0,12
2022,1,مكتب محافظة حفر الباطن,الإقامة,42,17,1,0,60
2022,1,مكتب محافظة حفر الباطن,الأنشطة الإبداعية والفنون وأنشطة الترفيه,2,0,0,0,2
2022,1,مكتب محافظة حفر الباطن,الأنشطة الأخرى للتعدين واستغلال المحاجر,8,2,0,0,10
2022,1,مكتب محافظة حفر الباطن,الأنشطة الإدارية للمكاتب ، وأنشطة الدعم للمكاتب وغير ذلك من أنشطة الدعم للأعمال,33,3,0,0,36
2022,1,مكتب محافظة حفر الباطن,الأنشطة الإيجارية,506,25,0,0,531
2022,1,مكتب محافظة حفر الباطن,الأنشطة البيطرية,8,0,0,0,8
2022,1,مكتب محافظة حفر الباطن,الأنشطة الرياضية وأنشطة التسلية والترفيه,19,7,0,0,26
2022,1,مكتب محافظة حفر الباطن,الأنشطة العقارية,26,3,0,0,29
2022,1,مكتب محافظة حفر الباطن,الأنشطة القانونية وأنشطة المحاسبة,7,0,0,0,7
2022,1,مكتب محافظة حفر الباطن,الأنشطة المساعدة لأنشطة الخدمات المالية وأنشطة التأمين,3,0,0,0,3
2022,1,مكتب محافظة حفر الباطن,الأنشطة المهنية والعلمية والتقنية الأخرى,12,2,1,0,15
2022,1,مكتب محافظة حفر الباطن,الاتصالات,9,0,0,0,9
2022,1,مكتب محافظة حفر الباطن,التخزين وأنشطة الدعم للنقل,88,22,1,0,111
2022,1,مكتب محافظة حفر الباطن,التعليم,23,22,6,1,52
2022,1,مكتب محافظة حفر الباطن,الصحة البشرية,27,24,9,0,60
2022,1,مكتب محافظة حفر الباطن,الصناعة التحويلية الأخرى,6,1,0,0,7
2022,1,مكتب محافظة حفر الباطن,الطباعة واستنساخ وسائط الأعلام المسجّلة,11,5,0,0,16
2022,1,مكتب محافظة حفر الباطن,النقل البري و النقل عبر الأنابيب,423,84,7,2,516
2022,1,مكتب محافظة حفر الباطن,النقل الجوي,7,4,0,0,11
2022,1,مكتب محافظة حفر الباطن,النقل المائي,5,0,0,0,5
2022,1,مكتب محافظة حفر الباطن,الهندسة المدنية,4,1,0,0,5
2022,1,مكتب محافظة حفر الباطن,تجارة التجزئة، باستثناء المركبات ذات المحركات والدراجات النارية,1324,202,12,0,1538
2022,1,مكتب محافظة حفر الباطن,تجارة الجملة ، باستثناء المركبات ذات المحركات والدراجات النارية,394,72,9,1,476
2022,1,مكتب محافظة حفر الباطن,تجارة الجملة والتجزئة ، وإصلاح المركبات ذات المحركات والدراجات النارية,741,119,6,0,866
2022,1,مكتب محافظة حفر الباطن,تجميع المياه ومعالجتها وتوصيلها,6,1,0,0,7
2022,1,مكتب محافظة حفر الباطن,تشييد المباني,1378,293,35,1,1707
2022,1,مكتب محافظة حفر الباطن,تعدين الفحم والليغنيت,1,0,0,0,1
2022,1,مكتب محافظة حفر الباطن,تعدين ركازات الفلزات,45,7,0,0,52
2022,1,مكتب محافظة حفر الباطن,توصيل الكهرباء والغاز والبخار وتكييف الهواء,4,4,0,0,8
2022,1,مكتب محافظة حفر الباطن,صناعة الآلات والمعدات غير المصنفة في موضع أخر,16,0,0,0,16
2022,1,مكتب محافظة حفر الباطن,صناعة المركبات ذات المحركات والمركبات المقطورة ونصف المقطورة,17,2,0,0,19
2022,1,مكتب محافظة حفر الباطن,صناعة معدات النقل الأخرى,8,1,0,0,9
2022,1,مكتب محافظة حفر الباطن,صنع الأثاث,123,21,0,0,144
2022,1,مكتب محافظة حفر الباطن,صنع الحواسيب والمنتجات الإلكترونية والبصرية,16,3,0,0,19
2022,1,مكتب محافظة حفر الباطن,صُنع الخشب ومنتجات الخشب والفلين ، باستثناء الأثاث ، صُنع أصناف من القش ومواد الضفر,62,9,0,0,71
2022,1,مكتب محافظة حفر الباطن,صنع الفلزات القاعدية,28,10,0,0,38
2022,1,مكتب محافظة حفر الباطن,صُنع المشروبات,8,5,2,0,15
2022,1,مكتب محافظة حفر الباطن,صنع المعدات الكهربائية,72,10,0,0,82
2022,1,مكتب محافظة حفر الباطن,صُنع الملبوسات,315,28,0,0,343
2022,1,مكتب محافظة حفر الباطن,صُنع المنتجات الجلدية والمنتجات ذات الصلة,3,2,1,0,6
2022,1,مكتب محافظة حفر الباطن,صنع المنتجات الصيدلانية الأساسية والمستحضرات الصيدلانية,0,1,0,0,1
2022,1,مكتب محافظة حفر الباطن,صُنع المنتجات الغذائية,131,36,8,1,176
2022,1,مكتب محافظة حفر الباطن,صُنع المنسوجات,66,11,1,0,78
2022,1,مكتب محافظة حفر الباطن,صُنع المواد الكيميائية والمنتجات الكيميائية,23,6,0,0,29
2022,1,مكتب محافظة حفر الباطن,صُنع الورق ومنتجات الورق,4,4,0,0,8
2022,1,مكتب محافظة حفر الباطن,صنع فحم الكوك والمنتجات النفطية المكررة,1,0,0,0,1
2022,1,مكتب محافظة حفر الباطن,صُنع منتجات التبغ,2,1,0,0,3
2022,1,مكتب محافظة حفر الباطن,صنع منتجات المطاط واللدائن,10,6,1,0,17
2022,1,مكتب محافظة حفر الباطن,صنع منتجات المعادن اللافلزية الأخرى,105,38,6,0,149
2022,1,مكتب محافظة حفر الباطن,صنع منتجات المعادن المشكلة ( باستثناء الآلات والمعدات ),136,31,2,0,169
2022,1,مكتب محافظة حفر الباطن,صيد الأسماك وتربية المائيات,30,1,0,0,31
2022,1,مكتب محافظة حفر الباطن,وكالات السفر ومشغّلو الجولات السياحية وخدمات الحجز والأنشطة المتصلة بها,4,3,0,0,7
2022,1,مكتب محافظة ينبع,أبحاث الإعلان والسوق,14,0,0,0,14
2022,1,مكتب محافظة ينبع,إصلاح أجهزة الحاسوب والسلع الشخصية والمنزلية,69,7,0,0,76
2022,1,مكتب محافظة ينبع,إصلاح وتركيب الآلات والمعدات,30,5,0,0,35
2022,1,مكتب محافظة ينبع,أنشطة أنتاج الأفلام والبرامج التلفزيونية والتسجيلات الصوتية و نشرالموسيقى,6,0,0,0,6
2022,1,مكتب محافظة ينبع,أنشطة الأمن والتحقيقات,1,0,0,0,1
2022,1,مكتب محافظة ينبع,أنشطة الاستخدام,12,1,0,0,13
2022,1,مكتب محافظة ينبع,أنشطة البرمجة الحاسوبية والخبرة الاستشارية وما يتصل بها من أنشطة,5,2,0,0,7
2022,1,مكتب محافظة ينبع,أنشطة البريد ونقل الرسائل والطرود بواسطة مندوبين,1,0,0,0,1
2022,1,مكتب محافظة ينبع,أنشطة التشييد المتخصصة,618,109,9,0,736
2022,1,مكتب محافظة ينبع,أنشطة الخدمات الشخصية الأخرى,381,40,4,0,425
2022,1,مكتب محافظة ينبع,أنشطة الخدمات المالية ، فيما عدا تمويل التأمين وصناديق المعاشات,6,0,0,0,6
2022,1,مكتب محافظة ينبع,أنشطة العمل الاجتماعي، دون إقامة، لكبار السن وذوي الإعاقة,23,9,0,0,32
2022,1,مكتب محافظة ينبع,أنشطة المعمارية والهندسية ، والاختبارات الفنية والتحليل,30,6,0,1,37
2022,1,مكتب محافظة ينبع,أنشطة المكاتب الرئيسية ، وألأنشطة الاستشارية في مجال الإدارة,6,1,0,0,7
2022,1,مكتب محافظة ينبع,أنشطة المكتبات ودور المحفوظات، والمتاحف والأنشطة الثقافية الأخرى,9,1,0,0,10
2022,1,مكتب محافظة ينبع,أنشطة المنظمات الدولية,1,0,0,0,1
2022,1,مكتب محافظة ينبع,أنشطة المنظمات ذات العضوية,8,5,0,0,13
2022,1,مكتب محافظة ينبع,أنشطة النشر,4,1,0,0,5
2022,1,مكتب محافظة ينبع,أنشطة تقديم الخدمات للمباني وتجميل المواقع,116,50,0,1,167
2022,1,مكتب محافظة ينبع,أنشطة خدمات الأطعمة والمشروبات,997,241,9,0,1247
2022,1,مكتب محافظة ينبع,أنشطة خدمات المعلومات,3,2,0,0,5
2022,1,مكتب محافظة ينبع,أنشطة خدمات دعم التعدين,3,4,0,2,9
2022,1,مكتب محافظة ينبع,أنشطة زراعة المحاصيل والإنتاج الحيواني والصيد والخدمات المتصلة,193,9,0,0,202
2022,1,مكتب محافظة ينبع,الإدارة العامة والدفاع ؛ والضمان الاجتماعي الإلزامي,6,12,0,0,18
2022,1,مكتب محافظة ينبع,الإقامة,57,17,4,0,78
2022,1,مكتب محافظة ينبع,الأنشطة الإبداعية والفنون وأنشطة الترفيه,3,1,0,0,4
2022,1,مكتب محافظة ينبع,الأنشطة الأخرى للتعدين واستغلال المحاجر,6,2,0,0,8
2022,1,مكتب محافظة ينبع,الأنشطة الإدارية للمكاتب ، وأنشطة الدعم للمكاتب وغير ذلك من أنشطة الدعم للأعمال,20,0,0,0,20
2022,1,مكتب محافظة ينبع,الأنشطة الإيجارية,201,13,1,0,215
2022,1,مكتب محافظة ينبع,الأنشطة الرياضية وأنشطة التسلية والترفيه,26,6,1,0,33
2022,1,مكتب محافظة ينبع,الأنشطة العقارية,17,2,0,0,19
2022,1,مكتب محافظة ينبع,الأنشطة القانونية وأنشطة المحاسبة,3,0,0,0,3
2022,1,مكتب محافظة ينبع,الأنشطة المهنية والعلمية والتقنية الأخرى,10,1,0,0,11
2022,1,مكتب محافظة ينبع,الاتصالات,8,1,0,0,9
2022,1,مكتب محافظة ينبع,البحث والتطوير في المجال العلمي,0,0,1,0,1
2022,1,مكتب محافظة ينبع,التخزين وأنشطة الدعم للنقل,44,13,2,1,60
2022,1,مكتب محافظة ينبع,التعليم,19,20,7,0,46
2022,1,مكتب محافظة ينبع,الرعاية مع الإقامة,8,1,0,0,9
2022,1,مكتب محافظة ينبع,الصحة البشرية,16,23,4,2,45
2022,1,مكتب محافظة ينبع,الصرف الصحي,1,0,0,0,1
2022,1,مكتب محافظة ينبع,الصناعة التحويلية الأخرى,7,1,0,0,8
2022,1,مكتب محافظة ينبع,الطباعة واستنساخ وسائط الأعلام المسجّلة,16,1,0,0,17
2022,1,مكتب محافظة ينبع,النقل البري و النقل عبر الأنابيب,298,47,10,0,355
2022,1,مكتب محافظة ينبع,النقل الجوي,7,2,0,0,9
2022,1,مكتب محافظة ينبع,النقل المائي,10,1,1,0,12
2022,1,مكتب محافظة ينبع,الهندسة المدنية,11,4,1,1,17
2022,1,مكتب محافظة ينبع,تجارة التجزئة، باستثناء المركبات ذات المحركات والدراجات النارية,1079,210,9,2,1300
2022,1,مكتب محافظة ينبع,تجارة الجملة ، باستثناء المركبات ذات المحركات والدراجات النارية,322,87,9,0,418
2022,1,مكتب محافظة ينبع,تجارة الجملة والتجزئة ، وإصلاح المركبات ذات المحركات والدراجات النارية,558,75,2,0,635
2022,1,مكتب محافظة ينبع,تجميع المياه ومعالجتها وتوصيلها,5,2,0,0,7
2022,1,مكتب محافظة ينبع,تشييد المباني,1005,346,51,3,1405
2022,1,مكتب محافظة ينبع,تعدين الفحم والليغنيت,2,0,0,0,2
2022,1,مكتب محافظة ينبع,تعدين ركازات الفلزات,5,0,0,0,5
2022,1,مكتب محافظة ينبع,تمويل التأمين وإعادة التأمين وصناديق المعاشات التقاعدية باستثناء الضمان الاجتماعي الإلزامي,1,0,0,0,1
2022,1,مكتب محافظة ينبع,توصيل الكهرباء والغاز والبخار وتكييف الهواء,6,2,0,0,8
2022,1,مكتب محافظة ينبع,صناعة الآلات والمعدات غير المصنفة في موضع أخر,4,1,1,0,6
2022,1,مكتب محافظة ينبع,صناعة المركبات ذات المحركات والمركبات المقطورة ونصف المقطورة,7,1,1,0,9
2022,1,مكتب محافظة ينبع,صناعة معدات النقل الأخرى,6,0,0,0,6
2022,1,مكتب محافظة ينبع,صنع الأثاث,46,4,0,0,50
2022,1,مكتب محافظة ينبع,صنع الحواسيب والمنتجات الإلكترونية والبصرية,9,4,0,0,13
2022,1,مكتب محافظة ينبع,صُنع الخشب ومنتجات الخشب والفلين ، باستثناء الأثاث ، صُنع أصناف من القش ومواد الضفر,38,5,1,0,44
2022,1,مكتب محافظة ينبع,صنع الفلزات القاعدية,23,3,2,0,28
2022,1,مكتب محافظة ينبع,صُنع المشروبات,6,1,0,0,7
2022,1,مكتب محافظة ينبع,صنع المعدات الكهربائية,17,2,1,1,21
2022,1,مكتب محافظة ينبع,صُنع الملبوسات,171,15,0,0,186
2022,1,مكتب محافظة ينبع,صُنع المنتجات الجلدية والمنتجات ذات الصلة,1,0,0,0,1
2022,1,مكتب محافظة ينبع,صُنع المنتجات الغذائية,85,20,7,0,112
2022,1,مكتب محافظة ينبع,صُنع المنسوجات,11,1,1,0,13
2022,1,مكتب محافظة ينبع,صُنع المواد الكيميائية والمنتجات الكيميائية,12,10,7,2,31
2022,1,مكتب محافظة ينبع,صُنع الورق ومنتجات الورق,5,2,1,0,8
2022,1,مكتب محافظة ينبع,صنع فحم الكوك والمنتجات النفطية المكررة,2,1,2,1,6
2022,1,مكتب محافظة ينبع,صُنع منتجات التبغ,1,0,0,0,1
2022,1,مكتب محافظة ينبع,صنع منتجات المطاط واللدائن,8,6,1,1,16
2022,1,مكتب محافظة ينبع,صنع منتجات المعادن اللافلزية الأخرى,32,17,16,4,69
2022,1,مكتب محافظة ينبع,صنع منتجات المعادن المشكلة ( باستثناء الآلات والمعدات ),70,13,3,0,86
2022,1,مكتب محافظة ينبع,صيد الأسماك وتربية المائيات,47,17,0,0,64
2022,1,مكتب محافظة ينبع,وكالات السفر ومشغّلو الجولات السياحية وخدمات الحجز والأنشطة المتصلة بها,6,2,0,0,8
2022,1,مكتب مكة المكرمة,أبحاث الإعلان والسوق,55,6,0,0,61
2022,1,مكتب مكة المكرمة,إصلاح أجهزة الحاسوب والسلع الشخصية والمنزلية,291,35,0,0,326
2022,1,مكتب مكة المكرمة,إصلاح وتركيب الآلات والمعدات,177,11,0,0,188
2022,1,مكتب مكة المكرمة,أنشطة أنتاج الأفلام والبرامج التلفزيونية والتسجيلات الصوتية و نشرالموسيقى,24,1,0,0,25
2022,1,مكتب مكة المكرمة,أنشطة الأمن والتحقيقات,19,7,4,2,32
2022,1,مكتب مكة المكرمة,أنشطة الاستخدام,37,5,1,1,44
2022,1,مكتب مكة المكرمة,أنشطة الاسر المعيشية التي تستخدم أفراداً للعمل المنزلي,3,0,0,0,3
2022,1,مكتب مكة المكرمة,أنشطة البرمجة الحاسوبية والخبرة الاستشارية وما يتصل بها من أنشطة,43,9,0,0,52
2022,1,مكتب مكة المكرمة,أنشطة البرمجة والإذاعة,1,0,0,0,1
2022,1,مكتب مكة المكرمة,أنشطة البريد ونقل الرسائل والطرود بواسطة مندوبين,8,1,0,0,9
2022,1,مكتب مكة المكرمة,أنشطة التشييد المتخصصة,2552,541,37,2,3132
2022,1,مكتب مكة المكرمة,أنشطة الخدمات الشخصية الأخرى,2028,248,9,0,2285
2022,1,مكتب مكة المكرمة,أنشطة الخدمات المالية ، فيما عدا تمويل التأمين وصناديق المعاشات,63,11,0,0,74
2022,1,مكتب مكة المكرمة,أنشطة العمل الاجتماعي، دون إقامة، لكبار السن وذوي الإعاقة,211,105,9,1,326
2022,1,مكتب مكة المكرمة,أنشطة المعالجة وخدمات إدارة النفايات الأخرى,1,0,0,0,1
2022,1,مكتب مكة المكرمة,أنشطة المعمارية والهندسية ، والاختبارات الفنية والتحليل,265,168,7,2,442
2022,1,مكتب مكة المكرمة,أنشطة المكاتب الرئيسية ، وألأنشطة الاستشارية في مجال الإدارة,67,11,0,0,78
2022,1,مكتب مكة المكرمة,أنشطة المكتبات ودور المحفوظات، والمتاحف والأنشطة الثقافية الأخرى,59,11,1,0,71
2022,1,مكتب مكة المكرمة,أنشطة المنظمات الدولية,1,0,0,0,1
2022,1,مكتب مكة المكرمة,أنشطة المنظمات ذات العضوية,45,9,0,0,54
2022,1,مكتب مكة المكرمة,أنشطة النشر,25,1,0,0,26
2022,1,مكتب مكة المكرمة,أنشطة تقديم الخدمات للمباني وتجميل المواقع,811,198,24,2,1035
2022,1,مكتب مكة المكرمة,أنشطة جمع النفايات ومعالجتها وتصريفها ، واسترجاع المواد,3,0,0,0,3
2022,1,مكتب مكة المكرمة,أنشطة خدمات الأطعمة والمشروبات,4706,996,65,4,5771
2022,1,مكتب مكة المكرمة,أنشطة خدمات المعلومات,24,1,0,0,25
2022,1,مكتب مكة المكرمة,أنشطة خدمات دعم التعدين,10,6,1,0,17
2022,1,مكتب مكة المكرمة,أنشطة زراعة المحاصيل والإنتاج الحيواني والصيد والخدمات المتصلة,764,28,1,1,794
2022,1,مكتب مكة المكرمة,الإدارة العامة والدفاع ؛ والضمان الاجتماعي الإلزامي,67,39,2,0,108
2022,1,مكتب مكة المكرمة,الإقامة,384,163,40,9,596
2022,1,مكتب مكة المكرمة,الأنشطة الإبداعية والفنون وأنشطة الترفيه,9,0,0,0,9
2022,1,مكتب مكة المكرمة,الأنشطة الأخرى للتعدين واستغلال المحاجر,15,4,0,0,19
2022,1,مكتب مكة المكرمة,الأنشطة الإدارية للمكاتب ، وأنشطة الدعم للمكاتب وغير ذلك من أنشطة الدعم للأعمال,162,12,0,0,174
2022,1,مكتب مكة المكرمة,الأنشطة الإيجارية,972,38,0,1,1011
2022,1,مكتب مكة المكرمة,الأنشطة البيطرية,10,4,0,0,14
2022,1,مكتب مكة المكرمة,الأنشطة الرياضية وأنشطة التسلية والترفيه,76,24,1,0,101
2022,1,مكتب مكة المكرمة,الأنشطة العقارية,211,34,3,0,248
2022,1,مكتب مكة المكرمة,الأنشطة القانونية وأنشطة المحاسبة,45,5,0,0,50
2022,1,مكتب مكة المكرمة,الأنشطة المساعدة لأنشطة الخدمات المالية وأنشطة التأمين,12,10,1,0,23
2022,1,مكتب مكة المكرمة,الأنشطة المهنية والعلمية والتقنية الأخرى,67,11,0,0,78
2022,1,مكتب مكة المكرمة,الاتصالات,46,2,0,0,48
2022,1,مكتب مكة المكرمة,البحث والتطوير في المجال العلمي,2,0,0,0,2
2022,1,مكتب مكة المكرمة,التخزين وأنشطة الدعم للنقل,92,16,2,0,110
2022,1,مكتب مكة المكرمة,التعليم,78,49,22,2,151
2022,1,مكتب مكة المكرمة,الحراجة وقطع الأخشاب,1,1,0,0,2
2022,1,مكتب مكة المكرمة,الرعاية مع الإقامة,12,3,1,0,16
2022,1,مكتب مكة المكرمة,الصحة البشرية,90,126,32,3,251
2022,1,مكتب مكة المكرمة,الصرف الصحي,7,1,1,0,9
2022,1,مكتب مكة المكرمة,الصناعة التحويلية الأخرى,40,12,2,0,54
2022,1,مكتب مكة المكرمة,الطباعة واستنساخ وسائط الأعلام المسجّلة,64,23,2,0,89
2022,1,مكتب مكة المكرمة,النقل البري و النقل عبر الأنابيب,1023,162,15,2,1202
2022,1,مكتب مكة المكرمة,النقل الجوي,20,3,1,0,24
2022,1,مكتب مكة المكرمة,النقل المائي,19,1,0,0,20
2022,1,مكتب مكة المكرمة,الهندسة المدنية,55,11,0,1,67
2022,1,مكتب مكة المكرمة,تجارة التجزئة، باستثناء المركبات ذات المحركات والدراجات النارية,5937,1130,51,5,7123
2022,1,مكتب مكة المكرمة,تجارة الجملة ، باستثناء المركبات ذات المحركات والدراجات النارية,1781,441,31,2,2255
2022,1,مكتب مكة المكرمة,تجارة الجملة والتجزئة ، وإصلاح المركبات ذات المحركات والدراجات النارية,2134,320,8,0,2462
2022,1,مكتب مكة المكرمة,تجميع المياه ومعالجتها وتوصيلها,67,23,0,1,91
2022,1,مكتب مكة المكرمة,تشييد المباني,5333,1664,151,12,7160
2022,1,مكتب مكة المكرمة,تعدين ركازات الفلزات,23,2,0,0,25
2022,1,مكتب مكة المكرمة,تمويل التأمين وإعادة التأمين وصناديق المعاشات التقاعدية باستثناء الضمان الاجتماعي الإلزامي,3,2,0,0,5
2022,1,مكتب مكة المكرمة,توصيل الكهرباء والغاز والبخار وتكييف الهواء,9,10,2,0,21
2022,1,مكتب مكة المكرمة,صناعة الآلات والمعدات غير المصنفة في موضع أخر,28,3,0,0,31
2022,1,مكتب مكة المكرمة,صناعة المركبات ذات المحركات والمركبات المقطورة ونصف المقطورة,41,5,1,0,47
2022,1,مكتب مكة المكرمة,صناعة معدات النقل الأخرى,15,0,0,1,16
2022,1,مكتب مكة المكرمة,صنع الأثاث,158,34,2,0,194
2022,1,مكتب مكة المكرمة,صنع الحواسيب والمنتجات الإلكترونية والبصرية,72,16,0,0,88
2022,1,مكتب مكة المكرمة,صُنع الخشب ومنتجات الخشب والفلين ، باستثناء الأثاث ، صُنع أصناف من القش ومواد الضفر,231,40,2,0,273
2022,1,مكتب مكة المكرمة,صنع الفلزات القاعدية,63,24,2,0,89
2022,1,مكتب مكة المكرمة,صُنع المشروبات,20,9,3,0,32
2022,1,مكتب مكة المكرمة,صنع المعدات الكهربائية,89,14,1,0,104
2022,1,مكتب مكة المكرمة,صُنع الملبوسات,730,80,0,0,810
2022,1,مكتب مكة المكرمة,صُنع المنتجات الجلدية والمنتجات ذات الصلة,18,2,0,0,20
2022,1,مكتب مكة المكرمة,صنع المنتجات الصيدلانية الأساسية والمستحضرات الصيدلانية,3,1,0,0,4
2022,1,مكتب مكة المكرمة,صُنع المنتجات الغذائية,564,145,15,2,726
2022,1,مكتب مكة المكرمة,صُنع المنسوجات,114,20,0,0,134
2022,1,مكتب مكة المكرمة,صُنع المواد الكيميائية والمنتجات الكيميائية,74,28,0,0,102
2022,1,مكتب مكة المكرمة,صُنع الورق ومنتجات الورق,8,3,1,0,12
2022,1,مكتب مكة المكرمة,صنع فحم الكوك والمنتجات النفطية المكررة,3,0,0,0,3
2022,1,مكتب مكة المكرمة,صُنع منتجات التبغ,2,1,0,0,3
2022,1,مكتب مكة المكرمة,صنع منتجات المطاط واللدائن,22,10,2,1,35
2022,1,مكتب مكة المكرمة,صنع منتجات المعادن اللافلزية الأخرى,122,38,9,0,169
2022,1,مكتب مكة المكرمة,صنع منتجات المعادن المشكلة ( باستثناء الآلات والمعدات ),519,89,8,0,616
2022,1,مكتب مكة المكرمة,صيد الأسماك وتربية المائيات,169,14,1,0,184
2022,1,مكتب مكة المكرمة,وكالات السفر ومشغّلو الجولات السياحية وخدمات الحجز والأنشطة المتصلة بها,126,40,3,0,169
2022,1,مكتب منطقة الباحة,أبحاث الإعلان والسوق,4,2,0,0,6
2022,1,مكتب منطقة الباحة,إصلاح أجهزة الحاسوب والسلع الشخصية والمنزلية,48,2,0,0,50
2022,1,مكتب منطقة الباحة,إصلاح وتركيب الآلات والمعدات,18,1,0,0,19
2022,1,مكتب منطقة الباحة,أنشطة أنتاج الأفلام والبرامج التلفزيونية والتسجيلات الصوتية و نشرالموسيقى,1,0,0,0,1
2022,1,مكتب منطقة الباحة,أنشطة الأمن والتحقيقات,1,0,0,0,1
2022,1,مكتب منطقة الباحة,أنشطة الاستخدام,9,1,0,0,10
2022,1,مكتب منطقة الباحة,أنشطة البرمجة الحاسوبية والخبرة الاستشارية وما يتصل بها من أنشطة,2,0,0,0,2
2022,1,مكتب منطقة الباحة,أنشطة التشييد المتخصصة,483,68,0,1,552
2022,1,مكتب منطقة الباحة,أنشطة الخدمات الشخصية الأخرى,285,16,0,0,301
2022,1,مكتب منطقة الباحة,أنشطة الخدمات المالية ، فيما عدا تمويل التأمين وصناديق المعاشات,7,0,0,0,7
2022,1,مكتب منطقة الباحة,أنشطة العمل الاجتماعي، دون إقامة، لكبار السن وذوي الإعاقة,28,16,0,0,44
2022,1,مكتب منطقة الباحة,أنشطة المعمارية والهندسية ، والاختبارات الفنية والتحليل,84,37,3,0,124
2022,1,مكتب منطقة الباحة,أنشطة المكاتب الرئيسية ، وألأنشطة الاستشارية في مجال الإدارة,5,1,0,0,6
2022,1,مكتب منطقة الباحة,أنشطة المكتبات ودور المحفوظات، والمتاحف والأنشطة الثقافية الأخرى,7,2,0,0,9
2022,1,مكتب منطقة الباحة,أنشطة المنظمات الدولية,0,1,0,0,1
2022,1,مكتب منطقة الباحة,أنشطة المنظمات ذات العضوية,14,5,0,0,19
2022,1,مكتب منطقة الباحة,أنشطة النشر,6,1,0,0,7
2022,1,مكتب منطقة الباحة,أنشطة تقديم الخدمات للمباني وتجميل المواقع,61,8,2,0,71
2022,1,مكتب منطقة الباحة,أنشطة جمع النفايات ومعالجتها وتصريفها ، واسترجاع المواد,1,0,0,0,1
2022,1,مكتب منطقة الباحة,أنشطة خدمات الأطعمة والمشروبات,692,178,5,0,875
2022,1,مكتب منطقة الباحة,أنشطة خدمات المعلومات,2,0,0,0,2
2022,1,مكتب منطقة الباحة,أنشطة خدمات دعم التعدين,7,0,0,0,7
2022,1,مكتب منطقة الباحة,أنشطة زراعة المحاصيل والإنتاج الحيواني والصيد والخدمات المتصلة,316,5,0,0,321
2022,1,مكتب منطقة الباحة,الإدارة العامة والدفاع ؛ والضمان الاجتماعي الإلزامي,7,9,1,0,17
2022,1,مكتب منطقة الباحة,الإقامة,47,23,1,0,71
2022,1,مكتب منطقة الباحة,الأنشطة الإبداعية والفنون وأنشطة الترفيه,1,0,0,0,1
2022,1,مكتب منطقة الباحة,الأنشطة الأخرى للتعدين واستغلال المحاجر,2,3,0,0,5
2022,1,مكتب منطقة الباحة,الأنشطة الإدارية للمكاتب ، وأنشطة الدعم للمكاتب وغير ذلك من أنشطة الدعم للأعمال,23,0,0,0,23
2022,1,مكتب منطقة الباحة,الأنشطة الإيجارية,142,4,0,0,146
2022,1,مكتب منطقة الباحة,الأنشطة البيطرية,2,0,0,0,2
2022,1,مكتب منطقة الباحة,الأنشطة الرياضية وأنشطة التسلية والترفيه,23,2,0,0,25
2022,1,مكتب منطقة الباحة,الأنشطة العقارية,11,1,0,0,12
2022,1,مكتب منطقة الباحة,الأنشطة القانونية وأنشطة المحاسبة,4,0,0,0,4
2022,1,مكتب منطقة الباحة,الأنشطة المهنية والعلمية والتقنية الأخرى,5,0,0,0,5
2022,1,مكتب منطقة الباحة,الاتصالات,7,1,0,0,8
2022,1,مكتب منطقة الباحة,التخزين وأنشطة الدعم للنقل,28,2,0,0,30
2022,1,مكتب منطقة الباحة,التعليم,13,7,0,0,20
2022,1,مكتب منطقة الباحة,الرعاية مع الإقامة,2,5,0,0,7
2022,1,مكتب منطقة الباحة,الصحة البشرية,21,20,1,0,42
2022,1,مكتب منطقة الباحة,الصرف الصحي,1,0,0,0,1
2022,1,مكتب منطقة الباحة,الصناعة التحويلية الأخرى,9,0,0,0,9
2022,1,مكتب منطقة الباحة,الطباعة واستنساخ وسائط الأعلام المسجّلة,12,5,0,0,17
2022,1,مكتب منطقة الباحة,النقل البري و النقل عبر الأنابيب,145,15,0,0,160
2022,1,مكتب منطقة الباحة,النقل الجوي,0,2,0,0,2
2022,1,مكتب منطقة الباحة,الهندسة المدنية,6,3,1,0,10
2022,1,مكتب منطقة الباحة,تجارة التجزئة، باستثناء المركبات ذات المحركات والدراجات النارية,1094,224,9,0,1327
2022,1,مكتب منطقة الباحة,تجارة الجملة ، باستثناء المركبات ذات المحركات والدراجات النارية,391,180,6,0,577
2022,1,مكتب منطقة الباحة,تجارة الجملة والتجزئة ، وإصلاح المركبات ذات المحركات والدراجات النارية,401,60,1,0,462
2022,1,مكتب منطقة الباحة,تجميع المياه ومعالجتها وتوصيلها,21,1,0,0,22
2022,1,مكتب منطقة الباحة,تشييد المباني,745,152,11,1,909
2022,1,مكتب منطقة الباحة,تعدين ركازات الفلزات,11,1,0,0,12
2022,1,مكتب منطقة الباحة,توصيل الكهرباء والغاز والبخار وتكييف الهواء,1,1,0,0,2
2022,1,مكتب منطقة الباحة,صناعة الآلات والمعدات غير المصنفة في موضع أخر,5,0,0,0,5
2022,1,مكتب منطقة الباحة,صناعة المركبات ذات المحركات والمركبات المقطورة ونصف المقطورة,4,0,0,0,4
2022,1,مكتب منطقة الباحة,صناعة معدات النقل الأخرى,3,0,0,0,3
2022,1,مكتب منطقة الباحة,صنع الأثاث,53,9,0,0,62
2022,1,مكتب منطقة الباحة,صنع الحواسيب والمنتجات الإلكترونية والبصرية,16,4,0,0,20
2022,1,مكتب منطقة الباحة,صُنع الخشب ومنتجات الخشب والفلين ، باستثناء الأثاث ، صُنع أصناف من القش ومواد الضفر,55,13,0,0,68
2022,1,مكتب منطقة الباحة,صنع الفلزات القاعدية,24,3,0,0,27
2022,1,مكتب منطقة الباحة,صُنع المشروبات,5,2,0,0,7
2022,1,مكتب منطقة الباحة,صنع المعدات الكهربائية,16,1,0,0,17
2022,1,مكتب منطقة الباحة,صُنع الملبوسات,116,15,0,0,131
2022,1,مكتب منطقة الباحة,صُنع المنتجات الجلدية والمنتجات ذات الصلة,1,0,0,0,1
2022,1,مكتب منطقة الباحة,صنع المنتجات الصيدلانية الأساسية والمستحضرات الصيدلانية,2,0,0,0,2
2022,1,مكتب منطقة الباحة,صُنع المنتجات الغذائية,104,13,1,0,118
2022,1,مكتب منطقة الباحة,صُنع المنسوجات,10,3,0,0,13
2022,1,مكتب منطقة الباحة,صُنع المواد الكيميائية والمنتجات الكيميائية,9,2,0,0,11
2022,1,مكتب منطقة الباحة,صُنع الورق ومنتجات الورق,2,0,0,0,2
2022,1,مكتب منطقة الباحة,صنع منتجات المطاط واللدائن,4,2,0,0,6
2022,1,مكتب منطقة الباحة,صنع منتجات المعادن اللافلزية الأخرى,41,24,5,0,70
2022,1,مكتب منطقة الباحة,صنع منتجات المعادن المشكلة ( باستثناء الآلات والمعدات ),139,17,0,0,156
2022,1,مكتب منطقة الباحة,صيد الأسماك وتربية المائيات,7,0,0,0,7
2022,1,مكتب منطقة الباحة,وكالات السفر ومشغّلو الجولات السياحية وخدمات الحجز والأنشطة المتصلة بها,2,0,0,0,2
2022,1,مكتب منطقة الجوف,أبحاث الإعلان والسوق,43,3,0,0,46
2022,1,مكتب منطقة الجوف,إصلاح أجهزة الحاسوب والسلع الشخصية والمنزلية,88,8,1,0,97
2022,1,مكتب منطقة الجوف,إصلاح وتركيب الآلات والمعدات,25,3,0,0,28
2022,1,مكتب منطقة الجوف,أنشطة أنتاج الأفلام والبرامج التلفزيونية والتسجيلات الصوتية و نشرالموسيقى,3,0,0,0,3
2022,1,مكتب منطقة الجوف,أنشطة الأمن والتحقيقات,2,2,0,0,4
2022,1,مكتب منطقة الجوف,أنشطة الاستخدام,16,3,0,0,19
2022,1,مكتب منطقة الجوف,أنشطة البرمجة الحاسوبية والخبرة الاستشارية وما يتصل بها من أنشطة,9,3,0,0,12
2022,1,مكتب منطقة الجوف,أنشطة البرمجة والإذاعة,1,0,0,0,1
2022,1,مكتب منطقة الجوف,أنشطة البريد ونقل الرسائل والطرود بواسطة مندوبين,1,0,0,0,1
2022,1,مكتب منطقة الجوف,أنشطة التشييد المتخصصة,738,174,8,0,920
2022,1,مكتب منطقة الجوف,أنشطة الخدمات الشخصية الأخرى,532,53,0,0,585
2022,1,مكتب منطقة الجوف,أنشطة الخدمات المالية ، فيما عدا تمويل التأمين وصناديق المعاشات,13,0,0,0,13
2022,1,مكتب منطقة الجوف,أنشطة العمل الاجتماعي، دون إقامة، لكبار السن وذوي الإعاقة,15,16,0,0,31
2022,1,مكتب منطقة الجوف,أنشطة المعمارية والهندسية ، والاختبارات الفنية والتحليل,100,38,1,0,139
2022,1,مكتب منطقة الجوف,أنشطة المكاتب الرئيسية ، وألأنشطة الاستشارية في مجال الإدارة,10,2,0,0,12
2022,1,مكتب منطقة الجوف,أنشطة المكتبات ودور المحفوظات، والمتاحف والأنشطة الثقافية الأخرى,10,6,0,0,16
2022,1,مكتب منطقة الجوف,أنشطة المنظمات ذات العضوية,12,5,0,0,17
2022,1,مكتب منطقة الجوف,أنشطة النشر,5,1,0,0,6
2022,1,مكتب منطقة الجوف,أنشطة تقديم الخدمات للمباني وتجميل المواقع,314,84,7,1,406
2022,1,مكتب منطقة الجوف,أنشطة جمع النفايات ومعالجتها وتصريفها ، واسترجاع المواد,4,0,0,0,4
2022,1,مكتب منطقة الجوف,أنشطة خدمات الأطعمة والمشروبات,1031,204,6,0,1241
2022,1,مكتب منطقة الجوف,أنشطة خدمات المعلومات,5,2,0,0,7
2022,1,مكتب منطقة الجوف,أنشطة خدمات دعم التعدين,6,1,0,0,7
2022,1,مكتب منطقة الجوف,أنشطة زراعة المحاصيل والإنتاج الحيواني والصيد والخدمات المتصلة,699,21,0,2,722
2022,1,مكتب منطقة الجوف,الإدارة العامة والدفاع ؛ والضمان الاجتماعي الإلزامي,14,6,0,0,20
2022,1,مكتب منطقة الجوف,الإقامة,66,11,1,0,78
2022,1,مكتب منطقة الجوف,الأنشطة الإبداعية والفنون وأنشطة الترفيه,3,0,0,0,3
2022,1,مكتب منطقة الجوف,الأنشطة الأخرى للتعدين واستغلال المحاجر,7,1,0,0,8
2022,1,مكتب منطقة الجوف,الأنشطة الإدارية للمكاتب ، وأنشطة الدعم للمكاتب وغير ذلك من أنشطة الدعم للأعمال,33,1,0,0,34
2022,1,مكتب منطقة الجوف,الأنشطة الإيجارية,604,21,0,0,625
2022,1,مكتب منطقة الجوف,الأنشطة البيطرية,4,3,0,0,7
2022,1,مكتب منطقة الجوف,الأنشطة الرياضية وأنشطة التسلية والترفيه,43,6,0,0,49
2022,1,مكتب منطقة الجوف,الأنشطة العقارية,30,2,1,0,33
2022,1,مكتب منطقة الجوف,الأنشطة القانونية وأنشطة المحاسبة,13,1,0,0,14
2022,1,مكتب منطقة الجوف,الأنشطة المهنية والعلمية والتقنية الأخرى,14,1,0,0,15
2022,1,مكتب منطقة الجوف,الاتصالات,20,1,0,0,21
2022,1,مكتب منطقة الجوف,التخزين وأنشطة الدعم للنقل,115,17,3,0,135
2022,1,مكتب منطقة الجوف,التعليم,18,29,12,0,59
2022,1,مكتب منطقة الجوف,الحراجة وقطع الأخشاب,1,0,0,0,1
2022,1,مكتب منطقة الجوف,الرعاية مع الإقامة,6,2,0,0,8
2022,1,مكتب منطقة الجوف,الصحة البشرية,21,29,7,0,57
2022,1,مكتب منطقة الجوف,الصرف الصحي,4,0,0,0,4
2022,1,مكتب منطقة الجوف,الصناعة التحويلية الأخرى,6,0,0,0,6
2022,1,مكتب منطقة الجوف,الطباعة واستنساخ وسائط الأعلام المسجّلة,16,4,0,0,20
2022,1,مكتب منطقة الجوف,النقل البري و النقل عبر الأنابيب,480,62,1,0,543
2022,1,مكتب منطقة الجوف,النقل الجوي,13,0,0,0,13
2022,1,مكتب منطقة الجوف,الهندسة المدنية,15,3,0,0,18
2022,1,مكتب منطقة الجوف,تجارة التجزئة، باستثناء المركبات ذات المحركات والدراجات النارية,1438,224,10,1,1673
2022,1,مكتب منطقة الجوف,تجارة الجملة ، باستثناء المركبات ذات المحركات والدراجات النارية,400,85,3,1,489
2022,1,مكتب منطقة الجوف,تجارة الجملة والتجزئة ، وإصلاح المركبات ذات المحركات والدراجات النارية,607,97,0,0,704
2022,1,مكتب منطقة الجوف,تجميع المياه ومعالجتها وتوصيلها,10,1,0,0,11
2022,1,مكتب منطقة الجوف,تشييد المباني,1000,205,16,1,1222
2022,1,مكتب منطقة الجوف,تعدين الفحم والليغنيت,2,0,0,0,2
2022,1,مكتب منطقة الجوف,تعدين ركازات الفلزات,5,1,0,0,6
2022,1,مكتب منطقة الجوف,توصيل الكهرباء والغاز والبخار وتكييف الهواء,8,2,0,0,10
2022,1,مكتب منطقة الجوف,صناعة الآلات والمعدات غير المصنفة في موضع أخر,15,0,0,0,15
2022,1,مكتب منطقة الجوف,صناعة المركبات ذات المحركات والمركبات المقطورة ونصف المقطورة,13,3,0,0,16
2022,1,مكتب منطقة الجوف,صناعة معدات النقل الأخرى,2,2,0,0,4
2022,1,مكتب منطقة الجوف,صنع الأثاث,94,10,0,0,104
2022,1,مكتب منطقة الجوف,صنع الحواسيب والمنتجات الإلكترونية والبصرية,12,1,0,0,13
2022,1,مكتب منطقة الجوف,صُنع الخشب ومنتجات الخشب والفلين ، باستثناء الأثاث ، صُنع أصناف من القش ومواد الضفر,55,5,0,0,60
2022,1,مكتب منطقة الجوف,صنع الفلزات القاعدية,38,9,0,0,47
2022,1,مكتب منطقة الجوف,صُنع المشروبات,7,4,1,1,13
2022,1,مكتب منطقة الجوف,صنع المعدات الكهربائية,25,3,0,0,28
2022,1,مكتب منطقة الجوف,صُنع الملبوسات,240,19,0,0,259
2022,1,مكتب منطقة الجوف,صُنع المنتجات الجلدية والمنتجات ذات الصلة,1,0,0,0,1
2022,1,مكتب منطقة الجوف,صنع المنتجات الصيدلانية الأساسية والمستحضرات الصيدلانية,3,0,0,0,3
2022,1,مكتب منطقة الجوف,صُنع المنتجات الغذائية,156,45,1,0,202
2022,1,مكتب منطقة الجوف,صُنع المنسوجات,29,8,0,0,37
2022,1,مكتب منطقة الجوف,صُنع المواد الكيميائية والمنتجات الكيميائية,23,3,0,0,26
2022,1,مكتب منطقة الجوف,صُنع الورق ومنتجات الورق,5,1,0,0,6
2022,1,مكتب منطقة الجوف,صنع منتجات المطاط واللدائن,9,3,0,0,12
2022,1,مكتب منطقة الجوف,صنع منتجات المعادن اللافلزية الأخرى,55,23,5,0,83
2022,1,مكتب منطقة الجوف,صنع منتجات المعادن المشكلة ( باستثناء الآلات والمعدات ),152,17,1,0,170
2022,1,مكتب منطقة الجوف,صيد الأسماك وتربية المائيات,31,2,0,0,33
2022,1,مكتب منطقة الجوف,وكالات السفر ومشغّلو الجولات السياحية وخدمات الحجز والأنشطة المتصلة بها,7,3,0,0,10
2022,1,مكتب منطقة الحدود الشمالية,أبحاث الإعلان والسوق,9,1,0,0,10
2022,1,مكتب منطقة الحدود الشمالية,إصلاح أجهزة الحاسوب والسلع الشخصية والمنزلية,49,1,0,0,50
2022,1,مكتب منطقة الحدود الشمالية,إصلاح وتركيب الآلات والمعدات,22,2,0,0,24
2022,1,مكتب منطقة الحدود الشمالية,أنشطة أنتاج الأفلام والبرامج التلفزيونية والتسجيلات الصوتية و نشرالموسيقى,1,0,0,0,1
2022,1,مكتب منطقة الحدود الشمالية,أنشطة الأمن والتحقيقات,0,2,1,1,4
2022,1,مكتب منطقة الحدود الشمالية,أنشطة الاستخدام,11,1,0,0,12
2022,1,مكتب منطقة الحدود الشمالية,أنشطة الاسر المعيشية التي تستخدم أفراداً للعمل المنزلي,1,0,0,0,1
2022,1,مكتب منطقة الحدود الشمالية,أنشطة البرمجة الحاسوبية والخبرة الاستشارية وما يتصل بها من أنشطة,3,0,0,0,3
2022,1,مكتب منطقة الحدود الشمالية,أنشطة البريد ونقل الرسائل والطرود بواسطة مندوبين,0,1,0,0,1
2022,1,مكتب منطقة الحدود الشمالية,أنشطة التشييد المتخصصة,362,44,3,0,409
2022,1,مكتب منطقة الحدود الشمالية,أنشطة الخدمات الشخصية الأخرى,425,29,0,0,454
2022,1,مكتب منطقة الحدود الشمالية,أنشطة الخدمات المالية ، فيما عدا تمويل التأمين وصناديق المعاشات,10,2,0,0,12
2022,1,مكتب منطقة الحدود الشمالية,أنشطة العمل الاجتماعي، دون إقامة، لكبار السن وذوي الإعاقة,13,10,0,0,23
2022,1,مكتب منطقة الحدود الشمالية,أنشطة المعمارية والهندسية ، والاختبارات الفنية والتحليل,108,30,1,0,139
2022,1,مكتب منطقة الحدود الشمالية,أنشطة المكاتب الرئيسية ، وألأنشطة الاستشارية في مجال الإدارة,6,3,0,0,9
2022,1,مكتب منطقة الحدود الشمالية,أنشطة المكتبات ودور المحفوظات، والمتاحف والأنشطة الثقافية الأخرى,11,3,0,0,14
2022,1,مكتب منطقة الحدود الشمالية,أنشطة المنظمات ذات العضوية,11,1,0,0,12
2022,1,مكتب منطقة الحدود الشمالية,أنشطة النشر,1,0,0,0,1
2022,1,مكتب منطقة الحدود الشمالية,أنشطة تقديم الخدمات للمباني وتجميل المواقع,112,15,0,0,127
2022,1,مكتب منطقة الحدود الشمالية,أنشطة خدمات الأطعمة والمشروبات,941,136,3,0,1080
2022,1,مكتب منطقة الحدود الشمالية,أنشطة خدمات المعلومات,1,2,0,0,3
2022,1,مكتب منطقة الحدود الشمالية,أنشطة خدمات دعم التعدين,1,1,0,0,2
2022,1,مكتب منطقة الحدود الشمالية,أنشطة زراعة المحاصيل والإنتاج الحيواني والصيد والخدمات المتصلة,246,6,0,0,252
2022,1,مكتب منطقة الحدود الشمالية,الإدارة العامة والدفاع ؛ والضمان الاجتماعي الإلزامي,5,1,0,0,6
2022,1,مكتب منطقة الحدود الشمالية,الإقامة,31,12,1,0,44
2022,1,مكتب منطقة الحدود الشمالية,الأنشطة الإبداعية والفنون وأنشطة الترفيه,3,0,0,0,3
2022,1,مكتب منطقة الحدود الشمالية,الأنشطة الأخرى للتعدين واستغلال المحاجر,5,2,0,1,8
2022,1,مكتب منطقة الحدود الشمالية,الأنشطة الإدارية للمكاتب ، وأنشطة الدعم للمكاتب وغير ذلك من أنشطة الدعم للأعمال,37,1,0,0,38
2022,1,مكتب منطقة الحدود الشمالية,الأنشطة الإيجارية,240,9,0,0,249
2022,1,مكتب منطقة الحدود الشمالية,الأنشطة البيطرية,5,2,0,0,7
2022,1,مكتب منطقة الحدود الشمالية,الأنشطة الرياضية وأنشطة التسلية والترفيه,33,8,0,0,41
2022,1,مكتب منطقة الحدود الشمالية,الأنشطة العقارية,28,3,0,0,31
2022,1,مكتب منطقة الحدود الشمالية,الأنشطة القانونية وأنشطة المحاسبة,6,0,0,0,6
2022,1,مكتب منطقة الحدود الشمالية,الأنشطة المهنية والعلمية والتقنية الأخرى,6,0,0,0,6
2022,1,مكتب منطقة الحدود الشمالية,الاتصالات,8,0,0,0,8
2022,1,مكتب منطقة الحدود الشمالية,التخزين وأنشطة الدعم للنقل,27,4,1,0,32
2022,1,مكتب منطقة الحدود الشمالية,التعليم,15,20,3,0,38
2022,1,مكتب منطقة الحدود الشمالية,الرعاية مع الإقامة,3,1,0,0,4
2022,1,مكتب منطقة الحدود الشمالية,الصحة البشرية,19,22,4,0,45
2022,1,مكتب منطقة الحدود الشمالية,الصناعة التحويلية الأخرى,6,1,0,0,7
2022,1,مكتب منطقة الحدود الشمالية,الطباعة واستنساخ وسائط الأعلام المسجّلة,9,3,0,0,12
2022,1,مكتب منطقة الحدود الشمالية,النقل البري و النقل عبر الأنابيب,318,44,0,0,362
2022,1,مكتب منطقة الحدود الشمالية,النقل الجوي,0,2,0,1,3
2022,1,مكتب منطقة الحدود الشمالية,النقل المائي,3,0,0,0,3
2022,1,مكتب منطقة الحدود الشمالية,الهندسة المدنية,8,0,0,0,8
2022,1,مكتب منطقة الحدود الشمالية,تجارة التجزئة، باستثناء المركبات ذات المحركات والدراجات النارية,1003,124,7,0,1134
2022,1,مكتب منطقة الحدود الشمالية,تجارة الجملة ، باستثناء المركبات ذات المحركات والدراجات النارية,233,32,1,0,266
2022,1,مكتب منطقة الحدود الشمالية,تجارة الجملة والتجزئة ، وإصلاح المركبات ذات المحركات والدراجات النارية,494,66,1,0,561
2022,1,مكتب منطقة الحدود الشمالية,تجميع المياه ومعالجتها وتوصيلها,13,4,0,0,17
2022,1,مكتب منطقة الحدود الشمالية,تشييد المباني,1303,220,19,4,1546
2022,1,مكتب منطقة الحدود الشمالية,تعدين ركازات الفلزات,7,0,0,0,7
2022,1,مكتب منطقة الحدود الشمالية,توصيل الكهرباء والغاز والبخار وتكييف الهواء,4,1,0,0,5
2022,1,مكتب منطقة الحدود الشمالية,صناعة الآلات والمعدات غير المصنفة في موضع أخر,7,0,0,0,7
2022,1,مكتب منطقة الحدود الشمالية,صناعة المركبات ذات المحركات والمركبات المقطورة ونصف المقطورة,9,1,0,0,10
2022,1,مكتب منطقة الحدود الشمالية,صناعة معدات النقل الأخرى,2,1,0,0,3
2022,1,مكتب منطقة الحدود الشمالية,صنع الأثاث,56,6,0,0,62
2022,1,مكتب منطقة الحدود الشمالية,صنع الحواسيب والمنتجات الإلكترونية والبصرية,13,3,0,0,16
2022,1,مكتب منطقة الحدود الشمالية,صُنع الخشب ومنتجات الخشب والفلين ، باستثناء الأثاث ، صُنع أصناف من القش ومواد الضفر,50,5,0,0,55
2022,1,مكتب منطقة الحدود الشمالية,صنع الفلزات القاعدية,22,5,0,0,27
2022,1,مكتب منطقة الحدود الشمالية,صُنع المشروبات,4,3,0,0,7
2022,1,مكتب منطقة الحدود الشمالية,صنع المعدات الكهربائية,43,5,0,0,48
2022,1,مكتب منطقة الحدود الشمالية,صُنع الملبوسات,230,10,0,0,240
2022,1,مكتب منطقة الحدود الشمالية,صُنع المنتجات الجلدية والمنتجات ذات الصلة,5,3,0,0,8
2022,1,مكتب منطقة الحدود الشمالية,صنع المنتجات الصيدلانية الأساسية والمستحضرات الصيدلانية,1,1,0,0,2
2022,1,مكتب منطقة الحدود الشمالية,صُنع المنتجات الغذائية,128,31,0,0,159
2022,1,مكتب منطقة الحدود الشمالية,صُنع المنسوجات,21,2,0,0,23
2022,1,مكتب منطقة الحدود الشمالية,صُنع المواد الكيميائية والمنتجات الكيميائية,14,0,0,0,14
2022,1,مكتب منطقة الحدود الشمالية,صُنع الورق ومنتجات الورق,1,2,0,0,3
2022,1,مكتب منطقة الحدود الشمالية,صنع فحم الكوك والمنتجات النفطية المكررة,1,0,0,0,1
2022,1,مكتب منطقة الحدود الشمالية,صنع منتجات المطاط واللدائن,1,3,0,0,4
2022,1,مكتب منطقة الحدود الشمالية,صنع منتجات المعادن اللافلزية الأخرى,45,19,0,1,65
2022,1,مكتب منطقة الحدود الشمالية,صنع منتجات المعادن المشكلة ( باستثناء الآلات والمعدات ),68,5,0,0,73
2022,1,مكتب منطقة الحدود الشمالية,صيد الأسماك وتربية المائيات,10,0,0,0,10
2022,1,مكتب منطقة الحدود الشمالية,وكالات السفر ومشغّلو الجولات السياحية وخدمات الحجز والأنشطة المتصلة بها,4,2,0,0,6
2022,1,مكتب منطقة الرياض,أبحاث الإعلان والسوق,597,140,1,0,738
2022,1,مكتب منطقة الرياض,إصلاح أجهزة الحاسوب والسلع الشخصية والمنزلية,956,180,28,6,1170
2022,1,مكتب منطقة الرياض,إصلاح وتركيب الآلات والمعدات,619,116,10,5,750
2022,1,مكتب منطقة الرياض,أنشطة أنتاج الأفلام والبرامج التلفزيونية والتسجيلات الصوتية و نشرالموسيقى,208,85,5,3,301
2022,1,مكتب منطقة الرياض,أنشطة الأمن والتحقيقات,115,43,20,10,188
2022,1,مكتب منطقة الرياض,أنشطة الاستخدام,454,107,19,27,607
2022,1,مكتب منطقة الرياض,أنشطة الاسر المعيشية التي تستخدم أفراداً للعمل المنزلي,17,1,0,0,18
2022,1,مكتب منطقة الرياض,أنشطة البرمجة الحاسوبية والخبرة الاستشارية وما يتصل بها من أنشطة,879,416,54,8,1357
2022,1,مكتب منطقة الرياض,أنشطة البرمجة والإذاعة,13,2,0,0,15
2022,1,مكتب منطقة الرياض,أنشطة البريد ونقل الرسائل والطرود بواسطة مندوبين,146,38,6,0,190
2022,1,مكتب منطقة الرياض,أنشطة التشييد المتخصصة,10597,3230,328,50,14205
2022,1,مكتب منطقة الرياض,أنشطة الخدمات الشخصية الأخرى,6452,1473,117,48,8090
2022,1,مكتب منطقة الرياض,أنشطة الخدمات المالية ، فيما عدا تمويل التأمين وصناديق المعاشات,267,123,21,14,425
2022,1,مكتب منطقة الرياض,أنشطة العمل الاجتماعي، دون إقامة، لكبار السن وذوي الإعاقة,193,165,27,2,387
2022,1,مكتب منطقة الرياض,أنشطة المعالجة وخدمات إدارة النفايات الأخرى,6,2,1,0,9
2022,1,مكتب منطقة الرياض,أنشطة المعمارية والهندسية ، والاختبارات الفنية والتحليل,716,429,97,23,1265
2022,1,مكتب منطقة الرياض,أنشطة المكاتب الرئيسية ، وألأنشطة الاستشارية في مجال الإدارة,923,322,36,7,1288
2022,1,مكتب منطقة الرياض,أنشطة المكتبات ودور المحفوظات، والمتاحف والأنشطة الثقافية الأخرى,94,39,2,0,135
2022,1,مكتب منطقة الرياض,أنشطة المنظمات الدولية,6,4,1,0,11
2022,1,مكتب منطقة الرياض,أنشطة المنظمات ذات العضوية,206,49,4,0,259
2022,1,مكتب منطقة الرياض,أنشطة النشر,206,69,4,1,280
2022,1,مكتب منطقة الرياض,أنشطة تقديم الخدمات للمباني وتجميل المواقع,5732,3039,580,127,9478
2022,1,مكتب منطقة الرياض,أنشطة جمع النفايات ومعالجتها وتصريفها ، واسترجاع المواد,42,10,5,6,63
2022,1,مكتب منطقة الرياض,أنشطة خدمات الأطعمة والمشروبات,10853,3612,415,76,14956
2022,1,مكتب منطقة الرياض,أنشطة خدمات المعلومات,232,89,9,2,332
2022,1,مكتب منطقة الرياض,أنشطة خدمات دعم التعدين,80,36,5,3,124
2022,1,مكتب منطقة الرياض,أنشطة زراعة المحاصيل والإنتاج الحيواني والصيد والخدمات المتصلة,3314,312,82,21,3729
2022,1,مكتب منطقة الرياض,استخراج النفط الخام والغاز الطبيعي,7,0,0,0,7
2022,1,مكتب منطقة الرياض,الإدارة العامة والدفاع ؛ والضمان الاجتماعي الإلزامي,333,207,44,15,599
2022,1,مكتب منطقة الرياض,الإقامة,647,340,74,10,1071
2022,1,مكتب منطقة الرياض,الأنشطة الإبداعية والفنون وأنشطة الترفيه,114,19,3,1,137
2022,1,مكتب منطقة الرياض,الأنشطة الأخرى للتعدين واستغلال المحاجر,140,65,13,4,222
2022,1,مكتب منطقة الرياض,الأنشطة الإدارية للمكاتب ، وأنشطة الدعم للمكاتب وغير ذلك من أنشطة الدعم للأعمال,915,145,16,4,1080
2022,1,مكتب منطقة الرياض,الأنشطة الإيجارية,55806,1085,33,3,56927
2022,1,مكتب منطقة الرياض,الأنشطة البيطرية,55,47,6,0,108
2022,1,مكتب منطقة الرياض,الأنشطة الرياضية وأنشطة التسلية والترفيه,533,178,21,5,737
2022,1,مكتب منطقة الرياض,الأنشطة العقارية,1209,449,61,8,1727
2022,1,مكتب منطقة الرياض,الأنشطة القانونية وأنشطة المحاسبة,570,226,14,2,812
2022,1,مكتب منطقة الرياض,الأنشطة المساعدة لأنشطة الخدمات المالية وأنشطة التأمين,85,75,14,1,175
2022,1,مكتب منطقة الرياض,الأنشطة المهنية والعلمية والتقنية الأخرى,422,63,3,0,488
2022,1,مكتب منطقة الرياض,الأنشطة غير المتميزة لإنتاج السلع والخدمات التي تقوم بها الأسر المعيشية الخاصة لإستعمالها الخاص,2,0,0,0,2
2022,1,مكتب منطقة الرياض,الاتصالات,376,162,25,13,576
2022,1,مكتب منطقة الرياض,البحث والتطوير في المجال العلمي,25,12,1,1,39
2022,1,مكتب منطقة الرياض,التخزين وأنشطة الدعم للنقل,1017,260,59,18,1354
2022,1,مكتب منطقة الرياض,التعليم,760,427,167,47,1401
2022,1,مكتب منطقة الرياض,الحراجة وقطع الأخشاب,4,5,2,0,11
2022,1,مكتب منطقة الرياض,الرعاية مع الإقامة,33,17,0,0,50
2022,1,مكتب منطقة الرياض,الصحة البشرية,522,641,197,64,1424
2022,1,مكتب منطقة الرياض,الصرف الصحي,36,16,3,2,57
2022,1,مكتب منطقة الرياض,الصناعة التحويلية الأخرى,200,99,16,4,319
2022,1,مكتب منطقة الرياض,الطباعة واستنساخ وسائط الأعلام المسجّلة,351,205,23,5,584
2022,1,مكتب منطقة الرياض,النقل البري و النقل عبر الأنابيب,10590,756,86,23,11455
2022,1,مكتب منطقة الرياض,النقل الجوي,323,71,32,13,439
2022,1,مكتب منطقة الرياض,النقل المائي,113,15,3,0,131
2022,1,مكتب منطقة الرياض,الهندسة المدنية,331,118,37,14,500
2022,1,مكتب منطقة الرياض,تجارة التجزئة، باستثناء المركبات ذات المحركات والدراجات النارية,20792,6069,747,141,27749
2022,1,مكتب منطقة الرياض,تجارة الجملة ، باستثناء المركبات ذات المحركات والدراجات النارية,11950,5351,705,177,18183
2022,1,مكتب منطقة الرياض,تجارة الجملة والتجزئة ، وإصلاح المركبات ذات المحركات والدراجات النارية,7411,1718,70,8,9207
2022,1,مكتب منطقة الرياض,تجميع المياه ومعالجتها وتوصيلها,124,34,8,0,166
2022,1,مكتب منطقة الرياض,تشييد المباني,11762,4819,1079,342,18002
2022,1,مكتب منطقة الرياض,تعدين الفحم والليغنيت,14,1,1,0,16
2022,1,مكتب منطقة الرياض,تعدين ركازات الفلزات,58,39,0,1,98
2022,1,مكتب منطقة الرياض,تمويل التأمين وإعادة التأمين وصناديق المعاشات التقاعدية باستثناء الضمان الاجتماعي الإلزامي,54,53,15,8,130
2022,1,مكتب منطقة الرياض,توصيل الكهرباء والغاز والبخار وتكييف الهواء,96,69,24,15,204
2022,1,مكتب منطقة الرياض,صناعة الآلات والمعدات غير المصنفة في موضع أخر,220,56,9,2,287
2022,1,مكتب منطقة الرياض,صناعة المركبات ذات المحركات والمركبات المقطورة ونصف المقطورة,105,54,4,1,164
2022,1,مكتب منطقة الرياض,صناعة معدات النقل الأخرى,122,44,8,2,176
2022,1,مكتب منطقة الرياض,صنع الأثاث,1005,388,39,3,1435
2022,1,مكتب منطقة الرياض,صنع الحواسيب والمنتجات الإلكترونية والبصرية,273,119,29,7,428
2022,1,مكتب منطقة الرياض,صُنع الخشب ومنتجات الخشب والفلين ، باستثناء الأثاث ، صُنع أصناف من القش ومواد الضفر,829,255,39,7,1130
2022,1,مكتب منطقة الرياض,صنع الفلزات القاعدية,519,271,69,17,876
2022,1,مكتب منطقة الرياض,صُنع المشروبات,73,38,17,5,133
2022,1,مكتب منطقة الرياض,صنع المعدات الكهربائية,252,118,28,4,402
2022,1,مكتب منطقة الرياض,صُنع الملبوسات,2346,425,23,1,2795
2022,1,مكتب منطقة الرياض,صُنع المنتجات الجلدية والمنتجات ذات الصلة,83,14,1,0,98
2022,1,مكتب منطقة الرياض,صنع المنتجات الصيدلانية الأساسية والمستحضرات الصيدلانية,52,27,7,1,87
2022,1,مكتب منطقة الرياض,صُنع المنتجات الغذائية,1448,555,82,27,2112
2022,1,مكتب منطقة الرياض,صُنع المنسوجات,220,86,12,9,327
2022,1,مكتب منطقة الرياض,صُنع المواد الكيميائية والمنتجات الكيميائية,443,237,39,2,721
2022,1,مكتب منطقة الرياض,صُنع الورق ومنتجات الورق,91,63,9,1,164
2022,1,مكتب منطقة الرياض,صنع فحم الكوك والمنتجات النفطية المكررة,34,12,1,0,47
2022,1,مكتب منطقة الرياض,صُنع منتجات التبغ,1,0,0,0,1
2022,1,مكتب منطقة الرياض,صنع منتجات المطاط واللدائن,313,196,87,12,608
2022,1,مكتب منطقة الرياض,صنع منتجات المعادن اللافلزية الأخرى,1264,716,107,20,2107
2022,1,مكتب منطقة الرياض,صنع منتجات المعادن المشكلة ( باستثناء الآلات والمعدات ),1117,517,106,19,1759
2022,1,مكتب منطقة الرياض,صيد الأسماك وتربية المائيات,3363,16,1,1,3381
2022,1,مكتب منطقة الرياض,وكالات السفر ومشغّلو الجولات السياحية وخدمات الحجز والأنشطة المتصلة بها,253,104,14,5,376
2022,1,مكتب منطقة القصيم,أبحاث الإعلان والسوق,40,9,0,0,49
2022,1,مكتب منطقة القصيم,إصلاح أجهزة الحاسوب والسلع الشخصية والمنزلية,297,36,3,0,336
2022,1,مكتب منطقة القصيم,إصلاح وتركيب الآلات والمعدات,122,11,0,0,133
2022,1,مكتب منطقة القصيم,أنشطة أنتاج الأفلام والبرامج التلفزيونية والتسجيلات الصوتية و نشرالموسيقى,10,1,0,0,11
2022,1,مكتب منطقة القصيم,أنشطة الأمن والتحقيقات,7,5,0,0,12
2022,1,مكتب منطقة القصيم,أنشطة الاستخدام,36,12,1,0,49
2022,1,مكتب منطقة القصيم,أنشطة الاسر المعيشية التي تستخدم أفراداً للعمل المنزلي,11,0,0,0,11
2022,1,مكتب منطقة القصيم,أنشطة البرمجة الحاسوبية والخبرة الاستشارية وما يتصل بها من أنشطة,43,6,0,0,49
2022,1,مكتب منطقة القصيم,أنشطة البرمجة والإذاعة,1,0,0,0,1
2022,1,مكتب منطقة القصيم,أنشطة البريد ونقل الرسائل والطرود بواسطة مندوبين,5,0,0,0,5
2022,1,مكتب منطقة القصيم,أنشطة التشييد المتخصصة,3561,561,79,2,4203
2022,1,مكتب منطقة القصيم,أنشطة الخدمات الشخصية الأخرى,1401,122,7,1,1531
2022,1,مكتب منطقة القصيم,أنشطة الخدمات المالية ، فيما عدا تمويل التأمين وصناديق المعاشات,27,2,0,0,29
2022,1,مكتب منطقة القصيم,أنشطة العمل الاجتماعي، دون إقامة، لكبار السن وذوي الإعاقة,57,55,3,0,115
2022,1,مكتب منطقة القصيم,أنشطة المعمارية والهندسية ، والاختبارات الفنية والتحليل,222,66,9,0,297
2022,1,مكتب منطقة القصيم,أنشطة المكاتب الرئيسية ، وألأنشطة الاستشارية في مجال الإدارة,56,21,1,0,78
2022,1,مكتب منطقة القصيم,أنشطة المكتبات ودور المحفوظات، والمتاحف والأنشطة الثقافية الأخرى,22,14,0,0,36
2022,1,مكتب منطقة القصيم,أنشطة المنظمات الدولية,2,0,0,0,2
2022,1,مكتب منطقة القصيم,أنشطة المنظمات ذات العضوية,36,13,1,0,50
2022,1,مكتب منطقة القصيم,أنشطة النشر,16,6,0,0,22
2022,1,مكتب منطقة القصيم,أنشطة تقديم الخدمات للمباني وتجميل المواقع,1334,285,57,15,1691
2022,1,مكتب منطقة القصيم,أنشطة جمع النفايات ومعالجتها وتصريفها ، واسترجاع المواد,4,6,0,0,10
2022,1,مكتب منطقة القصيم,أنشطة خدمات الأطعمة والمشروبات,3607,883,55,3,4548
2022,1,مكتب منطقة القصيم,أنشطة خدمات المعلومات,17,2,0,0,19
2022,1,مكتب منطقة القصيم,أنشطة خدمات دعم التعدين,9,2,0,0,11
2022,1,مكتب منطقة القصيم,أنشطة زراعة المحاصيل والإنتاج الحيواني والصيد والخدمات المتصلة,1621,91,12,5,1729
2022,1,مكتب منطقة القصيم,الإدارة العامة والدفاع ؛ والضمان الاجتماعي الإلزامي,32,27,2,0,61
2022,1,مكتب منطقة القصيم,الإقامة,116,54,6,1,177
2022,1,مكتب منطقة القصيم,الأنشطة الإبداعية والفنون وأنشطة الترفيه,11,2,0,0,13
2022,1,مكتب منطقة القصيم,الأنشطة الأخرى للتعدين واستغلال المحاجر,17,3,0,0,20
2022,1,مكتب منطقة القصيم,الأنشطة الإدارية للمكاتب ، وأنشطة الدعم للمكاتب وغير ذلك من أنشطة الدعم للأعمال,97,7,3,0,107
2022,1,مكتب منطقة القصيم,الأنشطة الإيجارية,1192,59,3,0,1254
2022,1,مكتب منطقة القصيم,الأنشطة البيطرية,14,5,1,0,20
2022,1,مكتب منطقة القصيم,الأنشطة الرياضية وأنشطة التسلية والترفيه,84,31,0,0,115
2022,1,مكتب منطقة القصيم,الأنشطة العقارية,111,16,2,0,129
2022,1,مكتب منطقة القصيم,الأنشطة القانونية وأنشطة المحاسبة,42,2,0,0,44
2022,1,مكتب منطقة القصيم,الأنشطة المساعدة لأنشطة الخدمات المالية وأنشطة التأمين,1,0,0,0,1
2022,1,مكتب منطقة القصيم,الأنشطة المهنية والعلمية والتقنية الأخرى,25,6,0,0,31
2022,1,مكتب منطقة القصيم,الاتصالات,86,19,0,0,105
2022,1,مكتب منطقة القصيم,البحث والتطوير في المجال العلمي,3,0,0,0,3
2022,1,مكتب منطقة القصيم,التخزين وأنشطة الدعم للنقل,127,38,4,0,169
2022,1,مكتب منطقة القصيم,التعليم,62,40,18,2,122
2022,1,مكتب منطقة القصيم,الحراجة وقطع الأخشاب,4,0,0,0,4
2022,1,مكتب منطقة القصيم,الرعاية مع الإقامة,9,4,0,0,13
2022,1,مكتب منطقة القصيم,الصحة البشرية,47,89,26,4,166
2022,1,مكتب منطقة القصيم,الصرف الصحي,3,1,0,0,4
2022,1,مكتب منطقة القصيم,الصناعة التحويلية الأخرى,32,7,0,0,39
2022,1,مكتب منطقة القصيم,الطباعة واستنساخ وسائط الأعلام المسجّلة,58,26,2,0,86
2022,1,مكتب منطقة القصيم,النقل البري و النقل عبر الأنابيب,953,167,17,3,1140
2022,1,مكتب منطقة القصيم,النقل الجوي,10,10,0,2,22
2022,1,مكتب منطقة القصيم,النقل المائي,11,1,0,0,12
2022,1,مكتب منطقة القصيم,الهندسة المدنية,53,14,5,0,72
2022,1,مكتب منطقة القصيم,تجارة التجزئة، باستثناء المركبات ذات المحركات والدراجات النارية,3704,685,48,7,4444
2022,1,مكتب منطقة القصيم,تجارة الجملة ، باستثناء المركبات ذات المحركات والدراجات النارية,1752,575,52,4,2383
2022,1,مكتب منطقة القصيم,تجارة الجملة والتجزئة ، وإصلاح المركبات ذات المحركات والدراجات النارية,2394,405,15,2,2816
2022,1,مكتب منطقة القصيم,تجميع المياه ومعالجتها وتوصيلها,34,8,0,0,42
2022,1,مكتب منطقة القصيم,تشييد المباني,7718,1777,241,41,9777
2022,1,مكتب منطقة القصيم,تعدين الفحم والليغنيت,3,0,0,0,3
2022,1,مكتب منطقة القصيم,تعدين ركازات الفلزات,37,12,1,0,50
2022,1,مكتب منطقة القصيم,تمويل التأمين وإعادة التأمين وصناديق المعاشات التقاعدية باستثناء الضمان الاجتماعي الإلزامي,2,2,0,0,4
2022,1,مكتب منطقة القصيم,توصيل الكهرباء والغاز والبخار وتكييف الهواء,12,4,0,0,16
2022,1,مكتب منطقة القصيم,صناعة الآلات والمعدات غير المصنفة في موضع أخر,41,7,2,0,50
2022,1,مكتب منطقة القصيم,صناعة المركبات ذات المحركات والمركبات المقطورة ونصف المقطورة,28,7,1,0,36
2022,1,مكتب منطقة القصيم,صناعة معدات النقل الأخرى,21,3,0,0,24
2022,1,مكتب منطقة القصيم,صنع الأثاث,211,58,7,0,276
2022,1,مكتب منطقة القصيم,صنع الحواسيب والمنتجات الإلكترونية والبصرية,49,11,1,0,61
2022,1,مكتب منطقة القصيم,صُنع الخشب ومنتجات الخشب والفلين ، باستثناء الأثاث ، صُنع أصناف من القش ومواد الضفر,264,47,2,1,314
2022,1,مكتب منطقة القصيم,صنع الفلزات القاعدية,233,40,2,0,275
2022,1,مكتب منطقة القصيم,صُنع المشروبات,16,8,4,1,29
2022,1,مكتب منطقة القصيم,صنع المعدات الكهربائية,84,15,3,0,102
2022,1,مكتب منطقة القصيم,صُنع الملبوسات,590,72,4,1,667
2022,1,مكتب منطقة القصيم,صُنع المنتجات الجلدية والمنتجات ذات الصلة,8,0,0,0,8
2022,1,مكتب منطقة القصيم,صنع المنتجات الصيدلانية الأساسية والمستحضرات الصيدلانية,5,4,1,0,10
2022,1,مكتب منطقة القصيم,صُنع المنتجات الغذائية,441,99,36,6,582
2022,1,مكتب منطقة القصيم,صُنع المنسوجات,91,19,1,0,111
2022,1,مكتب منطقة القصيم,صُنع المواد الكيميائية والمنتجات الكيميائية,63,15,4,1,83
2022,1,مكتب منطقة القصيم,صُنع الورق ومنتجات الورق,8,10,4,0,22
2022,1,مكتب منطقة القصيم,صنع فحم الكوك والمنتجات النفطية المكررة,1,1,0,0,2
2022,1,مكتب منطقة القصيم,صُنع منتجات التبغ,2,0,0,0,2
2022,1,مكتب منطقة القصيم,صنع منتجات المطاط واللدائن,27,17,11,1,56
2022,1,مكتب منطقة القصيم,صنع منتجات المعادن اللافلزية الأخرى,194,71,21,3,289
2022,1,مكتب منطقة القصيم,صنع منتجات المعادن المشكلة ( باستثناء الآلات والمعدات ),711,108,7,3,829
2022,1,مكتب منطقة القصيم,صيد الأسماك وتربية المائيات,84,2,0,0,86
2022,1,مكتب منطقة القصيم,وكالات السفر ومشغّلو الجولات السياحية وخدمات الحجز والأنشطة المتصلة بها,46,15,0,0,61
2022,1,مكتب منطقة المدينة المنورة,أبحاث الإعلان والسوق,60,7,0,0,67
2022,1,مكتب منطقة المدينة المنورة,إصلاح أجهزة الحاسوب والسلع الشخصية والمنزلية,173,11,0,0,184
2022,1,مكتب منطقة المدينة المنورة,إصلاح وتركيب الآلات والمعدات,91,10,0,0,101
2022,1,مكتب منطقة المدينة المنورة,أنشطة أنتاج الأفلام والبرامج التلفزيونية والتسجيلات الصوتية و نشرالموسيقى,13,1,0,0,14
2022,1,مكتب منطقة المدينة المنورة,أنشطة الأمن والتحقيقات,9,2,1,0,12
2022,1,مكتب منطقة المدينة المنورة,أنشطة الاستخدام,40,11,0,0,51
2022,1,مكتب منطقة المدينة المنورة,أنشطة الاسر المعيشية التي تستخدم أفراداً للعمل المنزلي,3,0,0,0,3
2022,1,مكتب منطقة المدينة المنورة,أنشطة البرمجة الحاسوبية والخبرة الاستشارية وما يتصل بها من أنشطة,54,7,0,0,61
2022,1,مكتب منطقة المدينة المنورة,أنشطة البرمجة والإذاعة,4,0,0,0,4
2022,1,مكتب منطقة المدينة المنورة,أنشطة البريد ونقل الرسائل والطرود بواسطة مندوبين,8,1,0,0,9
2022,1,مكتب منطقة المدينة المنورة,أنشطة التشييد المتخصصة,1827,349,11,0,2187
2022,1,مكتب منطقة المدينة المنورة,أنشطة الخدمات الشخصية الأخرى,1573,142,2,0,1717
2022,1,مكتب منطقة المدينة المنورة,أنشطة الخدمات المالية ، فيما عدا تمويل التأمين وصناديق المعاشات,25,2,0,0,27
2022,1,مكتب منطقة المدينة المنورة,أنشطة العمل الاجتماعي، دون إقامة، لكبار السن وذوي الإعاقة,74,35,10,0,119
2022,1,مكتب منطقة المدينة المنورة,أنشطة المعمارية والهندسية ، والاختبارات الفنية والتحليل,94,57,3,1,155
2022,1,مكتب منطقة المدينة المنورة,أنشطة المكاتب الرئيسية ، وألأنشطة الاستشارية في مجال الإدارة,62,9,1,0,72
2022,1,مكتب منطقة المدينة المنورة,أنشطة المكتبات ودور المحفوظات، والمتاحف والأنشطة الثقافية الأخرى,64,18,0,0,82
2022,1,مكتب منطقة المدينة المنورة,أنشطة المنظمات ذات العضوية,15,4,3,0,22
2022,1,مكتب منطقة المدينة المنورة,أنشطة النشر,36,13,1,0,50
2022,1,مكتب منطقة المدينة المنورة,أنشطة تقديم الخدمات للمباني وتجميل المواقع,862,219,17,4,1102
2022,1,مكتب منطقة المدينة المنورة,أنشطة جمع النفايات ومعالجتها وتصريفها ، واسترجاع المواد,8,1,0,0,9
2022,1,مكتب منطقة المدينة المنورة,أنشطة خدمات الأطعمة والمشروبات,3639,802,39,1,4481
2022,1,مكتب منطقة المدينة المنورة,أنشطة خدمات المعلومات,16,3,0,0,19
2022,1,مكتب منطقة المدينة المنورة,أنشطة خدمات دعم التعدين,6,8,0,0,14
2022,1,مكتب منطقة المدينة المنورة,أنشطة زراعة المحاصيل والإنتاج الحيواني والصيد والخدمات المتصلة,784,57,3,0,844
2022,1,مكتب منطقة المدينة المنورة,الإدارة العامة والدفاع ؛ والضمان الاجتماعي الإلزامي,49,23,2,0,74
2022,1,مكتب منطقة المدينة المنورة,الإقامة,255,120,31,5,411
2022,1,مكتب منطقة المدينة المنورة,الأنشطة الإبداعية والفنون وأنشطة الترفيه,4,0,0,0,4
2022,1,مكتب منطقة المدينة المنورة,الأنشطة الأخرى للتعدين واستغلال المحاجر,27,5,0,0,32
2022,1,مكتب منطقة المدينة المنورة,الأنشطة الإدارية للمكاتب ، وأنشطة الدعم للمكاتب وغير ذلك من أنشطة الدعم للأعمال,117,11,0,0,128
2022,1,مكتب منطقة المدينة المنورة,الأنشطة الإيجارية,749,46,3,0,798
2022,1,مكتب منطقة المدينة المنورة,الأنشطة البيطرية,16,4,0,0,20
2022,1,مكتب منطقة المدينة المنورة,الأنشطة الرياضية وأنشطة التسلية والترفيه,69,24,1,0,94
2022,1,مكتب منطقة المدينة المنورة,الأنشطة العقارية,163,21,4,0,188
2022,1,مكتب منطقة المدينة المنورة,الأنشطة القانونية وأنشطة المحاسبة,49,11,0,0,60
2022,1,مكتب منطقة المدينة المنورة,الأنشطة المساعدة لأنشطة الخدمات المالية وأنشطة التأمين,12,3,0,0,15
2022,1,مكتب منطقة المدينة المنورة,الأنشطة المهنية والعلمية والتقنية الأخرى,51,12,1,0,64
2022,1,مكتب منطقة المدينة المنورة,الأنشطة غير المتميزة لإنتاج السلع والخدمات التي تقوم بها الأسر المعيشية الخاصة لإستعمالها الخاص,1,0,0,0,1
2022,1,مكتب منطقة المدينة المنورة,الاتصالات,43,3,0,0,46
2022,1,مكتب منطقة المدينة المنورة,البحث والتطوير في المجال العلمي,1,1,0,0,2
2022,1,مكتب منطقة المدينة المنورة,التخزين وأنشطة الدعم للنقل,219,37,1,2,259
2022,1,مكتب منطقة المدينة المنورة,التعليم,81,63,24,1,169
2022,1,مكتب منطقة المدينة المنورة,الحراجة وقطع الأخشاب,1,1,0,0,2
2022,1,مكتب منطقة المدينة المنورة,الرعاية مع الإقامة,12,5,1,0,18
2022,1,مكتب منطقة المدينة المنورة,الصحة البشرية,44,100,23,5,172
2022,1,مكتب منطقة المدينة المنورة,الصرف الصحي,2,2,0,0,4
2022,1,مكتب منطقة المدينة المنورة,الصناعة التحويلية الأخرى,30,14,2,0,46
2022,1,مكتب منطقة المدينة المنورة,الطباعة واستنساخ وسائط الأعلام المسجّلة,55,14,0,0,69
2022,1,مكتب منطقة المدينة المنورة,النقل البري و النقل عبر الأنابيب,697,65,1,0,763
2022,1,مكتب منطقة المدينة المنورة,النقل الجوي,9,2,0,0,11
2022,1,مكتب منطقة المدينة المنورة,النقل المائي,11,0,0,0,11
2022,1,مكتب منطقة المدينة المنورة,الهندسة المدنية,46,5,1,0,52
2022,1,مكتب منطقة المدينة المنورة,تجارة التجزئة، باستثناء المركبات ذات المحركات والدراجات النارية,5371,973,50,4,6398
2022,1,مكتب منطقة المدينة المنورة,تجارة الجملة ، باستثناء المركبات ذات المحركات والدراجات النارية,1685,399,29,2,2115
2022,1,مكتب منطقة المدينة المنورة,تجارة الجملة والتجزئة ، وإصلاح المركبات ذات المحركات والدراجات النارية,1716,225,5,0,1946
2022,1,مكتب منطقة المدينة المنورة,تجميع المياه ومعالجتها وتوصيلها,31,6,1,0,38
2022,1,مكتب منطقة المدينة المنورة,تشييد المباني,3272,864,59,20,4215
2022,1,مكتب منطقة المدينة المنورة,تعدين ركازات الفلزات,20,5,0,0,25
2022,1,مكتب منطقة المدينة المنورة,تمويل التأمين وإعادة التأمين وصناديق المعاشات التقاعدية باستثناء الضمان الاجتماعي الإلزامي,3,0,0,0,3
2022,1,مكتب منطقة المدينة المنورة,توصيل الكهرباء والغاز والبخار وتكييف الهواء,18,9,2,0,29
2022,1,مكتب منطقة المدينة المنورة,صناعة الآلات والمعدات غير المصنفة في موضع أخر,19,3,0,0,22
2022,1,مكتب منطقة المدينة المنورة,صناعة المركبات ذات المحركات والمركبات المقطورة ونصف المقطورة,41,2,0,0,43
2022,1,مكتب منطقة المدينة المنورة,صناعة معدات النقل الأخرى,11,5,0,0,16
2022,1,مكتب منطقة المدينة المنورة,صنع الأثاث,199,37,1,0,237
2022,1,مكتب منطقة المدينة المنورة,صنع الحواسيب والمنتجات الإلكترونية والبصرية,43,10,0,0,53
2022,1,مكتب منطقة المدينة المنورة,صُنع الخشب ومنتجات الخشب والفلين ، باستثناء الأثاث ، صُنع أصناف من القش ومواد الضفر,115,17,0,0,132
2022,1,مكتب منطقة المدينة المنورة,صنع الفلزات القاعدية,89,18,4,1,112
2022,1,مكتب منطقة المدينة المنورة,صُنع المشروبات,18,14,6,1,39
2022,1,مكتب منطقة المدينة المنورة,صنع المعدات الكهربائية,75,13,0,0,88
2022,1,مكتب منطقة المدينة المنورة,صُنع الملبوسات,700,71,2,0,773
2022,1,مكتب منطقة المدينة المنورة,صُنع المنتجات الجلدية والمنتجات ذات الصلة,9,1,1,0,11
2022,1,مكتب منطقة المدينة المنورة,صنع المنتجات الصيدلانية الأساسية والمستحضرات الصيدلانية,5,2,0,0,7
2022,1,مكتب منطقة المدينة المنورة,صُنع المنتجات الغذائية,489,112,6,2,609
2022,1,مكتب منطقة المدينة المنورة,صُنع المنسوجات,85,19,2,0,106
2022,1,مكتب منطقة المدينة المنورة,صُنع المواد الكيميائية والمنتجات الكيميائية,41,13,2,0,56
2022,1,مكتب منطقة المدينة المنورة,صُنع الورق ومنتجات الورق,3,6,1,0,10
2022,1,مكتب منطقة المدينة المنورة,صنع فحم الكوك والمنتجات النفطية المكررة,2,1,0,0,3
2022,1,مكتب منطقة المدينة المنورة,صُنع منتجات التبغ,1,0,0,0,1
2022,1,مكتب منطقة المدينة المنورة,صنع منتجات المطاط واللدائن,32,17,4,0,53
2022,1,مكتب منطقة المدينة المنورة,صنع منتجات المعادن اللافلزية الأخرى,134,54,12,0,200
2022,1,مكتب منطقة المدينة المنورة,صنع منتجات المعادن المشكلة ( باستثناء الآلات والمعدات ),320,48,5,0,373
2022,1,مكتب منطقة المدينة المنورة,صيد الأسماك وتربية المائيات,58,2,0,0,60
2022,1,مكتب منطقة المدينة المنورة,وكالات السفر ومشغّلو الجولات السياحية وخدمات الحجز والأنشطة المتصلة بها,68,15,1,0,84
2022,1,مكتب منطقة تبوك,أبحاث الإعلان والسوق,20,0,1,0,21
2022,1,مكتب منطقة تبوك,إصلاح أجهزة الحاسوب والسلع الشخصية والمنزلية,186,28,0,0,214
2022,1,مكتب منطقة تبوك,إصلاح وتركيب الآلات والمعدات,67,2,0,0,69
2022,1,مكتب منطقة تبوك,أنشطة أنتاج الأفلام والبرامج التلفزيونية والتسجيلات الصوتية و نشرالموسيقى,6,0,0,0,6
2022,1,مكتب منطقة تبوك,أنشطة الأمن والتحقيقات,3,0,0,0,3
2022,1,مكتب منطقة تبوك,أنشطة الاستخدام,21,2,0,1,24
2022,1,مكتب منطقة تبوك,أنشطة الاسر المعيشية التي تستخدم أفراداً للعمل المنزلي,2,1,0,0,3
2022,1,مكتب منطقة تبوك,أنشطة البرمجة الحاسوبية والخبرة الاستشارية وما يتصل بها من أنشطة,11,1,0,0,12
2022,1,مكتب منطقة تبوك,أنشطة البرمجة والإذاعة,0,1,0,0,1
2022,1,مكتب منطقة تبوك,أنشطة البريد ونقل الرسائل والطرود بواسطة مندوبين,5,0,0,0,5
2022,1,مكتب منطقة تبوك,أنشطة التشييد المتخصصة,1207,133,3,0,1343
2022,1,مكتب منطقة تبوك,أنشطة الخدمات الشخصية الأخرى,1030,72,1,1,1104
2022,1,مكتب منطقة تبوك,أنشطة الخدمات المالية ، فيما عدا تمويل التأمين وصناديق المعاشات,16,4,0,0,20
2022,1,مكتب منطقة تبوك,أنشطة العمل الاجتماعي، دون إقامة، لكبار السن وذوي الإعاقة,29,12,1,0,42
2022,1,مكتب منطقة تبوك,أنشطة المعمارية والهندسية ، والاختبارات الفنية والتحليل,66,24,1,0,91
2022,1,مكتب منطقة تبوك,أنشطة المكاتب الرئيسية ، وألأنشطة الاستشارية في مجال الإدارة,11,1,0,0,12
2022,1,مكتب منطقة تبوك,أنشطة المكتبات ودور المحفوظات، والمتاحف والأنشطة الثقافية الأخرى,22,7,0,0,29
2022,1,مكتب منطقة تبوك,أنشطة المنظمات ذات العضوية,8,1,0,0,9
2022,1,مكتب منطقة تبوك,أنشطة النشر,8,0,0,0,8
2022,1,مكتب منطقة تبوك,أنشطة تقديم الخدمات للمباني وتجميل المواقع,368,55,6,1,430
2022,1,مكتب منطقة تبوك,أنشطة جمع النفايات ومعالجتها وتصريفها ، واسترجاع المواد,1,0,0,0,1
2022,1,مكتب منطقة تبوك,أنشطة خدمات الأطعمة والمشروبات,1990,385,24,0,2399
2022,1,مكتب منطقة تبوك,أنشطة خدمات المعلومات,8,2,0,0,10
2022,1,مكتب منطقة تبوك,أنشطة خدمات دعم التعدين,2,1,0,0,3
2022,1,مكتب منطقة تبوك,أنشطة زراعة المحاصيل والإنتاج الحيواني والصيد والخدمات المتصلة,664,35,2,2,703
2022,1,مكتب منطقة تبوك,الإدارة العامة والدفاع ؛ والضمان الاجتماعي الإلزامي,10,8,1,0,19
2022,1,مكتب منطقة تبوك,الإقامة,94,35,3,0,132
2022,1,مكتب منطقة تبوك,الأنشطة الأخرى للتعدين واستغلال المحاجر,7,2,0,0,9
2022,1,مكتب منطقة تبوك,الأنشطة الإدارية للمكاتب ، وأنشطة الدعم للمكاتب وغير ذلك من أنشطة الدعم للأعمال,55,3,1,0,59
2022,1,مكتب منطقة تبوك,الأنشطة الإيجارية,432,6,0,0,438
2022,1,مكتب منطقة تبوك,الأنشطة البيطرية,10,0,0,0,10
2022,1,مكتب منطقة تبوك,الأنشطة الرياضية وأنشطة التسلية والترفيه,60,10,0,0,70
2022,1,مكتب منطقة تبوك,الأنشطة العقارية,56,8,0,0,64
2022,1,مكتب منطقة تبوك,الأنشطة القانونية وأنشطة المحاسبة,11,0,0,0,11
2022,1,مكتب منطقة تبوك,الأنشطة المساعدة لأنشطة الخدمات المالية وأنشطة التأمين,2,0,0,0,2
2022,1,مكتب منطقة تبوك,الأنشطة المهنية والعلمية والتقنية الأخرى,27,1,0,0,28
2022,1,مكتب منطقة تبوك,الاتصالات,18,0,0,0,18
2022,1,مكتب منطقة تبوك,البحث والتطوير في المجال العلمي,1,0,0,0,1
2022,1,مكتب منطقة تبوك,التخزين وأنشطة الدعم للنقل,73,9,0,0,82
2022,1,مكتب منطقة تبوك,التعليم,34,39,17,2,92
2022,1,مكتب منطقة تبوك,الرعاية مع الإقامة,8,0,1,0,9
2022,1,مكتب منطقة تبوك,الصحة البشرية,26,48,10,1,85
2022,1,مكتب منطقة تبوك,الصرف الصحي,1,0,0,0,1
2022,1,مكتب منطقة تبوك,الصناعة التحويلية الأخرى,12,1,0,0,13
2022,1,مكتب منطقة تبوك,الطباعة واستنساخ وسائط الأعلام المسجّلة,30,7,0,0,37
2022,1,مكتب منطقة تبوك,النقل البري و النقل عبر الأنابيب,497,69,5,0,571
2022,1,مكتب منطقة تبوك,النقل الجوي,9,3,3,0,15
2022,1,مكتب منطقة تبوك,النقل المائي,12,1,0,0,13
2022,1,مكتب منطقة تبوك,الهندسة المدنية,15,2,0,0,17
2022,1,مكتب منطقة تبوك,تجارة التجزئة، باستثناء المركبات ذات المحركات والدراجات النارية,2231,291,14,1,2537
2022,1,مكتب منطقة تبوك,تجارة الجملة ، باستثناء المركبات ذات المحركات والدراجات النارية,609,108,6,0,723
2022,1,مكتب منطقة تبوك,تجارة الجملة والتجزئة ، وإصلاح المركبات ذات المحركات والدراجات النارية,1056,131,1,0,1188
2022,1,مكتب منطقة تبوك,تجميع المياه ومعالجتها وتوصيلها,39,3,0,0,42
2022,1,مكتب منطقة تبوك,تشييد المباني,2312,359,25,5,2701
2022,1,مكتب منطقة تبوك,تعدين الفحم والليغنيت,1,0,0,0,1
2022,1,مكتب منطقة تبوك,تعدين ركازات الفلزات,6,2,0,0,8
2022,1,مكتب منطقة تبوك,توصيل الكهرباء والغاز والبخار وتكييف الهواء,9,2,0,0,11
2022,1,مكتب منطقة تبوك,صناعة الآلات والمعدات غير المصنفة في موضع أخر,18,2,0,0,20
2022,1,مكتب منطقة تبوك,صناعة المركبات ذات المحركات والمركبات المقطورة ونصف المقطورة,33,1,0,0,34
2022,1,مكتب منطقة تبوك,صناعة معدات النقل الأخرى,3,1,0,0,4
2022,1,مكتب منطقة تبوك,صنع الأثاث,165,19,0,0,184
2022,1,مكتب منطقة تبوك,صنع الحواسيب والمنتجات الإلكترونية والبصرية,38,4,1,0,43
2022,1,مكتب منطقة تبوك,صُنع الخشب ومنتجات الخشب والفلين ، باستثناء الأثاث ، صُنع أصناف من القش ومواد الضفر,92,23,0,0,115
2022,1,مكتب منطقة تبوك,صنع الفلزات القاعدية,24,3,1,0,28
2022,1,مكتب منطقة تبوك,صُنع المشروبات,26,7,1,0,34
2022,1,مكتب منطقة تبوك,صنع المعدات الكهربائية,44,4,0,0,48
2022,1,مكتب منطقة تبوك,صُنع الملبوسات,648,34,0,0,682
2022,1,مكتب منطقة تبوك,صُنع المنتجات الجلدية والمنتجات ذات الصلة,4,3,0,0,7
2022,1,مكتب منطقة تبوك,صنع المنتجات الصيدلانية الأساسية والمستحضرات الصيدلانية,0,0,0,1,1
2022,1,مكتب منطقة تبوك,صُنع المنتجات الغذائية,217,43,3,2,265
2022,1,مكتب منطقة تبوك,صُنع المنسوجات,44,12,0,0,56
2022,1,مكتب منطقة تبوك,صُنع المواد الكيميائية والمنتجات الكيميائية,22,8,0,0,30
2022,1,مكتب منطقة تبوك,صُنع الورق ومنتجات الورق,2,4,0,0,6
2022,1,مكتب منطقة تبوك,صُنع منتجات التبغ,5,0,0,0,5
2022,1,مكتب منطقة تبوك,صنع منتجات المطاط واللدائن,9,7,1,0,17
2022,1,مكتب منطقة تبوك,صنع منتجات المعادن اللافلزية الأخرى,51,25,1,0,77
2022,1,مكتب منطقة تبوك,صنع منتجات المعادن المشكلة ( باستثناء الآلات والمعدات ),173,36,1,1,211
2022,1,مكتب منطقة تبوك,صيد الأسماك وتربية المائيات,44,9,0,0,53
2022,1,مكتب منطقة تبوك,وكالات السفر ومشغّلو الجولات السياحية وخدمات الحجز والأنشطة المتصلة بها,21,4,0,0,25
2022,1,مكتب منطقة جازان,أبحاث الإعلان والسوق,32,5,0,0,37
2022,1,مكتب منطقة جازان,إصلاح أجهزة الحاسوب والسلع الشخصية والمنزلية,190,9,0,0,199
2022,1,مكتب منطقة جازان,إصلاح وتركيب الآلات والمعدات,184,6,0,0,190
2022,1,مكتب منطقة جازان,أنشطة أنتاج الأفلام والبرامج التلفزيونية والتسجيلات الصوتية و نشرالموسيقى,11,0,0,0,11
2022,1,مكتب منطقة جازان,أنشطة الأمن والتحقيقات,7,1,0,0,8
2022,1,مكتب منطقة جازان,أنشطة الاستخدام,22,2,0,0,24
2022,1,مكتب منطقة جازان,أنشطة الاسر المعيشية التي تستخدم أفراداً للعمل المنزلي,6,0,0,0,6
2022,1,مكتب منطقة جازان,أنشطة البرمجة الحاسوبية والخبرة الاستشارية وما يتصل بها من أنشطة,14,0,0,0,14
2022,1,مكتب منطقة جازان,أنشطة البريد ونقل الرسائل والطرود بواسطة مندوبين,1,0,0,0,1
2022,1,مكتب منطقة جازان,أنشطة التشييد المتخصصة,1451,150,6,0,1607
2022,1,مكتب منطقة جازان,أنشطة الخدمات الشخصية الأخرى,1369,77,0,0,1446
2022,1,مكتب منطقة جازان,أنشطة الخدمات المالية ، فيما عدا تمويل التأمين وصناديق المعاشات,26,6,0,0,32
2022,1,مكتب منطقة جازان,أنشطة العمل الاجتماعي، دون إقامة، لكبار السن وذوي الإعاقة,32,29,2,0,63
2022,1,مكتب منطقة جازان,أنشطة المعالجة وخدمات إدارة النفايات الأخرى,1,0,0,0,1
2022,1,مكتب منطقة جازان,أنشطة المعمارية والهندسية ، والاختبارات الفنية والتحليل,72,22,2,0,96
2022,1,مكتب منطقة جازان,أنشطة المكاتب الرئيسية ، وألأنشطة الاستشارية في مجال الإدارة,28,4,0,0,32
2022,1,مكتب منطقة جازان,أنشطة المكتبات ودور المحفوظات، والمتاحف والأنشطة الثقافية الأخرى,23,10,1,0,34
2022,1,مكتب منطقة جازان,أنشطة المنظمات ذات العضوية,32,5,0,0,37
2022,1,مكتب منطقة جازان,أنشطة النشر,19,2,0,0,21
2022,1,مكتب منطقة جازان,أنشطة تقديم الخدمات للمباني وتجميل المواقع,412,77,2,0,491
2022,1,مكتب منطقة جازان,أنشطة جمع النفايات ومعالجتها وتصريفها ، واسترجاع المواد,1,0,0,0,1
2022,1,مكتب منطقة جازان,أنشطة خدمات الأطعمة والمشروبات,3588,558,18,0,4164
2022,1,مكتب منطقة جازان,أنشطة خدمات المعلومات,14,2,0,0,16
2022,1,مكتب منطقة جازان,أنشطة خدمات دعم التعدين,10,4,0,0,14
2022,1,مكتب منطقة جازان,أنشطة زراعة المحاصيل والإنتاج الحيواني والصيد والخدمات المتصلة,583,31,1,0,615
2022,1,مكتب منطقة جازان,الإدارة العامة والدفاع ؛ والضمان الاجتماعي الإلزامي,20,6,0,0,26
2022,1,مكتب منطقة جازان,الإقامة,219,48,5,0,272
2022,1,مكتب منطقة جازان,الأنشطة الإبداعية والفنون وأنشطة الترفيه,3,0,0,0,3
2022,1,مكتب منطقة جازان,الأنشطة الأخرى للتعدين واستغلال المحاجر,13,5,0,0,18
2022,1,مكتب منطقة جازان,الأنشطة الإدارية للمكاتب ، وأنشطة الدعم للمكاتب وغير ذلك من أنشطة الدعم للأعمال,48,2,0,0,50
2022,1,مكتب منطقة جازان,الأنشطة الإيجارية,1250,27,1,0,1278
2022,1,مكتب منطقة جازان,الأنشطة البيطرية,7,5,0,0,12
2022,1,مكتب منطقة جازان,الأنشطة الرياضية وأنشطة التسلية والترفيه,50,8,1,0,59
2022,1,مكتب منطقة جازان,الأنشطة العقارية,78,11,0,2,91
2022,1,مكتب منطقة جازان,الأنشطة القانونية وأنشطة المحاسبة,15,3,0,0,18
2022,1,مكتب منطقة جازان,الأنشطة المساعدة لأنشطة الخدمات المالية وأنشطة التأمين,1,0,0,0,1
2022,1,مكتب منطقة جازان,الأنشطة المهنية والعلمية والتقنية الأخرى,29,2,0,0,31
2022,1,مكتب منطقة جازان,الأنشطة غير المتميزة لإنتاج السلع والخدمات التي تقوم بها الأسر المعيشية الخاصة لإستعمالها الخاص,1,0,0,0,1
2022,1,مكتب منطقة جازان,الاتصالات,21,3,0,0,24
2022,1,مكتب منطقة جازان,البحث والتطوير في المجال العلمي,1,0,0,0,1
2022,1,مكتب منطقة جازان,التخزين وأنشطة الدعم للنقل,83,16,3,1,103
2022,1,مكتب منطقة جازان,التعليم,45,33,4,0,82
2022,1,مكتب منطقة جازان,الحراجة وقطع الأخشاب,1,1,0,0,2
2022,1,مكتب منطقة جازان,الرعاية مع الإقامة,9,3,0,0,12
2022,1,مكتب منطقة جازان,الصحة البشرية,46,71,12,2,131
2022,1,مكتب منطقة جازان,الصرف الصحي,1,2,0,0,3
2022,1,مكتب منطقة جازان,الصناعة التحويلية الأخرى,16,8,0,0,24
2022,1,مكتب منطقة جازان,الطباعة واستنساخ وسائط الأعلام المسجّلة,16,4,0,0,20
2022,1,مكتب منطقة جازان,النقل البري و النقل عبر الأنابيب,368,33,2,0,403
2022,1,مكتب منطقة جازان,النقل الجوي,10,1,0,0,11
2022,1,مكتب منطقة جازان,النقل المائي,4,2,1,0,7
2022,1,مكتب منطقة جازان,الهندسة المدنية,24,3,2,0,29
2022,1,مكتب منطقة جازان,تجارة التجزئة، باستثناء المركبات ذات المحركات والدراجات النارية,4217,538,18,1,4774
2022,1,مكتب منطقة جازان,تجارة الجملة ، باستثناء المركبات ذات المحركات والدراجات النارية,1447,297,16,0,1760
2022,1,مكتب منطقة جازان,تجارة الجملة والتجزئة ، وإصلاح المركبات ذات المحركات والدراجات النارية,1622,163,5,1,1791
2022,1,مكتب منطقة جازان,تجميع المياه ومعالجتها وتوصيلها,56,6,1,1,64
2022,1,مكتب منطقة جازان,تشييد المباني,2842,428,33,1,3304
2022,1,مكتب منطقة جازان,تعدين ركازات الفلزات,24,6,0,0,30
2022,1,مكتب منطقة جازان,تمويل التأمين وإعادة التأمين وصناديق المعاشات التقاعدية باستثناء الضمان الاجتماعي الإلزامي,1,1,0,0,2
2022,1,مكتب منطقة جازان,توصيل الكهرباء والغاز والبخار وتكييف الهواء,14,8,1,0,23
2022,1,مكتب منطقة جازان,صناعة الآلات والمعدات غير المصنفة في موضع أخر,39,2,0,0,41
2022,1,مكتب منطقة جازان,صناعة المركبات ذات المحركات والمركبات المقطورة ونصف المقطورة,84,4,0,0,88
2022,1,مكتب منطقة جازان,صناعة معدات النقل الأخرى,13,3,0,0,16
2022,1,مكتب منطقة جازان,صنع الأثاث,216,12,0,0,228
2022,1,مكتب منطقة جازان,صنع الحواسيب والمنتجات الإلكترونية والبصرية,40,8,0,0,48
2022,1,مكتب منطقة جازان,صُنع الخشب ومنتجات الخشب والفلين ، باستثناء الأثاث ، صُنع أصناف من القش ومواد الضفر,170,15,0,0,185
2022,1,مكتب منطقة جازان,صنع الفلزات القاعدية,61,12,1,2,76
2022,1,مكتب منطقة جازان,صُنع المشروبات,17,5,3,1,26
2022,1,مكتب منطقة جازان,صنع المعدات الكهربائية,74,5,0,0,79
2022,1,مكتب منطقة جازان,صُنع الملبوسات,442,40,0,0,482
2022,1,مكتب منطقة جازان,صُنع المنتجات الجلدية والمنتجات ذات الصلة,54,1,0,0,55
2022,1,مكتب منطقة جازان,صنع المنتجات الصيدلانية الأساسية والمستحضرات الصيدلانية,6,1,0,0,7
2022,1,مكتب منطقة جازان,صُنع المنتجات الغذائية,303,73,5,0,381
2022,1,مكتب منطقة جازان,صُنع المنسوجات,14,4,0,0,18
2022,1,مكتب منطقة جازان,صُنع المواد الكيميائية والمنتجات الكيميائية,38,9,2,0,49
2022,1,مكتب منطقة جازان,صُنع الورق ومنتجات الورق,3,1,1,0,5
2022,1,مكتب منطقة جازان,صنع فحم الكوك والمنتجات النفطية المكررة,2,0,0,0,2
2022,1,مكتب منطقة جازان,صُنع منتجات التبغ,0,1,0,0,1
2022,1,مكتب منطقة جازان,صنع منتجات المطاط واللدائن,11,8,1,0,20
2022,1,مكتب منطقة جازان,صنع منتجات المعادن اللافلزية الأخرى,132,44,14,1,191
2022,1,مكتب منطقة جازان,صنع منتجات المعادن المشكلة ( باستثناء الآلات والمعدات ),501,17,1,0,519
2022,1,مكتب منطقة جازان,صيد الأسماك وتربية المائيات,156,65,4,0,225
2022,1,مكتب منطقة جازان,وكالات السفر ومشغّلو الجولات السياحية وخدمات الحجز والأنشطة المتصلة بها,22,3,0,0,25
2022,1,مكتب منطقة حائل,أبحاث الإعلان والسوق,27,5,0,0,32
2022,1,مكتب منطقة حائل,إصلاح أجهزة الحاسوب والسلع الشخصية والمنزلية,152,13,0,0,165
2022,1,مكتب منطقة حائل,إصلاح وتركيب الآلات والمعدات,34,2,0,0,36
2022,1,مكتب منطقة حائل,أنشطة أنتاج الأفلام والبرامج التلفزيونية والتسجيلات الصوتية و نشرالموسيقى,7,0,0,0,7
2022,1,مكتب منطقة حائل,أنشطة الأمن والتحقيقات,6,1,0,0,7
2022,1,مكتب منطقة حائل,أنشطة الاستخدام,12,3,0,0,15
2022,1,مكتب منطقة حائل,أنشطة الاسر المعيشية التي تستخدم أفراداً للعمل المنزلي,1,0,0,0,1
2022,1,مكتب منطقة حائل,أنشطة البرمجة الحاسوبية والخبرة الاستشارية وما يتصل بها من أنشطة,5,4,0,0,9
2022,1,مكتب منطقة حائل,أنشطة البريد ونقل الرسائل والطرود بواسطة مندوبين,2,1,0,0,3
2022,1,مكتب منطقة حائل,أنشطة التشييد المتخصصة,1253,170,2,0,1425
2022,1,مكتب منطقة حائل,أنشطة الخدمات الشخصية الأخرى,810,70,1,0,881
2022,1,مكتب منطقة حائل,أنشطة الخدمات المالية ، فيما عدا تمويل التأمين وصناديق المعاشات,24,3,0,0,27
2022,1,مكتب منطقة حائل,أنشطة العمل الاجتماعي، دون إقامة، لكبار السن وذوي الإعاقة,44,18,0,0,62
2022,1,مكتب منطقة حائل,أنشطة المعمارية والهندسية ، والاختبارات الفنية والتحليل,73,18,1,0,92
2022,1,مكتب منطقة حائل,أنشطة المكاتب الرئيسية ، وألأنشطة الاستشارية في مجال الإدارة,22,2,0,0,24
2022,1,مكتب منطقة حائل,أنشطة المكتبات ودور المحفوظات، والمتاحف والأنشطة الثقافية الأخرى,7,2,0,0,9
2022,1,مكتب منطقة حائل,أنشطة المنظمات ذات العضوية,29,4,0,0,33
2022,1,مكتب منطقة حائل,أنشطة النشر,38,1,0,0,39
2022,1,مكتب منطقة حائل,أنشطة تقديم الخدمات للمباني وتجميل المواقع,365,53,8,1,427
2022,1,مكتب منطقة حائل,أنشطة جمع النفايات ومعالجتها وتصريفها ، واسترجاع المواد,2,1,0,0,3
2022,1,مكتب منطقة حائل,أنشطة خدمات الأطعمة والمشروبات,1834,292,19,1,2146
2022,1,مكتب منطقة حائل,أنشطة خدمات المعلومات,8,1,0,0,9
2022,1,مكتب منطقة حائل,أنشطة خدمات دعم التعدين,8,3,0,0,11
2022,1,مكتب منطقة حائل,أنشطة زراعة المحاصيل والإنتاج الحيواني والصيد والخدمات المتصلة,1488,56,6,1,1551
2022,1,مكتب منطقة حائل,الإدارة العامة والدفاع ؛ والضمان الاجتماعي الإلزامي,16,7,0,0,23
2022,1,مكتب منطقة حائل,الإقامة,75,20,1,0,96
2022,1,مكتب منطقة حائل,الأنشطة الإبداعية والفنون وأنشطة الترفيه,2,1,0,0,3
2022,1,مكتب منطقة حائل,الأنشطة الأخرى للتعدين واستغلال المحاجر,31,4,0,0,35
2022,1,مكتب منطقة حائل,الأنشطة الإدارية للمكاتب ، وأنشطة الدعم للمكاتب وغير ذلك من أنشطة الدعم للأعمال,67,4,0,0,71
2022,1,مكتب منطقة حائل,الأنشطة الإيجارية,918,41,0,0,959
2022,1,مكتب منطقة حائل,الأنشطة البيطرية,4,0,0,0,4
2022,1,مكتب منطقة حائل,الأنشطة الرياضية وأنشطة التسلية والترفيه,51,19,0,0,70
2022,1,مكتب منطقة حائل,الأنشطة العقارية,75,7,0,0,82
2022,1,مكتب منطقة حائل,الأنشطة القانونية وأنشطة المحاسبة,10,3,0,0,13
2022,1,مكتب منطقة حائل,الأنشطة المهنية والعلمية والتقنية الأخرى,17,0,1,0,18
2022,1,مكتب منطقة حائل,الاتصالات,28,2,0,0,30
2022,1,مكتب منطقة حائل,التخزين وأنشطة الدعم للنقل,66,17,0,0,83
2022,1,مكتب منطقة حائل,التعليم,31,28,4,0,63
2022,1,مكتب منطقة حائل,الحراجة وقطع الأخشاب,2,0,0,0,2
2022,1,مكتب منطقة حائل,الرعاية مع الإقامة,11,3,0,0,14
2022,1,مكتب منطقة حائل,الصحة البشرية,43,62,16,2,123
2022,1,مكتب منطقة حائل,الصرف الصحي,2,0,0,0,2
2022,1,مكتب منطقة حائل,الصناعة التحويلية الأخرى,11,2,0,0,13
2022,1,مكتب منطقة حائل,الطباعة واستنساخ وسائط الأعلام المسجّلة,41,7,0,0,48
2022,1,مكتب منطقة حائل,النقل البري و النقل عبر الأنابيب,567,36,2,0,605
2022,1,مكتب منطقة حائل,النقل الجوي,22,5,0,0,27
2022,1,مكتب منطقة حائل,النقل المائي,3,0,0,0,3
2022,1,مكتب منطقة حائل,الهندسة المدنية,16,8,3,0,27
2022,1,مكتب منطقة حائل,تجارة التجزئة، باستثناء المركبات ذات المحركات والدراجات النارية,1836,291,14,0,2141
2022,1,مكتب منطقة حائل,تجارة الجملة ، باستثناء المركبات ذات المحركات والدراجات النارية,502,100,9,2,613
2022,1,مكتب منطقة حائل,تجارة الجملة والتجزئة ، وإصلاح المركبات ذات المحركات والدراجات النارية,848,159,2,0,1009
2022,1,مكتب منطقة حائل,تجميع المياه ومعالجتها وتوصيلها,20,2,1,0,23
2022,1,مكتب منطقة حائل,تشييد المباني,2972,560,56,8,3596
2022,1,مكتب منطقة حائل,تعدين الفحم والليغنيت,4,0,0,0,4
2022,1,مكتب منطقة حائل,تعدين ركازات الفلزات,5,0,0,0,5
2022,1,مكتب منطقة حائل,توصيل الكهرباء والغاز والبخار وتكييف الهواء,14,5,2,0,21
2022,1,مكتب منطقة حائل,صناعة الآلات والمعدات غير المصنفة في موضع أخر,24,3,0,0,27
2022,1,مكتب منطقة حائل,صناعة المركبات ذات المحركات والمركبات المقطورة ونصف المقطورة,38,2,0,0,40
2022,1,مكتب منطقة حائل,صناعة معدات النقل الأخرى,8,0,0,0,8
2022,1,مكتب منطقة حائل,صنع الأثاث,143,20,0,0,163
2022,1,مكتب منطقة حائل,صنع الحواسيب والمنتجات الإلكترونية والبصرية,37,4,0,0,41
2022,1,مكتب منطقة حائل,صُنع الخشب ومنتجات الخشب والفلين ، باستثناء الأثاث ، صُنع أصناف من القش ومواد الضفر,64,10,1,0,75
2022,1,مكتب منطقة حائل,صنع الفلزات القاعدية,89,27,2,0,118
2022,1,مكتب منطقة حائل,صُنع المشروبات,8,7,0,0,15
2022,1,مكتب منطقة حائل,صنع المعدات الكهربائية,48,3,0,0,51
2022,1,مكتب منطقة حائل,صُنع الملبوسات,342,33,0,0,375
2022,1,مكتب منطقة حائل,صُنع المنتجات الجلدية والمنتجات ذات الصلة,6,2,0,0,8
2022,1,مكتب منطقة حائل,صنع المنتجات الصيدلانية الأساسية والمستحضرات الصيدلانية,3,0,0,0,3
2022,1,مكتب منطقة حائل,صُنع المنتجات الغذائية,226,36,7,0,269
2022,1,مكتب منطقة حائل,صُنع المنسوجات,57,19,0,0,76
2022,1,مكتب منطقة حائل,صُنع المواد الكيميائية والمنتجات الكيميائية,102,30,0,0,132
2022,1,مكتب منطقة حائل,صُنع الورق ومنتجات الورق,4,3,0,0,7
2022,1,مكتب منطقة حائل,صنع منتجات المطاط واللدائن,13,7,3,0,23
2022,1,مكتب منطقة حائل,صنع منتجات المعادن اللافلزية الأخرى,113,41,9,1,164
2022,1,مكتب منطقة حائل,صنع منتجات المعادن المشكلة ( باستثناء الآلات والمعدات ),133,33,1,0,167
2022,1,مكتب منطقة حائل,صيد الأسماك وتربية المائيات,141,0,0,0,141
2022,1,مكتب منطقة حائل,وكالات السفر ومشغّلو الجولات السياحية وخدمات الحجز والأنشطة المتصلة بها,9,3,0,0,12
2022,1,مكتب منطقة عسير,أبحاث الإعلان والسوق,54,4,0,0,58
2022,1,مكتب منطقة عسير,إصلاح أجهزة الحاسوب والسلع الشخصية والمنزلية,260,25,1,0,286
2022,1,مكتب منطقة عسير,إصلاح وتركيب الآلات والمعدات,76,5,1,0,82
2022,1,مكتب منطقة عسير,أنشطة أنتاج الأفلام والبرامج التلفزيونية والتسجيلات الصوتية و نشرالموسيقى,15,0,0,0,15
2022,1,مكتب منطقة عسير,أنشطة الأمن والتحقيقات,10,5,2,1,18
2022,1,مكتب منطقة عسير,أنشطة الاستخدام,49,8,0,1,58
2022,1,مكتب منطقة عسير,أنشطة البرمجة الحاسوبية والخبرة الاستشارية وما يتصل بها من أنشطة,19,6,0,0,25
2022,1,مكتب منطقة عسير,أنشطة البرمجة والإذاعة,8,3,0,0,11
2022,1,مكتب منطقة عسير,أنشطة البريد ونقل الرسائل والطرود بواسطة مندوبين,7,2,0,0,9
2022,1,مكتب منطقة عسير,أنشطة التشييد المتخصصة,2014,262,9,1,2286
2022,1,مكتب منطقة عسير,أنشطة الخدمات الشخصية الأخرى,1352,115,2,2,1471
2022,1,مكتب منطقة عسير,أنشطة الخدمات المالية ، فيما عدا تمويل التأمين وصناديق المعاشات,20,1,0,0,21
2022,1,مكتب منطقة عسير,أنشطة العمل الاجتماعي، دون إقامة، لكبار السن وذوي الإعاقة,51,41,5,0,97
2022,1,مكتب منطقة عسير,أنشطة المعمارية والهندسية ، والاختبارات الفنية والتحليل,139,47,4,0,190
2022,1,مكتب منطقة عسير,أنشطة المكاتب الرئيسية ، وألأنشطة الاستشارية في مجال الإدارة,26,2,1,0,29
2022,1,مكتب منطقة عسير,أنشطة المكتبات ودور المحفوظات، والمتاحف والأنشطة الثقافية الأخرى,33,17,1,0,51
2022,1,مكتب منطقة عسير,أنشطة المنظمات ذات العضوية,25,5,0,0,30
2022,1,مكتب منطقة عسير,أنشطة النشر,19,1,1,0,21
2022,1,مكتب منطقة عسير,أنشطة تقديم الخدمات للمباني وتجميل المواقع,444,70,6,2,522
2022,1,مكتب منطقة عسير,أنشطة جمع النفايات ومعالجتها وتصريفها ، واسترجاع المواد,6,2,0,0,8
2022,1,مكتب منطقة عسير,أنشطة خدمات الأطعمة والمشروبات,4231,920,57,4,5212
2022,1,مكتب منطقة عسير,أنشطة خدمات المعلومات,18,3,0,0,21
2022,1,مكتب منطقة عسير,أنشطة خدمات دعم التعدين,24,5,1,0,30
2022,1,مكتب منطقة عسير,أنشطة زراعة المحاصيل والإنتاج الحيواني والصيد والخدمات المتصلة,1370,37,2,0,1409
2022,1,مكتب منطقة عسير,الإدارة العامة والدفاع ؛ والضمان الاجتماعي الإلزامي,11,13,1,0,25
2022,1,مكتب منطقة عسير,الإقامة,268,81,5,1,355
2022,1,مكتب منطقة عسير,الأنشطة الإبداعية والفنون وأنشطة الترفيه,3,0,0,0,3
2022,1,مكتب منطقة عسير,الأنشطة الأخرى للتعدين واستغلال المحاجر,24,6,0,0,30
2022,1,مكتب منطقة عسير,الأنشطة الإدارية للمكاتب ، وأنشطة الدعم للمكاتب وغير ذلك من أنشطة الدعم للأعمال,123,8,1,1,133
2022,1,مكتب منطقة عسير,الأنشطة الإيجارية,1118,77,2,1,1198
2022,1,مكتب منطقة عسير,الأنشطة البيطرية,12,6,2,0,20
2022,1,مكتب منطقة عسير,الأنشطة الرياضية وأنشطة التسلية والترفيه,93,33,0,0,126
2022,1,مكتب منطقة عسير,الأنشطة العقارية,117,19,1,0,137
2022,1,مكتب منطقة عسير,الأنشطة القانونية وأنشطة المحاسبة,28,5,0,0,33
2022,1,مكتب منطقة عسير,الأنشطة المساعدة لأنشطة الخدمات المالية وأنشطة التأمين,4,0,0,0,4
2022,1,مكتب منطقة عسير,الأنشطة المهنية والعلمية والتقنية الأخرى,33,4,2,0,39
2022,1,مكتب منطقة عسير,الأنشطة غير المتميزة لإنتاج السلع والخدمات التي تقوم بها الأسر المعيشية الخاصة لإستعمالها الخاص,1,0,0,0,1
2022,1,مكتب منطقة عسير,الاتصالات,25,2,0,0,27
2022,1,مكتب منطقة عسير,التخزين وأنشطة الدعم للنقل,96,29,3,0,128
2022,1,مكتب منطقة عسير,التعليم,38,44,11,1,94
2022,1,مكتب منطقة عسير,الرعاية مع الإقامة,13,3,0,0,16
2022,1,مكتب منطقة عسير,الصحة البشرية,80,102,39,5,226
2022,1,مكتب منطقة عسير,الصرف الصحي,1,2,1,0,4
2022,1,مكتب منطقة عسير,الصناعة التحويلية الأخرى,28,10,1,0,39
2022,1,مكتب منطقة عسير,الطباعة واستنساخ وسائط الأعلام المسجّلة,32,13,2,0,47
2022,1,مكتب منطقة عسير,النقل البري و النقل عبر الأنابيب,1298,155,9,2,1464
2022,1,مكتب منطقة عسير,النقل الجوي,13,1,0,0,14
2022,1,مكتب منطقة عسير,النقل المائي,12,0,0,0,12
2022,1,مكتب منطقة عسير,الهندسة المدنية,43,10,2,0,55
2022,1,مكتب منطقة عسير,تجارة التجزئة، باستثناء المركبات ذات المحركات والدراجات النارية,4284,728,42,5,5059
2022,1,مكتب منطقة عسير,تجارة الجملة ، باستثناء المركبات ذات المحركات والدراجات النارية,1158,254,18,3,1433
2022,1,مكتب منطقة عسير,تجارة الجملة والتجزئة ، وإصلاح المركبات ذات المحركات والدراجات النارية,1936,369,12,0,2317
2022,1,مكتب منطقة عسير,تجميع المياه ومعالجتها وتوصيلها,109,25,0,0,134
2022,1,مكتب منطقة عسير,تشييد المباني,6183,1312,107,14,7616
2022,1,مكتب منطقة عسير,تعدين الفحم والليغنيت,1,0,0,0,1
2022,1,مكتب منطقة عسير,تعدين ركازات الفلزات,87,16,0,0,103
2022,1,مكتب منطقة عسير,تمويل التأمين وإعادة التأمين وصناديق المعاشات التقاعدية باستثناء الضمان الاجتماعي الإلزامي,1,2,1,0,4
2022,1,مكتب منطقة عسير,توصيل الكهرباء والغاز والبخار وتكييف الهواء,8,8,2,1,19
2022,1,مكتب منطقة عسير,صناعة الآلات والمعدات غير المصنفة في موضع أخر,42,5,0,0,47
2022,1,مكتب منطقة عسير,صناعة المركبات ذات المحركات والمركبات المقطورة ونصف المقطورة,39,4,1,0,44
2022,1,مكتب منطقة عسير,صناعة معدات النقل الأخرى,10,0,0,0,10
2022,1,مكتب منطقة عسير,صنع الأثاث,279,30,0,0,309
2022,1,مكتب منطقة عسير,صنع الحواسيب والمنتجات الإلكترونية والبصرية,71,20,0,0,91
2022,1,مكتب منطقة عسير,صُنع الخشب ومنتجات الخشب والفلين ، باستثناء الأثاث ، صُنع أصناف من القش ومواد الضفر,272,56,1,0,329
2022,1,مكتب منطقة عسير,صنع الفلزات القاعدية,113,30,0,0,143
2022,1,مكتب منطقة عسير,صُنع المشروبات,26,8,1,0,35
2022,1,مكتب منطقة عسير,صنع المعدات الكهربائية,52,8,0,0,60
2022,1,مكتب منطقة عسير,صُنع الملبوسات,611,58,1,0,670
2022,1,مكتب منطقة عسير,صُنع المنتجات الجلدية والمنتجات ذات الصلة,11,3,0,0,14
2022,1,مكتب منطقة عسير,صنع المنتجات الصيدلانية الأساسية والمستحضرات الصيدلانية,3,1,0,0,4
2022,1,مكتب منطقة عسير,صُنع المنتجات الغذائية,367,106,12,1,486
2022,1,مكتب منطقة عسير,صُنع المنسوجات,42,11,2,0,55
2022,1,مكتب منطقة عسير,صُنع المواد الكيميائية والمنتجات الكيميائية,52,21,5,0,78
2022,1,مكتب منطقة عسير,صُنع الورق ومنتجات الورق,10,5,1,0,16
2022,1,مكتب منطقة عسير,صنع فحم الكوك والمنتجات النفطية المكررة,2,0,0,0,2
2022,1,مكتب منطقة عسير,صُنع منتجات التبغ,1,0,0,0,1
2022,1,مكتب منطقة عسير,صنع منتجات المطاط واللدائن,33,13,2,1,49
2022,1,مكتب منطقة عسير,صنع منتجات المعادن اللافلزية الأخرى,182,97,20,2,301
2022,1,مكتب منطقة عسير,صنع منتجات المعادن المشكلة ( باستثناء الآلات والمعدات ),417,33,4,0,454
2022,1,مكتب منطقة عسير,صيد الأسماك وتربية المائيات,107,15,0,0,122
2022,1,مكتب منطقة عسير,وكالات السفر ومشغّلو الجولات السياحية وخدمات الحجز والأنشطة المتصلة بها,22,5,0,0,27
2022,1,مكتب منطقة مكة المكرمة/جدة,أبحاث الإعلان والسوق,293,54,2,0,349
2022,1,مكتب منطقة مكة المكرمة/جدة,إصلاح أجهزة الحاسوب والسلع الشخصية والمنزلية,573,89,7,1,670
2022,1,مكتب منطقة مكة المكرمة/جدة,إصلاح وتركيب الآلات والمعدات,272,61,13,1,347
2022,1,مكتب منطقة مكة المكرمة/جدة,أنشطة أنتاج الأفلام والبرامج التلفزيونية والتسجيلات الصوتية و نشرالموسيقى,101,20,0,0,121
2022,1,مكتب منطقة مكة المكرمة/جدة,أنشطة الأمن والتحقيقات,40,22,9,2,73
2022,1,مكتب منطقة مكة المكرمة/جدة,أنشطة الاستخدام,156,29,7,3,195
2022,1,مكتب منطقة مكة المكرمة/جدة,أنشطة الاسر المعيشية التي تستخدم أفراداً للعمل المنزلي,8,0,0,0,8
2022,1,مكتب منطقة مكة المكرمة/جدة,أنشطة البرمجة الحاسوبية والخبرة الاستشارية وما يتصل بها من أنشطة,350,127,11,3,491
2022,1,مكتب منطقة مكة المكرمة/جدة,أنشطة البرمجة والإذاعة,3,2,0,0,5
2022,1,مكتب منطقة مكة المكرمة/جدة,أنشطة البريد ونقل الرسائل والطرود بواسطة مندوبين,30,4,0,0,34
2022,1,مكتب منطقة مكة المكرمة/جدة,أنشطة التشييد المتخصصة,5943,1697,145,23,7808
2022,1,مكتب منطقة مكة المكرمة/جدة,أنشطة الخدمات الشخصية الأخرى,3420,536,30,6,3992
2022,1,مكتب منطقة مكة المكرمة/جدة,أنشطة الخدمات المالية ، فيما عدا تمويل التأمين وصناديق المعاشات,103,34,6,2,145
2022,1,مكتب منطقة مكة المكرمة/جدة,أنشطة العمل الاجتماعي، دون إقامة، لكبار السن وذوي الإعاقة,146,134,13,0,293
2022,1,مكتب منطقة مكة المكرمة/جدة,أنشطة المعالجة وخدمات إدارة النفايات الأخرى,2,4,0,0,6
2022,1,مكتب منطقة مكة المكرمة/جدة,أنشطة المعمارية والهندسية ، والاختبارات الفنية والتحليل,431,233,20,7,691
2022,1,مكتب منطقة مكة المكرمة/جدة,أنشطة المكاتب الرئيسية ، وألأنشطة الاستشارية في مجال الإدارة,363,167,2,0,532
2022,1,مكتب منطقة مكة المكرمة/جدة,أنشطة المكتبات ودور المحفوظات، والمتاحف والأنشطة الثقافية الأخرى,62,45,1,2,110
2022,1,مكتب منطقة مكة المكرمة/جدة,أنشطة المنظمات الدولية,1,1,1,0,3
2022,1,مكتب منطقة مكة المكرمة/جدة,أنشطة المنظمات ذات العضوية,35,15,0,0,50
2022,1,مكتب منطقة مكة المكرمة/جدة,أنشطة النشر,91,21,4,0,116
2022,1,مكتب منطقة مكة المكرمة/جدة,أنشطة تقديم الخدمات للمباني وتجميل المواقع,1948,843,97,33,2921
2022,1,مكتب منطقة مكة المكرمة/جدة,أنشطة جمع النفايات ومعالجتها وتصريفها ، واسترجاع المواد,39,8,2,0,49
2022,1,مكتب منطقة مكة المكرمة/جدة,أنشطة خدمات الأطعمة والمشروبات,6987,2080,241,30,9338
2022,1,مكتب منطقة مكة المكرمة/جدة,أنشطة خدمات المعلومات,125,37,4,0,166
2022,1,مكتب منطقة مكة المكرمة/جدة,أنشطة خدمات دعم التعدين,41,23,5,4,73
2022,1,مكتب منطقة مكة المكرمة/جدة,أنشطة زراعة المحاصيل والإنتاج الحيواني والصيد والخدمات المتصلة,634,95,6,2,737
2022,1,مكتب منطقة مكة المكرمة/جدة,استخراج النفط الخام والغاز الطبيعي,2,1,0,0,3
2022,1,مكتب منطقة مكة المكرمة/جدة,الإدارة العامة والدفاع ؛ والضمان الاجتماعي الإلزامي,279,148,16,2,445
2022,1,مكتب منطقة مكة المكرمة/جدة,الإقامة,418,312,36,7,773
2022,1,مكتب منطقة مكة المكرمة/جدة,الأنشطة الإبداعية والفنون وأنشطة الترفيه,63,13,1,0,77
2022,1,مكتب منطقة مكة المكرمة/جدة,الأنشطة الأخرى للتعدين واستغلال المحاجر,55,20,4,1,80
2022,1,مكتب منطقة مكة المكرمة/جدة,الأنشطة الإدارية للمكاتب ، وأنشطة الدعم للمكاتب وغير ذلك من أنشطة الدعم للأعمال,614,66,11,0,691
2022,1,مكتب منطقة مكة المكرمة/جدة,الأنشطة الإيجارية,1228,143,15,2,1388
2022,1,مكتب منطقة مكة المكرمة/جدة,الأنشطة البيطرية,26,15,4,0,45
2022,1,مكتب منطقة مكة المكرمة/جدة,الأنشطة الرياضية وأنشطة التسلية والترفيه,305,103,11,1,420
2022,1,مكتب منطقة مكة المكرمة/جدة,الأنشطة العقارية,720,216,32,1,969
2022,1,مكتب منطقة مكة المكرمة/جدة,الأنشطة القانونية وأنشطة المحاسبة,294,103,7,1,405
2022,1,مكتب منطقة مكة المكرمة/جدة,الأنشطة المساعدة لأنشطة الخدمات المالية وأنشطة التأمين,23,19,7,0,49
2022,1,مكتب منطقة مكة المكرمة/جدة,الأنشطة المهنية والعلمية والتقنية الأخرى,217,31,3,0,251
2022,1,مكتب منطقة مكة المكرمة/جدة,الأنشطة غير المتميزة لإنتاج السلع والخدمات التي تقوم بها الأسر المعيشية الخاصة لإستعمالها الخاص,2,0,0,0,2
2022,1,مكتب منطقة مكة المكرمة/جدة,الاتصالات,143,48,4,0,195
2022,1,مكتب منطقة مكة المكرمة/جدة,البحث والتطوير في المجال العلمي,13,4,2,0,19
2022,1,مكتب منطقة مكة المكرمة/جدة,التخزين وأنشطة الدعم للنقل,463,207,41,12,723
2022,1,مكتب منطقة مكة المكرمة/جدة,التعليم,255,270,87,15,627
2022,1,مكتب منطقة مكة المكرمة/جدة,الحراجة وقطع الأخشاب,5,0,0,1,6
2022,1,مكتب منطقة مكة المكرمة/جدة,الرعاية مع الإقامة,11,11,0,0,22
2022,1,مكتب منطقة مكة المكرمة/جدة,الصحة البشرية,275,377,129,31,812
2022,1,مكتب منطقة مكة المكرمة/جدة,الصرف الصحي,18,13,3,1,35
2022,1,مكتب منطقة مكة المكرمة/جدة,الصناعة التحويلية الأخرى,105,80,11,3,199
2022,1,مكتب منطقة مكة المكرمة/جدة,الطباعة واستنساخ وسائط الأعلام المسجّلة,212,130,23,2,367
2022,1,مكتب منطقة مكة المكرمة/جدة,النقل البري و النقل عبر الأنابيب,1475,418,62,13,1968
2022,1,مكتب منطقة مكة المكرمة/جدة,النقل الجوي,50,48,17,10,125
2022,1,مكتب منطقة مكة المكرمة/جدة,النقل المائي,74,38,9,4,125
2022,1,مكتب منطقة مكة المكرمة/جدة,الهندسة المدنية,105,46,17,1,169
2022,1,مكتب منطقة مكة المكرمة/جدة,تجارة التجزئة، باستثناء المركبات ذات المحركات والدراجات النارية,12133,3225,276,68,15702
2022,1,مكتب منطقة مكة المكرمة/جدة,تجارة الجملة ، باستثناء المركبات ذات المحركات والدراجات النارية,9266,4501,462,88,14317
2022,1,مكتب منطقة مكة المكرمة/جدة,تجارة الجملة والتجزئة ، وإصلاح المركبات ذات المحركات والدراجات النارية,3586,856,59,19,4520
2022,1,مكتب منطقة مكة المكرمة/جدة,تجميع المياه ومعالجتها وتوصيلها,61,28,2,3,94
2022,1,مكتب منطقة مكة المكرمة/جدة,تشييد المباني,8791,3213,405,103,12512
2022,1,مكتب منطقة مكة المكرمة/جدة,تعدين الفحم والليغنيت,7,3,0,0,10
2022,1,مكتب منطقة مكة المكرمة/جدة,تعدين ركازات الفلزات,34,15,6,3,58
2022,1,مكتب منطقة مكة المكرمة/جدة,تمويل التأمين وإعادة التأمين وصناديق المعاشات التقاعدية باستثناء الضمان الاجتماعي الإلزامي,8,27,10,3,48
2022,1,مكتب منطقة مكة المكرمة/جدة,توصيل الكهرباء والغاز والبخار وتكييف الهواء,52,29,11,7,99
2022,1,مكتب منطقة مكة المكرمة/جدة,صناعة الآلات والمعدات غير المصنفة في موضع أخر,71,22,6,1,100
2022,1,مكتب منطقة مكة المكرمة/جدة,صناعة المركبات ذات المحركات والمركبات المقطورة ونصف المقطورة,74,29,7,0,110
2022,1,مكتب منطقة مكة المكرمة/جدة,صناعة معدات النقل الأخرى,62,20,2,2,86
2022,1,مكتب منطقة مكة المكرمة/جدة,صنع الأثاث,260,106,22,2,390
2022,1,مكتب منطقة مكة المكرمة/جدة,صنع الحواسيب والمنتجات الإلكترونية والبصرية,126,69,15,2,212
2022,1,مكتب منطقة مكة المكرمة/جدة,صُنع الخشب ومنتجات الخشب والفلين ، باستثناء الأثاث ، صُنع أصناف من القش ومواد الضفر,281,70,17,2,370
2022,1,مكتب منطقة مكة المكرمة/جدة,صنع الفلزات القاعدية,100,111,38,7,256
2022,1,مكتب منطقة مكة المكرمة/جدة,صُنع المشروبات,70,40,14,5,129
2022,1,مكتب منطقة مكة المكرمة/جدة,صنع المعدات الكهربائية,154,71,11,2,238
2022,1,مكتب منطقة مكة المكرمة/جدة,صُنع الملبوسات,1112,183,10,2,1307
2022,1,مكتب منطقة مكة المكرمة/جدة,صُنع المنتجات الجلدية والمنتجات ذات الصلة,17,11,1,0,29
2022,1,مكتب منطقة مكة المكرمة/جدة,صنع المنتجات الصيدلانية الأساسية والمستحضرات الصيدلانية,11,11,7,1,30
2022,1,مكتب منطقة مكة المكرمة/جدة,صُنع المنتجات الغذائية,751,411,62,24,1248
2022,1,مكتب منطقة مكة المكرمة/جدة,صُنع المنسوجات,86,40,15,2,143
2022,1,مكتب منطقة مكة المكرمة/جدة,صُنع المواد الكيميائية والمنتجات الكيميائية,229,143,39,4,415
2022,1,مكتب منطقة مكة المكرمة/جدة,صُنع الورق ومنتجات الورق,46,48,11,5,110
2022,1,مكتب منطقة مكة المكرمة/جدة,صنع فحم الكوك والمنتجات النفطية المكررة,13,14,3,0,30
2022,1,مكتب منطقة مكة المكرمة/جدة,صُنع منتجات التبغ,5,3,0,0,8
2022,1,مكتب منطقة مكة المكرمة/جدة,صنع منتجات المطاط واللدائن,97,109,48,9,263
2022,1,مكتب منطقة مكة المكرمة/جدة,صنع منتجات المعادن اللافلزية الأخرى,188,107,31,13,339
2022,1,مكتب منطقة مكة المكرمة/جدة,صنع منتجات المعادن المشكلة ( باستثناء الآلات والمعدات ),334,132,44,7,517
2022,1,مكتب منطقة مكة المكرمة/جدة,صيد الأسماك وتربية المائيات,341,54,0,0,395
2022,1,مكتب منطقة مكة المكرمة/جدة,وكالات السفر ومشغّلو الجولات السياحية وخدمات الحجز والأنشطة المتصلة بها,188,89,8,0,285
2022,1,مكتب منطقة نجران,أبحاث الإعلان والسوق,13,0,0,0,13
2022,1,مكتب منطقة نجران,إصلاح أجهزة الحاسوب والسلع الشخصية والمنزلية,76,5,0,0,81
2022,1,مكتب منطقة نجران,إصلاح وتركيب الآلات والمعدات,46,4,0,1,51
2022,1,مكتب منطقة نجران,أنشطة أنتاج الأفلام والبرامج التلفزيونية والتسجيلات الصوتية و نشرالموسيقى,3,0,0,0,3
2022,1,مكتب منطقة نجران,أنشطة الأمن والتحقيقات,2,0,0,1,3
2022,1,مكتب منطقة نجران,أنشطة الاستخدام,21,3,0,0,24
2022,1,مكتب منطقة نجران,أنشطة الاسر المعيشية التي تستخدم أفراداً للعمل المنزلي,4,0,0,0,4
2022,1,مكتب منطقة نجران,أنشطة البرمجة الحاسوبية والخبرة الاستشارية وما يتصل بها من أنشطة,4,1,0,0,5
2022,1,مكتب منطقة نجران,أنشطة البريد ونقل الرسائل والطرود بواسطة مندوبين,1,0,0,0,1
2022,1,مكتب منطقة نجران,أنشطة التشييد المتخصصة,1473,228,11,5,1717
2022,1,مكتب منطقة نجران,أنشطة الخدمات الشخصية الأخرى,565,35,0,0,600
2022,1,مكتب منطقة نجران,أنشطة الخدمات المالية ، فيما عدا تمويل التأمين وصناديق المعاشات,21,1,0,0,22
2022,1,مكتب منطقة نجران,أنشطة العمل الاجتماعي، دون إقامة، لكبار السن وذوي الإعاقة,23,5,0,0,28
2022,1,مكتب منطقة نجران,أنشطة المعالجة وخدمات إدارة النفايات الأخرى,0,1,0,0,1
2022,1,مكتب منطقة نجران,أنشطة المعمارية والهندسية ، والاختبارات الفنية والتحليل,53,18,2,0,73
2022,1,مكتب منطقة نجران,أنشطة المكاتب الرئيسية ، وألأنشطة الاستشارية في مجال الإدارة,15,1,0,0,16
2022,1,مكتب منطقة نجران,أنشطة المكتبات ودور المحفوظات، والمتاحف والأنشطة الثقافية الأخرى,24,1,0,0,25
2022,1,مكتب منطقة نجران,أنشطة المنظمات الدولية,2,0,0,0,2
2022,1,مكتب منطقة نجران,أنشطة المنظمات ذات العضوية,18,0,0,0,18
2022,1,مكتب منطقة نجران,أنشطة النشر,15,5,0,0,20
2022,1,مكتب منطقة نجران,أنشطة تقديم الخدمات للمباني وتجميل المواقع,189,32,4,4,229
2022,1,مكتب منطقة نجران,أنشطة جمع النفايات ومعالجتها وتصريفها ، واسترجاع المواد,5,0,0,0,5
2022,1,مكتب منطقة نجران,أنشطة خدمات الأطعمة والمشروبات,1367,235,15,1,1618
2022,1,مكتب منطقة نجران,أنشطة خدمات المعلومات,1,1,0,0,2
2022,1,مكتب منطقة نجران,أنشطة خدمات دعم التعدين,4,3,0,0,7
2022,1,مكتب منطقة نجران,أنشطة زراعة المحاصيل والإنتاج الحيواني والصيد والخدمات المتصلة,1008,23,3,0,1034
2022,1,مكتب منطقة نجران,استخراج النفط الخام والغاز الطبيعي,2,1,0,0,3
2022,1,مكتب منطقة نجران,الإدارة العامة والدفاع ؛ والضمان الاجتماعي الإلزامي,54,16,0,0,70
2022,1,مكتب منطقة نجران,الإقامة,86,20,2,0,108
2022,1,مكتب منطقة نجران,الأنشطة الإبداعية والفنون وأنشطة الترفيه,4,0,0,0,4
2022,1,مكتب منطقة نجران,الأنشطة الأخرى للتعدين واستغلال المحاجر,8,0,1,0,9
2022,1,مكتب منطقة نجران,الأنشطة الإدارية للمكاتب ، وأنشطة الدعم للمكاتب وغير ذلك من أنشطة الدعم للأعمال,47,1,0,0,48
2022,1,مكتب منطقة نجران,الأنشطة الإيجارية,1388,68,1,1,1458
2022,1,مكتب منطقة نجران,الأنشطة البيطرية,3,3,0,0,6
2022,1,مكتب منطقة نجران,الأنشطة الرياضية وأنشطة التسلية والترفيه,33,10,0,1,44
2022,1,مكتب منطقة نجران,الأنشطة العقارية,32,4,0,0,36
2022,1,مكتب منطقة نجران,الأنشطة القانونية وأنشطة المحاسبة,4,0,0,0,4
2022,1,مكتب منطقة نجران,الأنشطة المساعدة لأنشطة الخدمات المالية وأنشطة التأمين,0,1,0,0,1
2022,1,مكتب منطقة نجران,الأنشطة المهنية والعلمية والتقنية الأخرى,24,0,0,0,24
2022,1,مكتب منطقة نجران,الاتصالات,18,1,0,0,19
2022,1,مكتب منطقة نجران,البحث والتطوير في المجال العلمي,1,0,0,0,1
2022,1,مكتب منطقة نجران,التخزين وأنشطة الدعم للنقل,247,65,1,0,313
2022,1,مكتب منطقة نجران,التعليم,17,16,6,0,39
2022,1,مكتب منطقة نجران,الرعاية مع الإقامة,3,1,0,0,4
2022,1,مكتب منطقة نجران,الصحة البشرية,20,54,11,1,86
2022,1,مكتب منطقة نجران,الصناعة التحويلية الأخرى,6,1,1,0,8
2022,1,مكتب منطقة نجران,الطباعة واستنساخ وسائط الأعلام المسجّلة,8,2,0,0,10
2022,1,مكتب منطقة نجران,النقل البري و النقل عبر الأنابيب,871,80,2,1,954
2022,1,مكتب منطقة نجران,النقل الجوي,5,3,0,0,8
2022,1,مكتب منطقة نجران,النقل المائي,11,0,0,0,11
2022,1,مكتب منطقة نجران,الهندسة المدنية,16,4,3,3,26
2022,1,مكتب منطقة نجران,تجارة التجزئة، باستثناء المركبات ذات المحركات والدراجات النارية,1701,365,18,2,2086
2022,1,مكتب منطقة نجران,تجارة الجملة ، باستثناء المركبات ذات المحركات والدراجات النارية,503,90,10,1,604
2022,1,مكتب منطقة نجران,تجارة الجملة والتجزئة ، وإصلاح المركبات ذات المحركات والدراجات النارية,607,106,3,0,716
2022,1,مكتب منطقة نجران,تجميع المياه ومعالجتها وتوصيلها,20,4,0,0,24
2022,1,مكتب منطقة نجران,تشييد المباني,2463,508,69,13,3053
2022,1,مكتب منطقة نجران,تعدين الفحم والليغنيت,1,0,0,0,1
2022,1,مكتب منطقة نجران,تعدين ركازات الفلزات,11,0,1,0,12
2022,1,مكتب منطقة نجران,تمويل التأمين وإعادة التأمين وصناديق المعاشات التقاعدية باستثناء الضمان الاجتماعي الإلزامي,2,0,0,0,2
2022,1,مكتب منطقة نجران,توصيل الكهرباء والغاز والبخار وتكييف الهواء,4,1,1,0,6
2022,1,مكتب منطقة نجران,صناعة الآلات والمعدات غير المصنفة في موضع أخر,14,2,0,0,16
2022,1,مكتب منطقة نجران,صناعة المركبات ذات المحركات والمركبات المقطورة ونصف المقطورة,15,2,0,0,17
2022,1,مكتب منطقة نجران,صناعة معدات النقل الأخرى,12,1,0,0,13
2022,1,مكتب منطقة نجران,صنع الأثاث,90,20,1,0,111
2022,1,مكتب منطقة نجران,صنع الحواسيب والمنتجات الإلكترونية والبصرية,17,1,0,0,18
2022,1,مكتب منطقة نجران,صُنع الخشب ومنتجات الخشب والفلين ، باستثناء الأثاث ، صُنع أصناف من القش ومواد الضفر,80,9,0,0,89
2022,1,مكتب منطقة نجران,صنع الفلزات القاعدية,83,10,3,1,97
2022,1,مكتب منطقة نجران,صُنع المشروبات,6,1,1,0,8
2022,1,مكتب منطقة نجران,صنع المعدات الكهربائية,15,1,0,0,16
2022,1,مكتب منطقة نجران,صُنع الملبوسات,319,24,0,0,343
2022,1,مكتب منطقة نجران,صُنع المنتجات الجلدية والمنتجات ذات الصلة,4,0,0,0,4
2022,1,مكتب منطقة نجران,صنع المنتجات الصيدلانية الأساسية والمستحضرات الصيدلانية,3,0,0,0,3
2022,1,مكتب منطقة نجران,صُنع المنتجات الغذائية,145,22,1,0,168
2022,1,مكتب منطقة نجران,صُنع المنسوجات,38,5,0,0,43
2022,1,مكتب منطقة نجران,صُنع المواد الكيميائية والمنتجات الكيميائية,22,4,1,0,27
2022,1,مكتب منطقة نجران,صُنع الورق ومنتجات الورق,11,4,1,0,16
2022,1,مكتب منطقة نجران,صنع منتجات المطاط واللدائن,21,2,0,0,23
2022,1,مكتب منطقة نجران,صنع منتجات المعادن اللافلزية الأخرى,66,31,9,1,107
2022,1,مكتب منطقة نجران,صنع منتجات المعادن المشكلة ( باستثناء الآلات والمعدات ),175,14,4,0,193
2022,1,مكتب منطقة نجران,صيد الأسماك وتربية المائيات,135,1,0,0,136
2022,1,مكتب منطقة نجران,وكالات السفر ومشغّلو الجولات السياحية وخدمات الحجز والأنشطة المتصلة بها,6,2,0,0,8
