,year,quarter,location,economic activity,micro enterprises,small enterprises,medium enterprises,large enterprises,total number of enterprises
0,2022,1,Eastern Region Office,أبحاث الإعلان والسوق,124,30,1,0,155
1,2022,1,Eastern Region Office,إصلاح أجهزة الحاسوب والسلع الشخصية والمنزلية,302,74,9,1,386
2,2022,1,Eastern Region Office,إصلاح وتركيب الآلات والمعدات,201,72,6,1,280
3,2022,1,Eastern Region Office,أنشطة أنتاج الأفلام والبرامج التلفزيونية والتسجيلات الصوتية و نشرالموسيقى,30,4,0,0,34
4,2022,1,Eastern Region Office,أنشطة الأمن والتحقيقات,22,17,11,4,54
5,2022,1,Eastern Region Office,أنشطة الاستخدام,83,23,2,6,114
6,2022,1,Eastern Region Office,أنشطة الاسر المعيشية التي تستخدم أفراداً للعمل المنزلي,2,0,0,0,2
7,2022,1,Eastern Region Office,أنشطة البرمجة الحاسوبية والخبرة الاستشارية وما يتصل بها من أنشطة,147,51,9,2,209
8,2022,1,Eastern Region Office,أنشطة البرمجة والإذاعة,1,1,0,0,2
9,2022,1,Eastern Region Office,أنشطة البريد ونقل الرسائل والطرود بواسطة مندوبين,16,3,0,0,19
10,2022,1,Eastern Region Office,أنشطة التشييد المتخصصة,2474,981,124,15,3594
11,2022,1,Eastern Region Office,أنشطة الخدمات الشخصية الأخرى,2149,421,28,3,2601
12,2022,1,Eastern Region Office,أنشطة الخدمات المالية ، فيما عدا تمويل التأمين وصناديق المعاشات,39,15,5,1,60
13,2022,1,Eastern Region Office,أنشطة العمل الاجتماعي، دون إقامة، لكبار السن وذوي الإعاقة,66,75,3,0,144
14,2022,1,Eastern Region Office,أنشطة المعالجة وخدمات إدارة النفايات الأخرى,3,1,1,0,5
15,2022,1,Eastern Region Office,أنشطة المعمارية والهندسية ، والاختبارات الفنية والتحليل,191,165,42,16,414
16,2022,1,Eastern Region Office,أنشطة المكاتب الرئيسية ، وألأنشطة الاستشارية في مجال الإدارة,152,57,9,1,219
17,2022,1,Eastern Region Office,أنشطة المكتبات ودور المحفوظات، والمتاحف والأنشطة الثقافية الأخرى,52,25,0,0,77
18,2022,1,Eastern Region Office,أنشطة المنظمات الدولية,0,1,0,0,1
19,2022,1,Eastern Region Office,أنشطة المنظمات ذات العضوية,19,4,1,0,24
20,2022,1,Eastern Region Office,أنشطة النشر,30,11,0,0,41
21,2022,1,Eastern Region Office,أنشطة تقديم الخدمات للمباني وتجميل المواقع,1415,780,127,39,2361
22,2022,1,Eastern Region Office,أنشطة جمع النفايات ومعالجتها وتصريفها ، واسترجاع المواد,11,12,1,1,25
23,2022,1,Eastern Region Office,أنشطة خدمات الأطعمة والمشروبات,3298,1559,182,23,5062
24,2022,1,Eastern Region Office,أنشطة خدمات المعلومات,50,19,1,0,70
25,2022,1,Eastern Region Office,أنشطة خدمات دعم التعدين,129,124,64,43,360
26,2022,1,Eastern Region Office,أنشطة زراعة المحاصيل والإنتاج الحيواني والصيد والخدمات المتصلة,373,64,8,0,445
27,2022,1,Eastern Region Office,استخراج النفط الخام والغاز الطبيعي,1,1,1,0,3
28,2022,1,Eastern Region Office,الإدارة العامة والدفاع ؛ والضمان الاجتماعي الإلزامي,188,125,31,4,348
29,2022,1,Eastern Region Office,الإقامة,157,148,24,1,330
30,2022,1,Eastern Region Office,الأنشطة الإبداعية والفنون وأنشطة الترفيه,17,1,0,0,18
31,2022,1,Eastern Region Office,الأنشطة الأخرى للتعدين واستغلال المحاجر,39,25,10,1,75
32,2022,1,Eastern Region Office,الأنشطة الإدارية للمكاتب ، وأنشطة الدعم للمكاتب وغير ذلك من أنشطة الدعم للأعمال,173,31,2,1,207
33,2022,1,Eastern Region Office,الأنشطة الإيجارية,622,144,24,6,796
34,2022,1,Eastern Region Office,الأنشطة البيطرية,6,10,2,0,18
35,2022,1,Eastern Region Office,الأنشطة الرياضية وأنشطة التسلية والترفيه,152,70,3,1,226
36,2022,1,Eastern Region Office,الأنشطة العقارية,263,127,12,2,404
37,2022,1,Eastern Region Office,الأنشطة القانونية وأنشطة المحاسبة,95,41,2,0,138
38,2022,1,Eastern Region Office,الأنشطة المساعدة لأنشطة الخدمات المالية وأنشطة التأمين,12,12,1,1,26
39,2022,1,Eastern Region Office,الأنشطة المهنية والعلمية والتقنية الأخرى,85,17,0,0,102
40,2022,1,Eastern Region Office,الأنشطة غير المتميزة لإنتاج السلع والخدمات التي تقوم بها الأسر المعيشية الخاصة لإستعمالها الخاص,1,1,0,0,2
41,2022,1,Eastern Region Office,الاتصالات,64,19,0,0,83
42,2022,1,Eastern Region Office,البحث والتطوير في المجال العلمي,6,3,1,0,10
43,2022,1,Eastern Region Office,التخزين وأنشطة الدعم للنقل,263,124,30,6,423
44,2022,1,Eastern Region Office,التعليم,147,169,51,13,380
45,2022,1,Eastern Region Office,الحراجة وقطع الأخشاب,1,1,0,0,2
46,2022,1,Eastern Region Office,الرعاية مع الإقامة,9,6,1,0,16
47,2022,1,Eastern Region Office,الصحة البشرية,85,148,63,24,320
48,2022,1,Eastern Region Office,الصرف الصحي,9,7,1,1,18
49,2022,1,Eastern Region Office,الصناعة التحويلية الأخرى,65,36,4,0,105
50,2022,1,Eastern Region Office,الطباعة واستنساخ وسائط الأعلام المسجّلة,112,76,7,0,195
51,2022,1,Eastern Region Office,النقل البري و النقل عبر الأنابيب,969,286,66,18,1339
52,2022,1,Eastern Region Office,النقل الجوي,78,73,37,7,195
53,2022,1,Eastern Region Office,النقل المائي,28,17,7,0,52
54,2022,1,Eastern Region Office,الهندسة المدنية,107,48,9,2,166
55,2022,1,Eastern Region Office,تجارة التجزئة، باستثناء المركبات ذات المحركات والدراجات النارية,5224,1982,217,39,7462
56,2022,1,Eastern Region Office,تجارة الجملة ، باستثناء المركبات ذات المحركات والدراجات النارية,2507,1408,236,50,4201
57,2022,1,Eastern Region Office,تجارة الجملة والتجزئة ، وإصلاح المركبات ذات المحركات والدراجات النارية,2131,735,31,6,2903
58,2022,1,Eastern Region Office,تجميع المياه ومعالجتها وتوصيلها,24,15,1,1,41
59,2022,1,Eastern Region Office,تشييد المباني,4167,2636,547,205,7555
60,2022,1,Eastern Region Office,تعدين الفحم والليغنيت,5,0,0,0,5
61,2022,1,Eastern Region Office,تعدين ركازات الفلزات,84,86,11,2,183
62,2022,1,Eastern Region Office,تمويل التأمين وإعادة التأمين وصناديق المعاشات التقاعدية باستثناء الضمان الاجتماعي الإلزامي,5,13,3,4,25
63,2022,1,Eastern Region Office,توصيل الكهرباء والغاز والبخار وتكييف الهواء,32,54,16,4,106
64,2022,1,Eastern Region Office,صناعة الآلات والمعدات غير المصنفة في موضع أخر,47,36,7,2,92
65,2022,1,Eastern Region Office,صناعة المركبات ذات المحركات والمركبات المقطورة ونصف المقطورة,19,10,0,0,29
66,2022,1,Eastern Region Office,صناعة معدات النقل الأخرى,19,13,7,2,41
67,2022,1,Eastern Region Office,صنع الأثاث,292,113,8,1,414
68,2022,1,Eastern Region Office,صنع الحواسيب والمنتجات الإلكترونية والبصرية,106,49,12,3,170
69,2022,1,Eastern Region Office,صُنع الخشب ومنتجات الخشب والفلين ، باستثناء الأثاث ، صُنع أصناف من القش ومواد الضفر,239,164,21,7,431
70,2022,1,Eastern Region Office,صنع الفلزات القاعدية,113,114,48,9,284
71,2022,1,Eastern Region Office,صُنع المشروبات,18,13,3,1,35
72,2022,1,Eastern Region Office,صنع المعدات الكهربائية,172,83,16,2,273
73,2022,1,Eastern Region Office,صُنع الملبوسات,750,173,7,0,930
74,2022,1,Eastern Region Office,صُنع المنتجات الجلدية والمنتجات ذات الصلة,4,1,0,0,5
75,2022,1,Eastern Region Office,صنع المنتجات الصيدلانية الأساسية والمستحضرات الصيدلانية,4,4,2,0,10
76,2022,1,Eastern Region Office,صُنع المنتجات الغذائية,410,208,53,9,680
77,2022,1,Eastern Region Office,صُنع المنسوجات,136,85,9,0,230
78,2022,1,Eastern Region Office,صُنع المواد الكيميائية والمنتجات الكيميائية,108,72,18,1,199
79,2022,1,Eastern Region Office,صُنع الورق ومنتجات الورق,23,16,10,0,49
80,2022,1,Eastern Region Office,صنع فحم الكوك والمنتجات النفطية المكررة,12,16,3,2,33
81,2022,1,Eastern Region Office,صُنع منتجات التبغ,2,1,0,0,3
82,2022,1,Eastern Region Office,صنع منتجات المطاط واللدائن,47,81,63,10,201
83,2022,1,Eastern Region Office,صنع منتجات المعادن اللافلزية الأخرى,150,100,32,7,289
84,2022,1,Eastern Region Office,صنع منتجات المعادن المشكلة ( باستثناء الآلات والمعدات ),341,242,70,20,673
85,2022,1,Eastern Region Office,صيد الأسماك وتربية المائيات,224,175,5,0,404
86,2022,1,Eastern Region Office,وكالات السفر ومشغّلو الجولات السياحية وخدمات الحجز والأنشطة المتصلة بها,74,34,6,0,114
87,2022,1,Al-Ahsa Governorate Office,أبحاث الإعلان والسوق,19,3,0,0,22
88,2022,1,Al-Ahsa Governorate Office,إصلاح أجهزة الحاسوب والسلع الشخصية والمنزلية,124,20,2,0,146
89,2022,1,Al-Ahsa Governorate Office,إصلاح وتركيب الآلات والمعدات,55,4,0,0,59
90,2022,1,Al-Ahsa Governorate Office,أنشطة أنتاج الأفلام والبرامج التلفزيونية والتسجيلات الصوتية و نشرالموسيقى,7,0,0,0,7
91,2022,1,Al-Ahsa Governorate Office,أنشطة الأمن والتحقيقات,2,1,2,0,5
92,2022,1,Al-Ahsa Governorate Office,أنشطة الاستخدام,25,5,0,0,30
93,2022,1,Al-Ahsa Governorate Office,أنشطة الاسر المعيشية التي تستخدم أفراداً للعمل المنزلي,1,0,0,0,1
94,2022,1,Al-Ahsa Governorate Office,أنشطة البرمجة الحاسوبية والخبرة الاستشارية وما يتصل بها من أنشطة,10,3,0,0,13
95,2022,1,Al-Ahsa Governorate Office,أنشطة البرمجة والإذاعة,1,0,0,0,1
96,2022,1,Al-Ahsa Governorate Office,أنشطة البريد ونقل الرسائل والطرود بواسطة مندوبين,1,2,0,0,3
97,2022,1,Al-Ahsa Governorate Office,أنشطة التشييد المتخصصة,870,220,10,2,1102
98,2022,1,Al-Ahsa Governorate Office,أنشطة الخدمات الشخصية الأخرى,921,129,3,1,1054
99,2022,1,Al-Ahsa Governorate Office,أنشطة الخدمات المالية ، فيما عدا تمويل التأمين وصناديق المعاشات,21,2,1,0,24
100,2022,1,Al-Ahsa Governorate Office,أنشطة العمل الاجتماعي، دون إقامة، لكبار السن وذوي الإعاقة,20,23,2,0,45
101,2022,1,Al-Ahsa Governorate Office,أنشطة المعالجة وخدمات إدارة النفايات الأخرى,0,1,0,0,1
102,2022,1,Al-Ahsa Governorate Office,أنشطة المعمارية والهندسية ، والاختبارات الفنية والتحليل,30,30,4,0,64
103,2022,1,Al-Ahsa Governorate Office,أنشطة المكاتب الرئيسية ، وألأنشطة الاستشارية في مجال الإدارة,25,4,0,0,29
104,2022,1,Al-Ahsa Governorate Office,أنشطة المكتبات ودور المحفوظات، والمتاحف والأنشطة الثقافية الأخرى,32,9,0,0,41
105,2022,1,Al-Ahsa Governorate Office,أنشطة المنظمات ذات العضوية,6,2,1,0,9
106,2022,1,Al-Ahsa Governorate Office,أنشطة النشر,2,1,0,0,3
107,2022,1,Al-Ahsa Governorate Office,أنشطة تقديم الخدمات للمباني وتجميل المواقع,182,53,4,0,239
108,2022,1,Al-Ahsa Governorate Office,أنشطة جمع النفايات ومعالجتها وتصريفها ، واسترجاع المواد,2,2,0,0,4
109,2022,1,Al-Ahsa Governorate Office,أنشطة خدمات الأطعمة والمشروبات,1231,564,34,2,1831
110,2022,1,Al-Ahsa Governorate Office,أنشطة خدمات المعلومات,8,2,0,0,10
111,2022,1,Al-Ahsa Governorate Office,أنشطة خدمات دعم التعدين,7,14,0,0,21
112,2022,1,Al-Ahsa Governorate Office,أنشطة زراعة المحاصيل والإنتاج الحيواني والصيد والخدمات المتصلة,269,50,7,0,326
113,2022,1,Al-Ahsa Governorate Office,الإدارة العامة والدفاع ؛ والضمان الاجتماعي الإلزامي,25,14,1,0,40
114,2022,1,Al-Ahsa Governorate Office,الإقامة,47,26,4,0,77
115,2022,1,Al-Ahsa Governorate Office,الأنشطة الإبداعية والفنون وأنشطة الترفيه,5,1,0,0,6
116,2022,1,Al-Ahsa Governorate Office,الأنشطة الأخرى للتعدين واستغلال المحاجر,18,3,0,0,21
117,2022,1,Al-Ahsa Governorate Office,الأنشطة الإدارية للمكاتب ، وأنشطة الدعم للمكاتب وغير ذلك من أنشطة الدعم للأعمال,32,8,0,0,40
118,2022,1,Al-Ahsa Governorate Office,الأنشطة الإيجارية,305,43,5,2,355
119,2022,1,Al-Ahsa Governorate Office,الأنشطة البيطرية,5,1,0,0,6
120,2022,1,Al-Ahsa Governorate Office,الأنشطة الرياضية وأنشطة التسلية والترفيه,33,15,1,0,49
121,2022,1,Al-Ahsa Governorate Office,الأنشطة العقارية,37,9,1,0,47
122,2022,1,Al-Ahsa Governorate Office,الأنشطة القانونية وأنشطة المحاسبة,14,1,1,0,16
123,2022,1,Al-Ahsa Governorate Office,الأنشطة المساعدة لأنشطة الخدمات المالية وأنشطة التأمين,2,0,0,0,2
124,2022,1,Al-Ahsa Governorate Office,الأنشطة المهنية والعلمية والتقنية الأخرى,34,1,0,0,35
125,2022,1,Al-Ahsa Governorate Office,الاتصالات,18,6,0,0,24
126,2022,1,Al-Ahsa Governorate Office,التخزين وأنشطة الدعم للنقل,63,14,0,1,78
127,2022,1,Al-Ahsa Governorate Office,التعليم,40,28,12,0,80
128,2022,1,Al-Ahsa Governorate Office,الرعاية مع الإقامة,3,0,1,0,4
129,2022,1,Al-Ahsa Governorate Office,الصحة البشرية,30,60,14,6,110
130,2022,1,Al-Ahsa Governorate Office,الصرف الصحي,2,0,0,0,2
131,2022,1,Al-Ahsa Governorate Office,الصناعة التحويلية الأخرى,20,5,0,0,25
132,2022,1,Al-Ahsa Governorate Office,الطباعة واستنساخ وسائط الأعلام المسجّلة,34,9,1,0,44
133,2022,1,Al-Ahsa Governorate Office,النقل البري و النقل عبر الأنابيب,230,44,5,2,281
134,2022,1,Al-Ahsa Governorate Office,النقل الجوي,10,4,1,0,15
135,2022,1,Al-Ahsa Governorate Office,النقل المائي,3,0,0,0,3
136,2022,1,Al-Ahsa Governorate Office,الهندسة المدنية,18,4,0,0,22
137,2022,1,Al-Ahsa Governorate Office,تجارة التجزئة، باستثناء المركبات ذات المحركات والدراجات النارية,1876,479,36,3,2394
138,2022,1,Al-Ahsa Governorate Office,تجارة الجملة ، باستثناء المركبات ذات المحركات والدراجات النارية,532,150,10,4,696
139,2022,1,Al-Ahsa Governorate Office,تجارة الجملة والتجزئة ، وإصلاح المركبات ذات المحركات والدراجات النارية,759,190,6,0,955
140,2022,1,Al-Ahsa Governorate Office,تجميع المياه ومعالجتها وتوصيلها,9,7,0,0,16
141,2022,1,Al-Ahsa Governorate Office,تشييد المباني,1566,665,62,16,2309
142,2022,1,Al-Ahsa Governorate Office,تعدين الفحم والليغنيت,2,1,0,0,3
143,2022,1,Al-Ahsa Governorate Office,تعدين ركازات الفلزات,26,9,1,1,37
144,2022,1,Al-Ahsa Governorate Office,تمويل التأمين وإعادة التأمين وصناديق المعاشات التقاعدية باستثناء الضمان الاجتماعي الإلزامي,0,1,0,0,1
145,2022,1,Al-Ahsa Governorate Office,توصيل الكهرباء والغاز والبخار وتكييف الهواء,9,4,0,0,13
146,2022,1,Al-Ahsa Governorate Office,صناعة الآلات والمعدات غير المصنفة في موضع أخر,15,6,1,0,22
147,2022,1,Al-Ahsa Governorate Office,صناعة المركبات ذات المحركات والمركبات المقطورة ونصف المقطورة,8,1,0,0,9
148,2022,1,Al-Ahsa Governorate Office,صناعة معدات النقل الأخرى,14,1,0,0,15
149,2022,1,Al-Ahsa Governorate Office,صنع الأثاث,138,48,1,0,187
150,2022,1,Al-Ahsa Governorate Office,صنع الحواسيب والمنتجات الإلكترونية والبصرية,90,21,1,0,112
151,2022,1,Al-Ahsa Governorate Office,صُنع الخشب ومنتجات الخشب والفلين ، باستثناء الأثاث ، صُنع أصناف من القش ومواد الضفر,55,20,1,1,77
152,2022,1,Al-Ahsa Governorate Office,صنع الفلزات القاعدية,53,16,0,0,69
153,2022,1,Al-Ahsa Governorate Office,صُنع المشروبات,7,9,0,0,16
154,2022,1,Al-Ahsa Governorate Office,صنع المعدات الكهربائية,47,24,1,0,72
155,2022,1,Al-Ahsa Governorate Office,صُنع الملبوسات,500,70,2,0,572
156,2022,1,Al-Ahsa Governorate Office,صُنع المنتجات الجلدية والمنتجات ذات الصلة,6,1,0,0,7
157,2022,1,Al-Ahsa Governorate Office,صنع المنتجات الصيدلانية الأساسية والمستحضرات الصيدلانية,1,3,0,0,4
158,2022,1,Al-Ahsa Governorate Office,صُنع المنتجات الغذائية,236,80,16,4,336
159,2022,1,Al-Ahsa Governorate Office,صُنع المنسوجات,36,8,1,0,45
160,2022,1,Al-Ahsa Governorate Office,صُنع المواد الكيميائية والمنتجات الكيميائية,28,7,3,0,38
161,2022,1,Al-Ahsa Governorate Office,صُنع الورق ومنتجات الورق,2,2,0,1,5
162,2022,1,Al-Ahsa Governorate Office,صنع فحم الكوك والمنتجات النفطية المكررة,1,0,1,0,2
163,2022,1,Al-Ahsa Governorate Office,صُنع منتجات التبغ,3,1,0,0,4
164,2022,1,Al-Ahsa Governorate Office,صنع منتجات المطاط واللدائن,7,6,4,1,18
165,2022,1,Al-Ahsa Governorate Office,صنع منتجات المعادن اللافلزية الأخرى,54,38,11,0,103
166,2022,1,Al-Ahsa Governorate Office,صنع منتجات المعادن المشكلة ( باستثناء الآلات والمعدات ),99,55,6,1,161
167,2022,1,Al-Ahsa Governorate Office,صيد الأسماك وتربية المائيات,9,4,1,0,14
168,2022,1,Al-Ahsa Governorate Office,وكالات السفر ومشغّلو الجولات السياحية وخدمات الحجز والأنشطة المتصلة بها,19,4,0,0,23
169,2022,1,Jubail Governorate Office,أبحاث الإعلان والسوق,21,5,0,0,26
170,2022,1,Jubail Governorate Office,إصلاح أجهزة الحاسوب والسلع الشخصية والمنزلية,45,15,3,0,63
171,2022,1,Jubail Governorate Office,إصلاح وتركيب الآلات والمعدات,43,27,5,0,75
172,2022,1,Jubail Governorate Office,أنشطة أنتاج الأفلام والبرامج التلفزيونية والتسجيلات الصوتية و نشرالموسيقى,1,0,0,0,1
173,2022,1,Jubail Governorate Office,أنشطة الأمن والتحقيقات,6,0,2,0,8
174,2022,1,Jubail Governorate Office,أنشطة الاستخدام,9,1,0,1,11
175,2022,1,Jubail Governorate Office,أنشطة الاسر المعيشية التي تستخدم أفراداً للعمل المنزلي,1,0,0,0,1
176,2022,1,Jubail Governorate Office,أنشطة البرمجة الحاسوبية والخبرة الاستشارية وما يتصل بها من أنشطة,8,6,0,0,14
177,2022,1,Jubail Governorate Office,أنشطة البريد ونقل الرسائل والطرود بواسطة مندوبين,2,0,0,0,2
178,2022,1,Jubail Governorate Office,أنشطة التشييد المتخصصة,727,305,34,19,1085
179,2022,1,Jubail Governorate Office,أنشطة الخدمات الشخصية الأخرى,466,91,6,0,563
180,2022,1,Jubail Governorate Office,أنشطة الخدمات المالية ، فيما عدا تمويل التأمين وصناديق المعاشات,8,2,1,0,11
181,2022,1,Jubail Governorate Office,أنشطة العمل الاجتماعي، دون إقامة، لكبار السن وذوي الإعاقة,8,7,1,0,16
182,2022,1,Jubail Governorate Office,أنشطة المعالجة وخدمات إدارة النفايات الأخرى,1,2,0,0,3
183,2022,1,Jubail Governorate Office,أنشطة المعمارية والهندسية ، والاختبارات الفنية والتحليل,41,15,1,3,60
184,2022,1,Jubail Governorate Office,أنشطة المكاتب الرئيسية ، وألأنشطة الاستشارية في مجال الإدارة,17,4,0,0,21
185,2022,1,Jubail Governorate Office,أنشطة المكتبات ودور المحفوظات، والمتاحف والأنشطة الثقافية الأخرى,12,2,1,0,15
186,2022,1,Jubail Governorate Office,أنشطة المنظمات الدولية,1,0,0,0,1
187,2022,1,Jubail Governorate Office,أنشطة المنظمات ذات العضوية,1,4,1,0,6
188,2022,1,Jubail Governorate Office,أنشطة النشر,30,3,1,0,34
189,2022,1,Jubail Governorate Office,أنشطة تقديم الخدمات للمباني وتجميل المواقع,248,123,28,5,404
190,2022,1,Jubail Governorate Office,أنشطة جمع النفايات ومعالجتها وتصريفها ، واسترجاع المواد,2,1,1,1,5
191,2022,1,Jubail Governorate Office,أنشطة خدمات الأطعمة والمشروبات,840,328,19,2,1189
192,2022,1,Jubail Governorate Office,أنشطة خدمات المعلومات,4,2,0,0,6
193,2022,1,Jubail Governorate Office,أنشطة خدمات دعم التعدين,24,20,11,11,66
194,2022,1,Jubail Governorate Office,أنشطة زراعة المحاصيل والإنتاج الحيواني والصيد والخدمات المتصلة,253,26,2,0,281
195,2022,1,Jubail Governorate Office,الإدارة العامة والدفاع ؛ والضمان الاجتماعي الإلزامي,15,6,3,0,24
196,2022,1,Jubail Governorate Office,الإقامة,41,25,6,0,72
197,2022,1,Jubail Governorate Office,الأنشطة الأخرى للتعدين واستغلال المحاجر,4,5,3,2,14
198,2022,1,Jubail Governorate Office,الأنشطة الإدارية للمكاتب ، وأنشطة الدعم للمكاتب وغير ذلك من أنشطة الدعم للأعمال,24,2,0,0,26
199,2022,1,Jubail Governorate Office,الأنشطة الإيجارية,380,41,5,0,426
200,2022,1,Jubail Governorate Office,الأنشطة البيطرية,5,0,0,0,5
201,2022,1,Jubail Governorate Office,الأنشطة الرياضية وأنشطة التسلية والترفيه,28,7,0,0,35
202,2022,1,Jubail Governorate Office,الأنشطة العقارية,32,9,0,0,41
203,2022,1,Jubail Governorate Office,الأنشطة القانونية وأنشطة المحاسبة,6,3,0,0,9
204,2022,1,Jubail Governorate Office,الأنشطة المساعدة لأنشطة الخدمات المالية وأنشطة التأمين,2,0,0,0,2
205,2022,1,Jubail Governorate Office,الأنشطة المهنية والعلمية والتقنية الأخرى,19,3,0,0,22
206,2022,1,Jubail Governorate Office,الاتصالات,21,4,0,0,25
207,2022,1,Jubail Governorate Office,البحث والتطوير في المجال العلمي,1,1,0,0,2
208,2022,1,Jubail Governorate Office,التخزين وأنشطة الدعم للنقل,58,16,4,0,78
209,2022,1,Jubail Governorate Office,التعليم,30,14,13,0,57
210,2022,1,Jubail Governorate Office,الحراجة وقطع الأخشاب,2,0,0,0,2
211,2022,1,Jubail Governorate Office,الرعاية مع الإقامة,2,3,0,0,5
212,2022,1,Jubail Governorate Office,الصحة البشرية,18,17,14,6,55
213,2022,1,Jubail Governorate Office,الصرف الصحي,3,2,1,1,7
214,2022,1,Jubail Governorate Office,الصناعة التحويلية الأخرى,7,5,0,0,12
215,2022,1,Jubail Governorate Office,الطباعة واستنساخ وسائط الأعلام المسجّلة,16,9,1,0,26
216,2022,1,Jubail Governorate Office,النقل البري و النقل عبر الأنابيب,229,63,4,0,296
217,2022,1,Jubail Governorate Office,النقل الجوي,10,7,0,2,19
218,2022,1,Jubail Governorate Office,النقل المائي,7,1,0,0,8
219,2022,1,Jubail Governorate Office,الهندسة المدنية,27,19,2,0,48
220,2022,1,Jubail Governorate Office,تجارة التجزئة، باستثناء المركبات ذات المحركات والدراجات النارية,1061,251,20,2,1334
221,2022,1,Jubail Governorate Office,تجارة الجملة ، باستثناء المركبات ذات المحركات والدراجات النارية,527,184,21,7,739
222,2022,1,Jubail Governorate Office,تجارة الجملة والتجزئة ، وإصلاح المركبات ذات المحركات والدراجات النارية,566,115,6,0,687
223,2022,1,Jubail Governorate Office,تجميع المياه ومعالجتها وتوصيلها,3,6,0,0,9
224,2022,1,Jubail Governorate Office,تشييد المباني,1220,684,142,41,2087
225,2022,1,Jubail Governorate Office,تعدين الفحم والليغنيت,0,2,0,0,2
226,2022,1,Jubail Governorate Office,تعدين ركازات الفلزات,48,12,2,1,63
227,2022,1,Jubail Governorate Office,تمويل التأمين وإعادة التأمين وصناديق المعاشات التقاعدية باستثناء الضمان الاجتماعي الإلزامي,0,1,0,0,1
228,2022,1,Jubail Governorate Office,توصيل الكهرباء والغاز والبخار وتكييف الهواء,13,10,3,1,27
229,2022,1,Jubail Governorate Office,صناعة الآلات والمعدات غير المصنفة في موضع أخر,15,14,4,0,33
230,2022,1,Jubail Governorate Office,صناعة المركبات ذات المحركات والمركبات المقطورة ونصف المقطورة,10,2,0,0,12
231,2022,1,Jubail Governorate Office,صناعة معدات النقل الأخرى,14,5,1,0,20
232,2022,1,Jubail Governorate Office,صنع الأثاث,36,6,0,0,42
233,2022,1,Jubail Governorate Office,صنع الحواسيب والمنتجات الإلكترونية والبصرية,27,7,4,2,40
234,2022,1,Jubail Governorate Office,صُنع الخشب ومنتجات الخشب والفلين ، باستثناء الأثاث ، صُنع أصناف من القش ومواد الضفر,69,13,4,0,86
235,2022,1,Jubail Governorate Office,صنع الفلزات القاعدية,68,25,13,5,111
236,2022,1,Jubail Governorate Office,صُنع المشروبات,3,2,0,0,5
237,2022,1,Jubail Governorate Office,صنع المعدات الكهربائية,61,20,4,1,86
238,2022,1,Jubail Governorate Office,صُنع الملبوسات,169,24,1,0,194
239,2022,1,Jubail Governorate Office,صُنع المنتجات الجلدية والمنتجات ذات الصلة,0,1,0,0,1
240,2022,1,Jubail Governorate Office,صنع المنتجات الصيدلانية الأساسية والمستحضرات الصيدلانية,1,0,0,0,1
241,2022,1,Jubail Governorate Office,صُنع المنتجات الغذائية,121,40,3,1,165
242,2022,1,Jubail Governorate Office,صُنع المنسوجات,43,14,1,0,58
243,2022,1,Jubail Governorate Office,صُنع المواد الكيميائية والمنتجات الكيميائية,25,18,19,3,65
244,2022,1,Jubail Governorate Office,صُنع الورق ومنتجات الورق,1,0,0,0,1
245,2022,1,Jubail Governorate Office,صنع فحم الكوك والمنتجات النفطية المكررة,2,4,0,1,7
246,2022,1,Jubail Governorate Office,صُنع منتجات التبغ,2,0,0,0,2
247,2022,1,Jubail Governorate Office,صنع منتجات المطاط واللدائن,12,23,10,10,55
248,2022,1,Jubail Governorate Office,صنع منتجات المعادن اللافلزية الأخرى,47,26,10,2,85
249,2022,1,Jubail Governorate Office,صنع منتجات المعادن المشكلة ( باستثناء الآلات والمعدات ),145,46,21,6,218
250,2022,1,Jubail Governorate Office,صيد الأسماك وتربية المائيات,66,88,1,0,155
251,2022,1,Jubail Governorate Office,وكالات السفر ومشغّلو الجولات السياحية وخدمات الحجز والأنشطة المتصلة بها,5,3,0,0,8
252,2022,1,Al-Kharj Office,أبحاث الإعلان والسوق,14,4,0,0,18
253,2022,1,Al-Kharj Office,إصلاح أجهزة الحاسوب والسلع الشخصية والمنزلية,86,11,0,0,97
254,2022,1,Al-Kharj Office,إصلاح وتركيب الآلات والمعدات,35,2,1,0,38
255,2022,1,Al-Kharj Office,أنشطة أنتاج الأفلام والبرامج التلفزيونية والتسجيلات الصوتية و نشرالموسيقى,2,0,0,0,2
256,2022,1,Al-Kharj Office,أنشطة الأمن والتحقيقات,2,1,0,0,3
257,2022,1,Al-Kharj Office,أنشطة الاستخدام,17,5,0,1,23
258,2022,1,Al-Kharj Office,أنشطة البرمجة الحاسوبية والخبرة الاستشارية وما يتصل بها من أنشطة,3,2,0,0,5
259,2022,1,Al-Kharj Office,أنشطة البرمجة والإذاعة,2,0,0,0,2
260,2022,1,Al-Kharj Office,أنشطة البريد ونقل الرسائل والطرود بواسطة مندوبين,2,0,0,0,2
261,2022,1,Al-Kharj Office,أنشطة التشييد المتخصصة,1019,199,9,1,1228
262,2022,1,Al-Kharj Office,أنشطة الخدمات الشخصية الأخرى,598,57,1,0,656
263,2022,1,Al-Kharj Office,أنشطة الخدمات المالية ، فيما عدا تمويل التأمين وصناديق المعاشات,27,8,0,0,35
264,2022,1,Al-Kharj Office,أنشطة العمل الاجتماعي، دون إقامة، لكبار السن وذوي الإعاقة,17,17,0,0,34
265,2022,1,Al-Kharj Office,أنشطة المعمارية والهندسية ، والاختبارات الفنية والتحليل,26,8,2,1,37
266,2022,1,Al-Kharj Office,أنشطة المكاتب الرئيسية ، وألأنشطة الاستشارية في مجال الإدارة,20,1,0,0,21
267,2022,1,Al-Kharj Office,أنشطة المكتبات ودور المحفوظات، والمتاحف والأنشطة الثقافية الأخرى,23,1,0,0,24
268,2022,1,Al-Kharj Office,أنشطة المنظمات ذات العضوية,13,3,0,0,16
269,2022,1,Al-Kharj Office,أنشطة النشر,10,3,0,0,13
270,2022,1,Al-Kharj Office,أنشطة تقديم الخدمات للمباني وتجميل المواقع,209,53,7,0,269
271,2022,1,Al-Kharj Office,أنشطة جمع النفايات ومعالجتها وتصريفها ، واسترجاع المواد,1,1,1,0,3
272,2022,1,Al-Kharj Office,أنشطة خدمات الأطعمة والمشروبات,1007,249,11,0,1267
273,2022,1,Al-Kharj Office,أنشطة خدمات المعلومات,10,0,0,0,10
274,2022,1,Al-Kharj Office,أنشطة خدمات دعم التعدين,10,3,0,0,13
275,2022,1,Al-Kharj Office,أنشطة زراعة المحاصيل والإنتاج الحيواني والصيد والخدمات المتصلة,1255,108,15,1,1379
276,2022,1,Al-Kharj Office,الإدارة العامة والدفاع ؛ والضمان الاجتماعي الإلزامي,13,10,0,0,23
277,2022,1,Al-Kharj Office,الإقامة,52,12,0,0,64
278,2022,1,Al-Kharj Office,الأنشطة الإبداعية والفنون وأنشطة الترفيه,5,0,1,0,6
279,2022,1,Al-Kharj Office,الأنشطة الأخرى للتعدين واستغلال المحاجر,14,3,0,0,17
280,2022,1,Al-Kharj Office,الأنشطة الإدارية للمكاتب ، وأنشطة الدعم للمكاتب وغير ذلك من أنشطة الدعم للأعمال,39,6,0,0,45
281,2022,1,Al-Kharj Office,الأنشطة الإيجارية,606,31,1,0,638
282,2022,1,Al-Kharj Office,الأنشطة البيطرية,9,3,0,0,12
283,2022,1,Al-Kharj Office,الأنشطة الرياضية وأنشطة التسلية والترفيه,31,12,0,0,43
284,2022,1,Al-Kharj Office,الأنشطة العقارية,86,19,0,1,106
285,2022,1,Al-Kharj Office,الأنشطة القانونية وأنشطة المحاسبة,5,0,0,0,5
286,2022,1,Al-Kharj Office,الأنشطة المساعدة لأنشطة الخدمات المالية وأنشطة التأمين,2,0,0,0,2
287,2022,1,Al-Kharj Office,الأنشطة المهنية والعلمية والتقنية الأخرى,11,1,0,0,12
288,2022,1,Al-Kharj Office,الاتصالات,14,2,1,0,17
289,2022,1,Al-Kharj Office,التخزين وأنشطة الدعم للنقل,76,9,0,0,85
290,2022,1,Al-Kharj Office,التعليم,28,11,7,0,46
291,2022,1,Al-Kharj Office,الحراجة وقطع الأخشاب,2,0,0,0,2
292,2022,1,Al-Kharj Office,الرعاية مع الإقامة,1,2,0,0,3
293,2022,1,Al-Kharj Office,الصحة البشرية,16,23,8,2,49
294,2022,1,Al-Kharj Office,الصرف الصحي,0,1,0,0,1
295,2022,1,Al-Kharj Office,الصناعة التحويلية الأخرى,9,7,1,0,17
296,2022,1,Al-Kharj Office,الطباعة واستنساخ وسائط الأعلام المسجّلة,16,4,0,0,20
297,2022,1,Al-Kharj Office,النقل البري و النقل عبر الأنابيب,909,106,5,1,1021
298,2022,1,Al-Kharj Office,النقل الجوي,16,5,0,0,21
299,2022,1,Al-Kharj Office,النقل المائي,12,0,0,0,12
300,2022,1,Al-Kharj Office,الهندسة المدنية,8,7,1,1,17
301,2022,1,Al-Kharj Office,تجارة التجزئة، باستثناء المركبات ذات المحركات والدراجات النارية,1567,283,17,1,1868
302,2022,1,Al-Kharj Office,تجارة الجملة ، باستثناء المركبات ذات المحركات والدراجات النارية,741,220,16,0,977
303,2022,1,Al-Kharj Office,تجارة الجملة والتجزئة ، وإصلاح المركبات ذات المحركات والدراجات النارية,781,127,3,0,911
304,2022,1,Al-Kharj Office,تجميع المياه ومعالجتها وتوصيلها,10,0,0,1,11
305,2022,1,Al-Kharj Office,تشييد المباني,1652,476,40,5,2173
306,2022,1,Al-Kharj Office,تعدين ركازات الفلزات,14,1,0,0,15
307,2022,1,Al-Kharj Office,توصيل الكهرباء والغاز والبخار وتكييف الهواء,7,5,1,0,13
308,2022,1,Al-Kharj Office,صناعة الآلات والمعدات غير المصنفة في موضع أخر,18,8,1,0,27
309,2022,1,Al-Kharj Office,صناعة المركبات ذات المحركات والمركبات المقطورة ونصف المقطورة,21,5,0,0,26
310,2022,1,Al-Kharj Office,صناعة معدات النقل الأخرى,7,3,1,0,11
311,2022,1,Al-Kharj Office,صنع الأثاث,58,18,1,1,78
312,2022,1,Al-Kharj Office,صنع الحواسيب والمنتجات الإلكترونية والبصرية,34,4,0,0,38
313,2022,1,Al-Kharj Office,صُنع الخشب ومنتجات الخشب والفلين ، باستثناء الأثاث ، صُنع أصناف من القش ومواد الضفر,70,18,1,0,89
314,2022,1,Al-Kharj Office,صنع الفلزات القاعدية,105,28,3,0,136
315,2022,1,Al-Kharj Office,صُنع المشروبات,8,5,6,6,25
316,2022,1,Al-Kharj Office,صنع المعدات الكهربائية,43,13,1,0,57
317,2022,1,Al-Kharj Office,صُنع الملبوسات,330,36,1,0,367
318,2022,1,Al-Kharj Office,صُنع المنتجات الجلدية والمنتجات ذات الصلة,4,1,0,0,5
319,2022,1,Al-Kharj Office,صنع المنتجات الصيدلانية الأساسية والمستحضرات الصيدلانية,3,5,0,0,8
320,2022,1,Al-Kharj Office,صُنع المنتجات الغذائية,162,59,9,0,230
321,2022,1,Al-Kharj Office,صُنع المنسوجات,27,9,1,0,37
322,2022,1,Al-Kharj Office,صُنع المواد الكيميائية والمنتجات الكيميائية,50,17,3,0,70
323,2022,1,Al-Kharj Office,صُنع الورق ومنتجات الورق,6,3,5,0,14
324,2022,1,Al-Kharj Office,صنع فحم الكوك والمنتجات النفطية المكررة,0,1,0,0,1
325,2022,1,Al-Kharj Office,صُنع منتجات التبغ,0,1,0,0,1
326,2022,1,Al-Kharj Office,صنع منتجات المطاط واللدائن,19,15,5,1,40
327,2022,1,Al-Kharj Office,صنع منتجات المعادن اللافلزية الأخرى,48,36,11,0,95
328,2022,1,Al-Kharj Office,صنع منتجات المعادن المشكلة ( باستثناء الآلات والمعدات ),110,27,4,1,142
329,2022,1,Al-Kharj Office,صيد الأسماك وتربية المائيات,5,0,0,0,5
330,2022,1,Al-Kharj Office,وكالات السفر ومشغّلو الجولات السياحية وخدمات الحجز والأنشطة المتصلة بها,5,1,0,0,6
331,2022,1,Dawadmi Governorate Office,أبحاث الإعلان والسوق,4,0,0,0,4
332,2022,1,Dawadmi Governorate Office,إصلاح أجهزة الحاسوب والسلع الشخصية والمنزلية,35,10,0,0,45
333,2022,1,Dawadmi Governorate Office,إصلاح وتركيب الآلات والمعدات,13,3,0,0,16
334,2022,1,Dawadmi Governorate Office,أنشطة أنتاج الأفلام والبرامج التلفزيونية والتسجيلات الصوتية و نشرالموسيقى,2,0,0,0,2
335,2022,1,Dawadmi Governorate Office,أنشطة الأمن والتحقيقات,1,0,0,0,1
336,2022,1,Dawadmi Governorate Office,أنشطة الاستخدام,8,0,0,0,8
337,2022,1,Dawadmi Governorate Office,أنشطة الاسر المعيشية التي تستخدم أفراداً للعمل المنزلي,3,0,0,0,3
338,2022,1,Dawadmi Governorate Office,أنشطة البرمجة الحاسوبية والخبرة الاستشارية وما يتصل بها من أنشطة,4,0,0,0,4
339,2022,1,Dawadmi Governorate Office,أنشطة البرمجة والإذاعة,1,1,0,0,2
340,2022,1,Dawadmi Governorate Office,أنشطة البريد ونقل الرسائل والطرود بواسطة مندوبين,1,3,0,0,4
341,2022,1,Dawadmi Governorate Office,أنشطة التشييد المتخصصة,705,118,6,2,831
342,2022,1,Dawadmi Governorate Office,أنشطة الخدمات الشخصية الأخرى,353,32,2,0,387
343,2022,1,Dawadmi Governorate Office,أنشطة الخدمات المالية ، فيما عدا تمويل التأمين وصناديق المعاشات,20,1,0,0,21
344,2022,1,Dawadmi Governorate Office,أنشطة العمل الاجتماعي، دون إقامة، لكبار السن وذوي الإعاقة,14,1,1,0,16
345,2022,1,Dawadmi Governorate Office,أنشطة المعمارية والهندسية ، والاختبارات الفنية والتحليل,22,6,0,0,28
346,2022,1,Dawadmi Governorate Office,أنشطة المكاتب الرئيسية ، وألأنشطة الاستشارية في مجال الإدارة,8,0,0,0,8
347,2022,1,Dawadmi Governorate Office,أنشطة المكتبات ودور المحفوظات، والمتاحف والأنشطة الثقافية الأخرى,6,1,0,0,7
348,2022,1,Dawadmi Governorate Office,أنشطة المنظمات ذات العضوية,4,0,0,0,4
349,2022,1,Dawadmi Governorate Office,أنشطة النشر,2,0,0,0,2
350,2022,1,Dawadmi Governorate Office,أنشطة تقديم الخدمات للمباني وتجميل المواقع,712,161,10,1,884
351,2022,1,Dawadmi Governorate Office,أنشطة جمع النفايات ومعالجتها وتصريفها ، واسترجاع المواد,1,0,0,0,1
352,2022,1,Dawadmi Governorate Office,أنشطة خدمات الأطعمة والمشروبات,592,76,5,0,673
353,2022,1,Dawadmi Governorate Office,أنشطة خدمات المعلومات,4,1,0,0,5
354,2022,1,Dawadmi Governorate Office,أنشطة خدمات دعم التعدين,0,2,0,0,2
355,2022,1,Dawadmi Governorate Office,أنشطة زراعة المحاصيل والإنتاج الحيواني والصيد والخدمات المتصلة,1028,36,0,0,1064
356,2022,1,Dawadmi Governorate Office,الإدارة العامة والدفاع ؛ والضمان الاجتماعي الإلزامي,6,3,0,0,9
357,2022,1,Dawadmi Governorate Office,الإقامة,35,7,1,0,43
358,2022,1,Dawadmi Governorate Office,الأنشطة الإبداعية والفنون وأنشطة الترفيه,4,0,0,0,4
359,2022,1,Dawadmi Governorate Office,الأنشطة الأخرى للتعدين واستغلال المحاجر,2,2,0,0,4
360,2022,1,Dawadmi Governorate Office,الأنشطة الإدارية للمكاتب ، وأنشطة الدعم للمكاتب وغير ذلك من أنشطة الدعم للأعمال,13,0,0,0,13
361,2022,1,Dawadmi Governorate Office,الأنشطة الإيجارية,990,20,1,1,1012
362,2022,1,Dawadmi Governorate Office,الأنشطة البيطرية,8,0,0,0,8
363,2022,1,Dawadmi Governorate Office,الأنشطة الرياضية وأنشطة التسلية والترفيه,21,5,0,0,26
364,2022,1,Dawadmi Governorate Office,الأنشطة العقارية,29,6,0,0,35
365,2022,1,Dawadmi Governorate Office,الأنشطة القانونية وأنشطة المحاسبة,1,0,0,0,1
366,2022,1,Dawadmi Governorate Office,الأنشطة المساعدة لأنشطة الخدمات المالية وأنشطة التأمين,1,0,0,0,1
367,2022,1,Dawadmi Governorate Office,الأنشطة المهنية والعلمية والتقنية الأخرى,6,1,0,0,7
368,2022,1,Dawadmi Governorate Office,الاتصالات,5,0,0,0,5
369,2022,1,Dawadmi Governorate Office,التخزين وأنشطة الدعم للنقل,57,4,0,0,61
370,2022,1,Dawadmi Governorate Office,التعليم,16,12,2,0,30
371,2022,1,Dawadmi Governorate Office,الحراجة وقطع الأخشاب,1,0,0,0,1
372,2022,1,Dawadmi Governorate Office,الصحة البشرية,16,7,2,0,25
373,2022,1,Dawadmi Governorate Office,الصرف الصحي,1,0,0,0,1
374,2022,1,Dawadmi Governorate Office,الصناعة التحويلية الأخرى,11,1,0,0,12
375,2022,1,Dawadmi Governorate Office,الطباعة واستنساخ وسائط الأعلام المسجّلة,7,0,0,0,7
376,2022,1,Dawadmi Governorate Office,النقل البري و النقل عبر الأنابيب,696,65,4,0,765
377,2022,1,Dawadmi Governorate Office,النقل الجوي,11,3,0,0,14
378,2022,1,Dawadmi Governorate Office,النقل المائي,2,0,0,0,2
379,2022,1,Dawadmi Governorate Office,الهندسة المدنية,2,0,1,0,3
380,2022,1,Dawadmi Governorate Office,تجارة التجزئة، باستثناء المركبات ذات المحركات والدراجات النارية,616,81,2,0,699
381,2022,1,Dawadmi Governorate Office,تجارة الجملة ، باستثناء المركبات ذات المحركات والدراجات النارية,294,67,4,0,365
382,2022,1,Dawadmi Governorate Office,تجارة الجملة والتجزئة ، وإصلاح المركبات ذات المحركات والدراجات النارية,575,60,5,1,641
383,2022,1,Dawadmi Governorate Office,تجميع المياه ومعالجتها وتوصيلها,5,2,1,0,8
384,2022,1,Dawadmi Governorate Office,تشييد المباني,785,176,21,3,985
385,2022,1,Dawadmi Governorate Office,تعدين ركازات الفلزات,5,0,0,0,5
386,2022,1,Dawadmi Governorate Office,توصيل الكهرباء والغاز والبخار وتكييف الهواء,5,0,1,0,6
387,2022,1,Dawadmi Governorate Office,صناعة الآلات والمعدات غير المصنفة في موضع أخر,6,0,0,0,6
388,2022,1,Dawadmi Governorate Office,صناعة المركبات ذات المحركات والمركبات المقطورة ونصف المقطورة,12,0,0,0,12
389,2022,1,Dawadmi Governorate Office,صناعة معدات النقل الأخرى,4,1,0,0,5
390,2022,1,Dawadmi Governorate Office,صنع الأثاث,44,8,0,0,52
391,2022,1,Dawadmi Governorate Office,صنع الحواسيب والمنتجات الإلكترونية والبصرية,11,0,0,0,11
392,2022,1,Dawadmi Governorate Office,صُنع الخشب ومنتجات الخشب والفلين ، باستثناء الأثاث ، صُنع أصناف من القش ومواد الضفر,57,9,1,0,67
393,2022,1,Dawadmi Governorate Office,صنع الفلزات القاعدية,59,8,0,0,67
394,2022,1,Dawadmi Governorate Office,صُنع المشروبات,5,0,0,0,5
395,2022,1,Dawadmi Governorate Office,صنع المعدات الكهربائية,23,4,0,0,27
396,2022,1,Dawadmi Governorate Office,صُنع الملبوسات,173,21,1,0,195
397,2022,1,Dawadmi Governorate Office,صُنع المنتجات الجلدية والمنتجات ذات الصلة,4,0,0,0,4
398,2022,1,Dawadmi Governorate Office,صنع المنتجات الصيدلانية الأساسية والمستحضرات الصيدلانية,0,1,0,0,1
399,2022,1,Dawadmi Governorate Office,صُنع المنتجات الغذائية,88,12,0,0,100
400,2022,1,Dawadmi Governorate Office,صُنع المنسوجات,22,4,1,0,27
401,2022,1,Dawadmi Governorate Office,صُنع المواد الكيميائية والمنتجات الكيميائية,13,1,0,0,14
402,2022,1,Dawadmi Governorate Office,صُنع الورق ومنتجات الورق,1,0,0,0,1
403,2022,1,Dawadmi Governorate Office,صنع منتجات المطاط واللدائن,5,3,0,0,8
404,2022,1,Dawadmi Governorate Office,صنع منتجات المعادن اللافلزية الأخرى,46,21,1,0,68
405,2022,1,Dawadmi Governorate Office,صنع منتجات المعادن المشكلة ( باستثناء الآلات والمعدات ),80,10,0,0,90
406,2022,1,Dawadmi Governorate Office,صيد الأسماك وتربية المائيات,3,0,0,0,3
407,2022,1,Dawadmi Governorate Office,وكالات السفر ومشغّلو الجولات السياحية وخدمات الحجز والأنشطة المتصلة بها,2,0,0,0,2
408,2022,1,Taif Governorate Office,أبحاث الإعلان والسوق,23,1,0,0,24
409,2022,1,Taif Governorate Office,إصلاح أجهزة الحاسوب والسلع الشخصية والمنزلية,160,16,0,0,176
410,2022,1,Taif Governorate Office,إصلاح وتركيب الآلات والمعدات,60,4,0,0,64
411,2022,1,Taif Governorate Office,أنشطة أنتاج الأفلام والبرامج التلفزيونية والتسجيلات الصوتية و نشرالموسيقى,20,2,0,0,22
412,2022,1,Taif Governorate Office,أنشطة الأمن والتحقيقات,10,1,0,0,11
413,2022,1,Taif Governorate Office,أنشطة الاستخدام,18,3,0,0,21
414,2022,1,Taif Governorate Office,أنشطة الاسر المعيشية التي تستخدم أفراداً للعمل المنزلي,2,1,0,0,3
415,2022,1,Taif Governorate Office,أنشطة البرمجة الحاسوبية والخبرة الاستشارية وما يتصل بها من أنشطة,9,3,0,0,12
416,2022,1,Taif Governorate Office,أنشطة البرمجة والإذاعة,0,0,1,0,1
417,2022,1,Taif Governorate Office,أنشطة البريد ونقل الرسائل والطرود بواسطة مندوبين,1,0,0,0,1
418,2022,1,Taif Governorate Office,أنشطة التشييد المتخصصة,1176,179,1,0,1356
419,2022,1,Taif Governorate Office,أنشطة الخدمات الشخصية الأخرى,1151,90,0,0,1241
420,2022,1,Taif Governorate Office,أنشطة الخدمات المالية ، فيما عدا تمويل التأمين وصناديق المعاشات,14,0,0,0,14
421,2022,1,Taif Governorate Office,أنشطة العمل الاجتماعي، دون إقامة، لكبار السن وذوي الإعاقة,32,31,1,0,64
422,2022,1,Taif Governorate Office,أنشطة المعالجة وخدمات إدارة النفايات الأخرى,0,1,0,0,1
423,2022,1,Taif Governorate Office,أنشطة المعمارية والهندسية ، والاختبارات الفنية والتحليل,180,78,3,0,261
424,2022,1,Taif Governorate Office,أنشطة المكاتب الرئيسية ، وألأنشطة الاستشارية في مجال الإدارة,13,4,0,0,17
425,2022,1,Taif Governorate Office,أنشطة المكتبات ودور المحفوظات، والمتاحف والأنشطة الثقافية الأخرى,37,8,2,0,47
426,2022,1,Taif Governorate Office,أنشطة المنظمات الدولية,0,1,0,0,1
427,2022,1,Taif Governorate Office,أنشطة المنظمات ذات العضوية,15,2,1,0,18
428,2022,1,Taif Governorate Office,أنشطة النشر,10,5,0,0,15
429,2022,1,Taif Governorate Office,أنشطة تقديم الخدمات للمباني وتجميل المواقع,274,50,7,2,333
430,2022,1,Taif Governorate Office,أنشطة جمع النفايات ومعالجتها وتصريفها ، واسترجاع المواد,4,0,0,0,4
431,2022,1,Taif Governorate Office,أنشطة خدمات الأطعمة والمشروبات,2334,527,34,0,2895
432,2022,1,Taif Governorate Office,أنشطة خدمات المعلومات,9,1,0,0,10
433,2022,1,Taif Governorate Office,أنشطة خدمات دعم التعدين,19,7,1,0,27
434,2022,1,Taif Governorate Office,أنشطة زراعة المحاصيل والإنتاج الحيواني والصيد والخدمات المتصلة,579,24,2,0,605
435,2022,1,Taif Governorate Office,الإدارة العامة والدفاع ؛ والضمان الاجتماعي الإلزامي,18,6,5,0,29
436,2022,1,Taif Governorate Office,الإقامة,156,49,7,0,212
437,2022,1,Taif Governorate Office,الأنشطة الإبداعية والفنون وأنشطة الترفيه,9,4,0,0,13
438,2022,1,Taif Governorate Office,الأنشطة الأخرى للتعدين واستغلال المحاجر,8,1,0,0,9
439,2022,1,Taif Governorate Office,الأنشطة الإدارية للمكاتب ، وأنشطة الدعم للمكاتب وغير ذلك من أنشطة الدعم للأعمال,60,5,0,0,65
440,2022,1,Taif Governorate Office,الأنشطة الإيجارية,1048,54,2,0,1104
441,2022,1,Taif Governorate Office,الأنشطة البيطرية,18,4,0,0,22
442,2022,1,Taif Governorate Office,الأنشطة الرياضية وأنشطة التسلية والترفيه,56,25,0,0,81
443,2022,1,Taif Governorate Office,الأنشطة العقارية,67,13,2,0,82
444,2022,1,Taif Governorate Office,الأنشطة القانونية وأنشطة المحاسبة,11,2,0,0,13
445,2022,1,Taif Governorate Office,الأنشطة المهنية والعلمية والتقنية الأخرى,41,6,0,0,47
446,2022,1,Taif Governorate Office,الاتصالات,31,0,0,0,31
447,2022,1,Taif Governorate Office,البحث والتطوير في المجال العلمي,1,0,0,0,1
448,2022,1,Taif Governorate Office,التخزين وأنشطة الدعم للنقل,82,7,2,0,91
449,2022,1,Taif Governorate Office,التعليم,35,31,18,0,84
450,2022,1,Taif Governorate Office,الرعاية مع الإقامة,1,1,0,0,2
451,2022,1,Taif Governorate Office,الصحة البشرية,25,102,14,2,143
452,2022,1,Taif Governorate Office,الصناعة التحويلية الأخرى,27,16,1,1,45
453,2022,1,Taif Governorate Office,الطباعة واستنساخ وسائط الأعلام المسجّلة,28,11,0,0,39
454,2022,1,Taif Governorate Office,النقل البري و النقل عبر الأنابيب,702,85,1,0,788
455,2022,1,Taif Governorate Office,النقل الجوي,15,3,0,0,18
456,2022,1,Taif Governorate Office,النقل المائي,6,2,0,0,8
457,2022,1,Taif Governorate Office,الهندسة المدنية,15,2,1,0,18
458,2022,1,Taif Governorate Office,تجارة التجزئة، باستثناء المركبات ذات المحركات والدراجات النارية,2785,436,24,0,3245
459,2022,1,Taif Governorate Office,تجارة الجملة ، باستثناء المركبات ذات المحركات والدراجات النارية,905,171,18,0,1094
460,2022,1,Taif Governorate Office,تجارة الجملة والتجزئة ، وإصلاح المركبات ذات المحركات والدراجات النارية,1419,173,5,0,1597
461,2022,1,Taif Governorate Office,تجميع المياه ومعالجتها وتوصيلها,139,20,2,0,161
462,2022,1,Taif Governorate Office,تشييد المباني,2298,507,41,2,2848
463,2022,1,Taif Governorate Office,تعدين الفحم والليغنيت,2,0,0,0,2
464,2022,1,Taif Governorate Office,تعدين ركازات الفلزات,19,3,0,0,22
465,2022,1,Taif Governorate Office,تمويل التأمين وإعادة التأمين وصناديق المعاشات التقاعدية باستثناء الضمان الاجتماعي الإلزامي,0,1,0,0,1
466,2022,1,Taif Governorate Office,توصيل الكهرباء والغاز والبخار وتكييف الهواء,10,1,0,0,11
467,2022,1,Taif Governorate Office,صناعة الآلات والمعدات غير المصنفة في موضع أخر,18,0,0,0,18
468,2022,1,Taif Governorate Office,صناعة المركبات ذات المحركات والمركبات المقطورة ونصف المقطورة,33,2,0,0,35
469,2022,1,Taif Governorate Office,صناعة معدات النقل الأخرى,4,2,0,0,6
470,2022,1,Taif Governorate Office,صنع الأثاث,172,27,3,0,202
471,2022,1,Taif Governorate Office,صنع الحواسيب والمنتجات الإلكترونية والبصرية,108,17,0,0,125
472,2022,1,Taif Governorate Office,صُنع الخشب ومنتجات الخشب والفلين ، باستثناء الأثاث ، صُنع أصناف من القش ومواد الضفر,178,28,0,0,206
473,2022,1,Taif Governorate Office,صنع الفلزات القاعدية,112,26,2,0,140
474,2022,1,Taif Governorate Office,صُنع المشروبات,17,6,0,0,23
475,2022,1,Taif Governorate Office,صنع المعدات الكهربائية,78,14,0,1,93
476,2022,1,Taif Governorate Office,صُنع الملبوسات,514,48,2,0,564
477,2022,1,Taif Governorate Office,صُنع المنتجات الجلدية والمنتجات ذات الصلة,8,0,0,0,8
478,2022,1,Taif Governorate Office,صنع المنتجات الصيدلانية الأساسية والمستحضرات الصيدلانية,1,0,0,0,1
479,2022,1,Taif Governorate Office,صُنع المنتجات الغذائية,350,95,3,1,449
480,2022,1,Taif Governorate Office,صُنع المنسوجات,62,23,0,0,85
481,2022,1,Taif Governorate Office,صُنع المواد الكيميائية والمنتجات الكيميائية,62,12,3,0,77
482,2022,1,Taif Governorate Office,صُنع الورق ومنتجات الورق,8,2,0,0,10
483,2022,1,Taif Governorate Office,صُنع منتجات التبغ,1,0,0,0,1
484,2022,1,Taif Governorate Office,صنع منتجات المطاط واللدائن,17,7,0,0,24
485,2022,1,Taif Governorate Office,صنع منتجات المعادن اللافلزية الأخرى,78,20,1,1,100
486,2022,1,Taif Governorate Office,صنع منتجات المعادن المشكلة ( باستثناء الآلات والمعدات ),492,63,0,0,555
487,2022,1,Taif Governorate Office,صيد الأسماك وتربية المائيات,3,1,0,0,4
488,2022,1,Taif Governorate Office,وكالات السفر ومشغّلو الجولات السياحية وخدمات الحجز والأنشطة المتصلة بها,16,3,0,0,19
489,2022,1,Bishah Governorate Office,أبحاث الإعلان والسوق,2,0,0,0,2
490,2022,1,Bishah Governorate Office,إصلاح أجهزة الحاسوب والسلع الشخصية والمنزلية,40,6,0,0,46
491,2022,1,Bishah Governorate Office,إصلاح وتركيب الآلات والمعدات,11,0,0,0,11
492,2022,1,Bishah Governorate Office,أنشطة الاستخدام,8,0,0,0,8
493,2022,1,Bishah Governorate Office,أنشطة الاسر المعيشية التي تستخدم أفراداً للعمل المنزلي,1,0,0,0,1
494,2022,1,Bishah Governorate Office,أنشطة البرمجة الحاسوبية والخبرة الاستشارية وما يتصل بها من أنشطة,2,0,1,0,3
495,2022,1,Bishah Governorate Office,أنشطة التشييد المتخصصة,566,72,1,0,639
496,2022,1,Bishah Governorate Office,أنشطة الخدمات الشخصية الأخرى,214,22,0,0,236
497,2022,1,Bishah Governorate Office,أنشطة الخدمات المالية ، فيما عدا تمويل التأمين وصناديق المعاشات,13,2,0,0,15
498,2022,1,Bishah Governorate Office,أنشطة العمل الاجتماعي، دون إقامة، لكبار السن وذوي الإعاقة,28,8,0,0,36
499,2022,1,Bishah Governorate Office,أنشطة المعمارية والهندسية ، والاختبارات الفنية والتحليل,21,4,2,0,27
500,2022,1,Bishah Governorate Office,أنشطة المكاتب الرئيسية ، وألأنشطة الاستشارية في مجال الإدارة,6,1,0,0,7
501,2022,1,Bishah Governorate Office,أنشطة المكتبات ودور المحفوظات، والمتاحف والأنشطة الثقافية الأخرى,8,3,0,0,11
502,2022,1,Bishah Governorate Office,أنشطة المنظمات ذات العضوية,7,1,0,0,8
503,2022,1,Bishah Governorate Office,أنشطة النشر,3,0,0,0,3
504,2022,1,Bishah Governorate Office,أنشطة تقديم الخدمات للمباني وتجميل المواقع,50,10,0,0,60
505,2022,1,Bishah Governorate Office,أنشطة جمع النفايات ومعالجتها وتصريفها ، واسترجاع المواد,2,0,0,0,2
506,2022,1,Bishah Governorate Office,أنشطة خدمات الأطعمة والمشروبات,516,91,4,0,611
507,2022,1,Bishah Governorate Office,أنشطة خدمات المعلومات,1,0,0,0,1
508,2022,1,Bishah Governorate Office,أنشطة خدمات دعم التعدين,7,1,0,0,8
509,2022,1,Bishah Governorate Office,أنشطة زراعة المحاصيل والإنتاج الحيواني والصيد والخدمات المتصلة,272,15,0,0,287
510,2022,1,Bishah Governorate Office,الإدارة العامة والدفاع ؛ والضمان الاجتماعي الإلزامي,3,4,0,0,7
511,2022,1,Bishah Governorate Office,الإقامة,30,11,1,0,42
512,2022,1,Bishah Governorate Office,الأنشطة الأخرى للتعدين واستغلال المحاجر,8,4,1,0,13
513,2022,1,Bishah Governorate Office,الأنشطة الإدارية للمكاتب ، وأنشطة الدعم للمكاتب وغير ذلك من أنشطة الدعم للأعمال,12,3,0,0,15
514,2022,1,Bishah Governorate Office,الأنشطة الإيجارية,246,5,1,0,252
515,2022,1,Bishah Governorate Office,الأنشطة البيطرية,6,0,0,0,6
516,2022,1,Bishah Governorate Office,الأنشطة الرياضية وأنشطة التسلية والترفيه,9,4,0,0,13
517,2022,1,Bishah Governorate Office,الأنشطة العقارية,5,3,0,0,8
518,2022,1,Bishah Governorate Office,الأنشطة القانونية وأنشطة المحاسبة,1,0,0,0,1
519,2022,1,Bishah Governorate Office,الأنشطة المهنية والعلمية والتقنية الأخرى,3,0,0,0,3
520,2022,1,Bishah Governorate Office,الاتصالات,9,1,0,0,10
521,2022,1,Bishah Governorate Office,البحث والتطوير في المجال العلمي,1,0,0,0,1
522,2022,1,Bishah Governorate Office,التخزين وأنشطة الدعم للنقل,35,3,0,0,38
523,2022,1,Bishah Governorate Office,التعليم,16,8,1,0,25
524,2022,1,Bishah Governorate Office,الرعاية مع الإقامة,4,0,0,0,4
525,2022,1,Bishah Governorate Office,الصحة البشرية,4,13,2,0,19
526,2022,1,Bishah Governorate Office,الصناعة التحويلية الأخرى,1,1,0,0,2
527,2022,1,Bishah Governorate Office,الطباعة واستنساخ وسائط الأعلام المسجّلة,7,0,0,0,7
528,2022,1,Bishah Governorate Office,النقل البري و النقل عبر الأنابيب,301,28,1,0,330
529,2022,1,Bishah Governorate Office,النقل الجوي,1,2,0,0,3
530,2022,1,Bishah Governorate Office,النقل المائي,1,1,0,0,2
531,2022,1,Bishah Governorate Office,الهندسة المدنية,4,2,0,0,6
532,2022,1,Bishah Governorate Office,تجارة التجزئة، باستثناء المركبات ذات المحركات والدراجات النارية,841,165,7,0,1013
533,2022,1,Bishah Governorate Office,تجارة الجملة ، باستثناء المركبات ذات المحركات والدراجات النارية,203,69,0,1,273
534,2022,1,Bishah Governorate Office,تجارة الجملة والتجزئة ، وإصلاح المركبات ذات المحركات والدراجات النارية,414,36,3,0,453
535,2022,1,Bishah Governorate Office,تجميع المياه ومعالجتها وتوصيلها,8,3,0,0,11
536,2022,1,Bishah Governorate Office,تشييد المباني,782,178,9,3,972
537,2022,1,Bishah Governorate Office,تعدين ركازات الفلزات,13,4,0,0,17
538,2022,1,Bishah Governorate Office,توصيل الكهرباء والغاز والبخار وتكييف الهواء,5,3,0,0,8
539,2022,1,Bishah Governorate Office,صناعة الآلات والمعدات غير المصنفة في موضع أخر,5,0,0,0,5
540,2022,1,Bishah Governorate Office,صناعة المركبات ذات المحركات والمركبات المقطورة ونصف المقطورة,9,0,0,0,9
541,2022,1,Bishah Governorate Office,صناعة معدات النقل الأخرى,3,0,0,0,3
542,2022,1,Bishah Governorate Office,صنع الأثاث,47,15,0,0,62
543,2022,1,Bishah Governorate Office,صنع الحواسيب والمنتجات الإلكترونية والبصرية,37,5,0,0,42
544,2022,1,Bishah Governorate Office,صُنع الخشب ومنتجات الخشب والفلين ، باستثناء الأثاث ، صُنع أصناف من القش ومواد الضفر,45,6,0,0,51
545,2022,1,Bishah Governorate Office,صنع الفلزات القاعدية,33,5,0,0,38
546,2022,1,Bishah Governorate Office,صُنع المشروبات,8,0,0,0,8
547,2022,1,Bishah Governorate Office,صنع المعدات الكهربائية,21,0,0,0,21
548,2022,1,Bishah Governorate Office,صُنع الملبوسات,124,19,0,0,143
549,2022,1,Bishah Governorate Office,صُنع المنتجات الجلدية والمنتجات ذات الصلة,4,0,0,0,4
550,2022,1,Bishah Governorate Office,صنع المنتجات الصيدلانية الأساسية والمستحضرات الصيدلانية,0,1,0,0,1
551,2022,1,Bishah Governorate Office,صُنع المنتجات الغذائية,84,14,0,0,98
552,2022,1,Bishah Governorate Office,صُنع المنسوجات,20,2,0,0,22
553,2022,1,Bishah Governorate Office,صُنع المواد الكيميائية والمنتجات الكيميائية,18,2,0,0,20
554,2022,1,Bishah Governorate Office,صُنع الورق ومنتجات الورق,1,0,0,0,1
555,2022,1,Bishah Governorate Office,صنع منتجات المطاط واللدائن,4,5,0,0,9
556,2022,1,Bishah Governorate Office,صنع منتجات المعادن اللافلزية الأخرى,28,9,2,1,40
557,2022,1,Bishah Governorate Office,صنع منتجات المعادن المشكلة ( باستثناء الآلات والمعدات ),84,11,1,0,96
558,2022,1,Bishah Governorate Office,صيد الأسماك وتربية المائيات,3,0,0,0,3
559,2022,1,Bishah Governorate Office,وكالات السفر ومشغّلو الجولات السياحية وخدمات الحجز والأنشطة المتصلة بها,1,0,0,0,1
560,2022,1,Hafr Al-Batin Governorate Office,أبحاث الإعلان والسوق,11,3,0,0,14
561,2022,1,Hafr Al-Batin Governorate Office,إصلاح أجهزة الحاسوب والسلع الشخصية والمنزلية,56,3,0,0,59
562,2022,1,Hafr Al-Batin Governorate Office,إصلاح وتركيب الآلات والمعدات,26,0,0,0,26
563,2022,1,Hafr Al-Batin Governorate Office,أنشطة أنتاج الأفلام والبرامج التلفزيونية والتسجيلات الصوتية و نشرالموسيقى,2,0,0,0,2
564,2022,1,Hafr Al-Batin Governorate Office,أنشطة الأمن والتحقيقات,1,2,0,0,3
565,2022,1,Hafr Al-Batin Governorate Office,أنشطة الاستخدام,16,6,1,1,24
566,2022,1,Hafr Al-Batin Governorate Office,أنشطة الاسر المعيشية التي تستخدم أفراداً للعمل المنزلي,1,0,0,0,1
567,2022,1,Hafr Al-Batin Governorate Office,أنشطة البرمجة الحاسوبية والخبرة الاستشارية وما يتصل بها من أنشطة,3,1,0,0,4
568,2022,1,Hafr Al-Batin Governorate Office,أنشطة البريد ونقل الرسائل والطرود بواسطة مندوبين,2,0,0,0,2
569,2022,1,Hafr Al-Batin Governorate Office,أنشطة التشييد المتخصصة,668,131,10,3,812
570,2022,1,Hafr Al-Batin Governorate Office,أنشطة الخدمات الشخصية الأخرى,526,50,2,0,578
571,2022,1,Hafr Al-Batin Governorate Office,أنشطة الخدمات المالية ، فيما عدا تمويل التأمين وصناديق المعاشات,14,5,0,0,19
572,2022,1,Hafr Al-Batin Governorate Office,أنشطة العمل الاجتماعي، دون إقامة، لكبار السن وذوي الإعاقة,3,3,0,0,6
573,2022,1,Hafr Al-Batin Governorate Office,أنشطة المعمارية والهندسية ، والاختبارات الفنية والتحليل,39,9,2,0,50
574,2022,1,Hafr Al-Batin Governorate Office,أنشطة المكاتب الرئيسية ، وألأنشطة الاستشارية في مجال الإدارة,12,3,0,0,15
575,2022,1,Hafr Al-Batin Governorate Office,أنشطة المكتبات ودور المحفوظات، والمتاحف والأنشطة الثقافية الأخرى,9,5,0,0,14
576,2022,1,Hafr Al-Batin Governorate Office,أنشطة المنظمات ذات العضوية,0,1,0,0,1
577,2022,1,Hafr Al-Batin Governorate Office,أنشطة النشر,13,5,0,0,18
578,2022,1,Hafr Al-Batin Governorate Office,أنشطة تقديم الخدمات للمباني وتجميل المواقع,118,24,2,0,144
579,2022,1,Hafr Al-Batin Governorate Office,أنشطة جمع النفايات ومعالجتها وتصريفها ، واسترجاع المواد,1,0,1,0,2
580,2022,1,Hafr Al-Batin Governorate Office,أنشطة خدمات الأطعمة والمشروبات,1352,302,18,2,1674
581,2022,1,Hafr Al-Batin Governorate Office,أنشطة خدمات المعلومات,5,0,0,0,5
582,2022,1,Hafr Al-Batin Governorate Office,أنشطة خدمات دعم التعدين,9,2,0,0,11
583,2022,1,Hafr Al-Batin Governorate Office,أنشطة زراعة المحاصيل والإنتاج الحيواني والصيد والخدمات المتصلة,127,3,0,0,130
584,2022,1,Hafr Al-Batin Governorate Office,الإدارة العامة والدفاع ؛ والضمان الاجتماعي الإلزامي,6,6,0,0,12
585,2022,1,Hafr Al-Batin Governorate Office,الإقامة,34,14,1,0,49
586,2022,1,Hafr Al-Batin Governorate Office,الأنشطة الإبداعية والفنون وأنشطة الترفيه,1,0,0,0,1
587,2022,1,Hafr Al-Batin Governorate Office,الأنشطة الأخرى للتعدين واستغلال المحاجر,11,1,0,0,12
588,2022,1,Hafr Al-Batin Governorate Office,الأنشطة الإدارية للمكاتب ، وأنشطة الدعم للمكاتب وغير ذلك من أنشطة الدعم للأعمال,21,4,0,0,25
589,2022,1,Hafr Al-Batin Governorate Office,الأنشطة الإيجارية,470,27,0,0,497
590,2022,1,Hafr Al-Batin Governorate Office,الأنشطة البيطرية,8,1,0,0,9
591,2022,1,Hafr Al-Batin Governorate Office,الأنشطة الرياضية وأنشطة التسلية والترفيه,18,5,0,0,23
592,2022,1,Hafr Al-Batin Governorate Office,الأنشطة العقارية,18,2,0,0,20
593,2022,1,Hafr Al-Batin Governorate Office,الأنشطة القانونية وأنشطة المحاسبة,2,0,0,0,2
594,2022,1,Hafr Al-Batin Governorate Office,الأنشطة المساعدة لأنشطة الخدمات المالية وأنشطة التأمين,1,2,0,0,3
595,2022,1,Hafr Al-Batin Governorate Office,الأنشطة المهنية والعلمية والتقنية الأخرى,8,2,1,0,11
596,2022,1,Hafr Al-Batin Governorate Office,الاتصالات,10,0,0,0,10
597,2022,1,Hafr Al-Batin Governorate Office,التخزين وأنشطة الدعم للنقل,88,24,1,0,113
598,2022,1,Hafr Al-Batin Governorate Office,التعليم,19,21,8,1,49
599,2022,1,Hafr Al-Batin Governorate Office,الصحة البشرية,16,21,11,0,48
600,2022,1,Hafr Al-Batin Governorate Office,الصناعة التحويلية الأخرى,6,1,0,0,7
601,2022,1,Hafr Al-Batin Governorate Office,الطباعة واستنساخ وسائط الأعلام المسجّلة,10,3,0,0,13
602,2022,1,Hafr Al-Batin Governorate Office,النقل البري و النقل عبر الأنابيب,407,61,6,2,476
603,2022,1,Hafr Al-Batin Governorate Office,النقل الجوي,10,4,0,0,14
604,2022,1,Hafr Al-Batin Governorate Office,النقل المائي,5,0,0,0,5
605,2022,1,Hafr Al-Batin Governorate Office,الهندسة المدنية,1,0,0,0,1
606,2022,1,Hafr Al-Batin Governorate Office,تجارة التجزئة، باستثناء المركبات ذات المحركات والدراجات النارية,1130,199,8,1,1338
607,2022,1,Hafr Al-Batin Governorate Office,تجارة الجملة ، باستثناء المركبات ذات المحركات والدراجات النارية,353,86,8,1,448
608,2022,1,Hafr Al-Batin Governorate Office,تجارة الجملة والتجزئة ، وإصلاح المركبات ذات المحركات والدراجات النارية,663,116,6,0,785
609,2022,1,Hafr Al-Batin Governorate Office,تجميع المياه ومعالجتها وتوصيلها,3,2,0,0,5
610,2022,1,Hafr Al-Batin Governorate Office,تشييد المباني,1271,314,36,2,1623
611,2022,1,Hafr Al-Batin Governorate Office,تعدين ركازات الفلزات,47,7,0,0,54
612,2022,1,Hafr Al-Batin Governorate Office,توصيل الكهرباء والغاز والبخار وتكييف الهواء,4,4,0,0,8
613,2022,1,Hafr Al-Batin Governorate Office,صناعة الآلات والمعدات غير المصنفة في موضع أخر,14,0,0,0,14
614,2022,1,Hafr Al-Batin Governorate Office,صناعة المركبات ذات المحركات والمركبات المقطورة ونصف المقطورة,15,1,0,0,16
615,2022,1,Hafr Al-Batin Governorate Office,صناعة معدات النقل الأخرى,6,1,0,0,7
616,2022,1,Hafr Al-Batin Governorate Office,صنع الأثاث,96,23,0,0,119
617,2022,1,Hafr Al-Batin Governorate Office,صنع الحواسيب والمنتجات الإلكترونية والبصرية,15,3,0,0,18
618,2022,1,Hafr Al-Batin Governorate Office,صُنع الخشب ومنتجات الخشب والفلين ، باستثناء الأثاث ، صُنع أصناف من القش ومواد الضفر,58,10,0,0,68
619,2022,1,Hafr Al-Batin Governorate Office,صنع الفلزات القاعدية,26,10,0,0,36
620,2022,1,Hafr Al-Batin Governorate Office,صُنع المشروبات,10,3,3,0,16
621,2022,1,Hafr Al-Batin Governorate Office,صنع المعدات الكهربائية,69,11,0,0,80
622,2022,1,Hafr Al-Batin Governorate Office,صُنع الملبوسات,296,41,0,0,337
623,2022,1,Hafr Al-Batin Governorate Office,صُنع المنتجات الجلدية والمنتجات ذات الصلة,2,2,1,0,5
624,2022,1,Hafr Al-Batin Governorate Office,صنع المنتجات الصيدلانية الأساسية والمستحضرات الصيدلانية,0,1,0,0,1
625,2022,1,Hafr Al-Batin Governorate Office,صُنع المنتجات الغذائية,110,38,7,1,156
626,2022,1,Hafr Al-Batin Governorate Office,صُنع المنسوجات,58,12,1,0,71
627,2022,1,Hafr Al-Batin Governorate Office,صُنع المواد الكيميائية والمنتجات الكيميائية,25,5,0,0,30
628,2022,1,Hafr Al-Batin Governorate Office,صُنع الورق ومنتجات الورق,3,3,1,0,7
629,2022,1,Hafr Al-Batin Governorate Office,صنع فحم الكوك والمنتجات النفطية المكررة,1,0,0,0,1
630,2022,1,Hafr Al-Batin Governorate Office,صُنع منتجات التبغ,2,1,0,0,3
631,2022,1,Hafr Al-Batin Governorate Office,صنع منتجات المطاط واللدائن,9,4,1,0,14
632,2022,1,Hafr Al-Batin Governorate Office,صنع منتجات المعادن اللافلزية الأخرى,83,31,8,0,122
633,2022,1,Hafr Al-Batin Governorate Office,صنع منتجات المعادن المشكلة ( باستثناء الآلات والمعدات ),116,32,2,0,150
634,2022,1,Hafr Al-Batin Governorate Office,صيد الأسماك وتربية المائيات,1,0,0,0,1
635,2022,1,Hafr Al-Batin Governorate Office,وكالات السفر ومشغّلو الجولات السياحية وخدمات الحجز والأنشطة المتصلة بها,2,3,0,0,5
636,2022,1,Yanbu Governorate Office,أبحاث الإعلان والسوق,8,0,0,0,8
637,2022,1,Yanbu Governorate Office,إصلاح أجهزة الحاسوب والسلع الشخصية والمنزلية,60,7,0,0,67
638,2022,1,Yanbu Governorate Office,إصلاح وتركيب الآلات والمعدات,21,5,0,0,26
639,2022,1,Yanbu Governorate Office,أنشطة أنتاج الأفلام والبرامج التلفزيونية والتسجيلات الصوتية و نشرالموسيقى,5,0,0,0,5
640,2022,1,Yanbu Governorate Office,أنشطة الاستخدام,9,2,0,0,11
641,2022,1,Yanbu Governorate Office,أنشطة الاسر المعيشية التي تستخدم أفراداً للعمل المنزلي,1,0,0,0,1
642,2022,1,Yanbu Governorate Office,أنشطة البرمجة الحاسوبية والخبرة الاستشارية وما يتصل بها من أنشطة,5,2,0,0,7
643,2022,1,Yanbu Governorate Office,أنشطة البريد ونقل الرسائل والطرود بواسطة مندوبين,1,0,0,0,1
644,2022,1,Yanbu Governorate Office,أنشطة التشييد المتخصصة,541,123,9,0,673
645,2022,1,Yanbu Governorate Office,أنشطة الخدمات الشخصية الأخرى,336,43,4,0,383
646,2022,1,Yanbu Governorate Office,أنشطة الخدمات المالية ، فيما عدا تمويل التأمين وصناديق المعاشات,4,0,0,0,4
647,2022,1,Yanbu Governorate Office,أنشطة العمل الاجتماعي، دون إقامة، لكبار السن وذوي الإعاقة,23,8,0,0,31
648,2022,1,Yanbu Governorate Office,أنشطة المعمارية والهندسية ، والاختبارات الفنية والتحليل,28,5,0,0,33
649,2022,1,Yanbu Governorate Office,أنشطة المكاتب الرئيسية ، وألأنشطة الاستشارية في مجال الإدارة,6,1,0,0,7
650,2022,1,Yanbu Governorate Office,أنشطة المكتبات ودور المحفوظات، والمتاحف والأنشطة الثقافية الأخرى,9,1,0,0,10
651,2022,1,Yanbu Governorate Office,أنشطة المنظمات الدولية,1,0,0,0,1
652,2022,1,Yanbu Governorate Office,أنشطة المنظمات ذات العضوية,9,4,0,0,13
653,2022,1,Yanbu Governorate Office,أنشطة النشر,3,1,0,0,4
654,2022,1,Yanbu Governorate Office,أنشطة تقديم الخدمات للمباني وتجميل المواقع,109,48,0,1,158
655,2022,1,Yanbu Governorate Office,أنشطة خدمات الأطعمة والمشروبات,816,246,10,0,1072
656,2022,1,Yanbu Governorate Office,أنشطة خدمات المعلومات,2,3,0,0,5
657,2022,1,Yanbu Governorate Office,أنشطة خدمات دعم التعدين,2,4,0,2,8
658,2022,1,Yanbu Governorate Office,أنشطة زراعة المحاصيل والإنتاج الحيواني والصيد والخدمات المتصلة,125,8,0,0,133
659,2022,1,Yanbu Governorate Office,الإدارة العامة والدفاع ؛ والضمان الاجتماعي الإلزامي,6,12,0,0,18
660,2022,1,Yanbu Governorate Office,الإقامة,48,19,4,0,71
661,2022,1,Yanbu Governorate Office,الأنشطة الإبداعية والفنون وأنشطة الترفيه,3,1,0,0,4
662,2022,1,Yanbu Governorate Office,الأنشطة الأخرى للتعدين واستغلال المحاجر,5,0,0,0,5
663,2022,1,Yanbu Governorate Office,الأنشطة الإدارية للمكاتب ، وأنشطة الدعم للمكاتب وغير ذلك من أنشطة الدعم للأعمال,15,0,0,0,15
664,2022,1,Yanbu Governorate Office,الأنشطة الإيجارية,141,14,1,0,156
665,2022,1,Yanbu Governorate Office,الأنشطة الرياضية وأنشطة التسلية والترفيه,19,8,1,0,28
666,2022,1,Yanbu Governorate Office,الأنشطة العقارية,17,1,0,0,18
667,2022,1,Yanbu Governorate Office,الأنشطة القانونية وأنشطة المحاسبة,3,0,0,0,3
668,2022,1,Yanbu Governorate Office,الأنشطة المهنية والعلمية والتقنية الأخرى,8,0,0,0,8
669,2022,1,Yanbu Governorate Office,الاتصالات,8,1,0,0,9
670,2022,1,Yanbu Governorate Office,البحث والتطوير في المجال العلمي,0,0,1,0,1
671,2022,1,Yanbu Governorate Office,التخزين وأنشطة الدعم للنقل,42,12,2,1,57
672,2022,1,Yanbu Governorate Office,التعليم,25,14,8,0,47
673,2022,1,Yanbu Governorate Office,الرعاية مع الإقامة,6,1,0,0,7
674,2022,1,Yanbu Governorate Office,الصحة البشرية,15,20,6,2,43
675,2022,1,Yanbu Governorate Office,الصرف الصحي,1,0,0,0,1
676,2022,1,Yanbu Governorate Office,الصناعة التحويلية الأخرى,6,1,0,0,7
677,2022,1,Yanbu Governorate Office,الطباعة واستنساخ وسائط الأعلام المسجّلة,15,2,1,0,18
678,2022,1,Yanbu Governorate Office,النقل البري و النقل عبر الأنابيب,280,45,9,0,334
679,2022,1,Yanbu Governorate Office,النقل الجوي,6,3,0,0,9
680,2022,1,Yanbu Governorate Office,النقل المائي,8,2,1,0,11
681,2022,1,Yanbu Governorate Office,الهندسة المدنية,5,5,0,0,10
682,2022,1,Yanbu Governorate Office,تجارة التجزئة، باستثناء المركبات ذات المحركات والدراجات النارية,953,196,10,2,1161
683,2022,1,Yanbu Governorate Office,تجارة الجملة ، باستثناء المركبات ذات المحركات والدراجات النارية,292,89,9,0,390
684,2022,1,Yanbu Governorate Office,تجارة الجملة والتجزئة ، وإصلاح المركبات ذات المحركات والدراجات النارية,482,75,2,0,559
685,2022,1,Yanbu Governorate Office,تجميع المياه ومعالجتها وتوصيلها,4,2,0,0,6
686,2022,1,Yanbu Governorate Office,تشييد المباني,913,373,51,4,1341
687,2022,1,Yanbu Governorate Office,تعدين الفحم والليغنيت,1,0,0,0,1
688,2022,1,Yanbu Governorate Office,تعدين ركازات الفلزات,4,1,0,0,5
689,2022,1,Yanbu Governorate Office,تمويل التأمين وإعادة التأمين وصناديق المعاشات التقاعدية باستثناء الضمان الاجتماعي الإلزامي,1,0,0,0,1
690,2022,1,Yanbu Governorate Office,توصيل الكهرباء والغاز والبخار وتكييف الهواء,5,2,1,0,8
691,2022,1,Yanbu Governorate Office,صناعة الآلات والمعدات غير المصنفة في موضع أخر,3,1,1,0,5
692,2022,1,Yanbu Governorate Office,صناعة المركبات ذات المحركات والمركبات المقطورة ونصف المقطورة,8,1,1,0,10
693,2022,1,Yanbu Governorate Office,صناعة معدات النقل الأخرى,4,0,0,0,4
694,2022,1,Yanbu Governorate Office,صنع الأثاث,39,2,0,0,41
695,2022,1,Yanbu Governorate Office,صنع الحواسيب والمنتجات الإلكترونية والبصرية,8,4,0,0,12
696,2022,1,Yanbu Governorate Office,صُنع الخشب ومنتجات الخشب والفلين ، باستثناء الأثاث ، صُنع أصناف من القش ومواد الضفر,30,5,1,0,36
697,2022,1,Yanbu Governorate Office,صنع الفلزات القاعدية,23,3,2,0,28
698,2022,1,Yanbu Governorate Office,صُنع المشروبات,4,1,0,0,5
699,2022,1,Yanbu Governorate Office,صنع المعدات الكهربائية,16,3,1,1,21
700,2022,1,Yanbu Governorate Office,صُنع الملبوسات,156,21,0,0,177
701,2022,1,Yanbu Governorate Office,صُنع المنتجات الجلدية والمنتجات ذات الصلة,1,0,0,0,1
702,2022,1,Yanbu Governorate Office,صُنع المنتجات الغذائية,83,19,7,0,109
703,2022,1,Yanbu Governorate Office,صُنع المنسوجات,10,1,1,0,12
704,2022,1,Yanbu Governorate Office,صُنع المواد الكيميائية والمنتجات الكيميائية,8,12,7,2,29
705,2022,1,Yanbu Governorate Office,صُنع الورق ومنتجات الورق,5,2,1,0,8
706,2022,1,Yanbu Governorate Office,صنع فحم الكوك والمنتجات النفطية المكررة,1,1,3,0,5
707,2022,1,Yanbu Governorate Office,صُنع منتجات التبغ,1,0,0,0,1
708,2022,1,Yanbu Governorate Office,صنع منتجات المطاط واللدائن,7,6,1,1,15
709,2022,1,Yanbu Governorate Office,صنع منتجات المعادن اللافلزية الأخرى,30,16,15,4,65
710,2022,1,Yanbu Governorate Office,صنع منتجات المعادن المشكلة ( باستثناء الآلات والمعدات ),63,13,3,0,79
711,2022,1,Yanbu Governorate Office,صيد الأسماك وتربية المائيات,36,17,0,0,53
712,2022,1,Yanbu Governorate Office,وكالات السفر ومشغّلو الجولات السياحية وخدمات الحجز والأنشطة المتصلة بها,6,1,0,0,7
713,2022,1,Makkah Al-Mukarramah Office,أبحاث الإعلان والسوق,50,1,0,0,51
714,2022,1,Makkah Al-Mukarramah Office,إصلاح أجهزة الحاسوب والسلع الشخصية والمنزلية,270,37,0,0,307
715,2022,1,Makkah Al-Mukarramah Office,إصلاح وتركيب الآلات والمعدات,151,9,0,0,160
716,2022,1,Makkah Al-Mukarramah Office,أنشطة أنتاج الأفلام والبرامج التلفزيونية والتسجيلات الصوتية و نشرالموسيقى,19,4,0,0,23
717,2022,1,Makkah Al-Mukarramah Office,أنشطة الأمن والتحقيقات,17,5,4,2,28
718,2022,1,Makkah Al-Mukarramah Office,أنشطة الاستخدام,34,3,0,1,38
719,2022,1,Makkah Al-Mukarramah Office,أنشطة الاسر المعيشية التي تستخدم أفراداً للعمل المنزلي,3,0,0,0,3
720,2022,1,Makkah Al-Mukarramah Office,أنشطة البرمجة الحاسوبية والخبرة الاستشارية وما يتصل بها من أنشطة,38,10,0,0,48
721,2022,1,Makkah Al-Mukarramah Office,أنشطة البرمجة والإذاعة,1,0,0,0,1
722,2022,1,Makkah Al-Mukarramah Office,أنشطة البريد ونقل الرسائل والطرود بواسطة مندوبين,6,1,0,0,7
723,2022,1,Makkah Al-Mukarramah Office,أنشطة التشييد المتخصصة,2329,538,34,2,2903
724,2022,1,Makkah Al-Mukarramah Office,أنشطة الخدمات الشخصية الأخرى,1873,261,9,0,2143
725,2022,1,Makkah Al-Mukarramah Office,أنشطة الخدمات المالية ، فيما عدا تمويل التأمين وصناديق المعاشات,61,12,0,0,73
726,2022,1,Makkah Al-Mukarramah Office,أنشطة العمل الاجتماعي، دون إقامة، لكبار السن وذوي الإعاقة,205,109,9,2,325
727,2022,1,Makkah Al-Mukarramah Office,أنشطة المعالجة وخدمات إدارة النفايات الأخرى,1,0,0,0,1
728,2022,1,Makkah Al-Mukarramah Office,أنشطة المعمارية والهندسية ، والاختبارات الفنية والتحليل,245,166,5,2,418
729,2022,1,Makkah Al-Mukarramah Office,أنشطة المكاتب الرئيسية ، وألأنشطة الاستشارية في مجال الإدارة,63,11,0,0,74
730,2022,1,Makkah Al-Mukarramah Office,أنشطة المكتبات ودور المحفوظات، والمتاحف والأنشطة الثقافية الأخرى,57,13,1,0,71
731,2022,1,Makkah Al-Mukarramah Office,أنشطة المنظمات الدولية,1,0,0,0,1
732,2022,1,Makkah Al-Mukarramah Office,أنشطة المنظمات ذات العضوية,40,7,0,0,47
733,2022,1,Makkah Al-Mukarramah Office,أنشطة النشر,20,1,0,0,21
734,2022,1,Makkah Al-Mukarramah Office,أنشطة تقديم الخدمات للمباني وتجميل المواقع,775,202,24,2,1003
735,2022,1,Makkah Al-Mukarramah Office,أنشطة جمع النفايات ومعالجتها وتصريفها ، واسترجاع المواد,1,0,0,0,1
736,2022,1,Makkah Al-Mukarramah Office,أنشطة خدمات الأطعمة والمشروبات,3922,958,71,4,4955
737,2022,1,Makkah Al-Mukarramah Office,أنشطة خدمات المعلومات,24,1,0,0,25
738,2022,1,Makkah Al-Mukarramah Office,أنشطة خدمات دعم التعدين,9,6,1,0,16
739,2022,1,Makkah Al-Mukarramah Office,أنشطة زراعة المحاصيل والإنتاج الحيواني والصيد والخدمات المتصلة,454,32,1,1,488
740,2022,1,Makkah Al-Mukarramah Office,الإدارة العامة والدفاع ؛ والضمان الاجتماعي الإلزامي,64,43,3,0,110
741,2022,1,Makkah Al-Mukarramah Office,الإقامة,333,157,40,8,538
742,2022,1,Makkah Al-Mukarramah Office,الأنشطة الإبداعية والفنون وأنشطة الترفيه,8,0,0,0,8
743,2022,1,Makkah Al-Mukarramah Office,الأنشطة الأخرى للتعدين واستغلال المحاجر,8,2,0,0,10
744,2022,1,Makkah Al-Mukarramah Office,الأنشطة الإدارية للمكاتب ، وأنشطة الدعم للمكاتب وغير ذلك من أنشطة الدعم للأعمال,142,9,0,0,151
745,2022,1,Makkah Al-Mukarramah Office,الأنشطة الإيجارية,874,38,1,1,914
746,2022,1,Makkah Al-Mukarramah Office,الأنشطة البيطرية,11,5,0,0,16
747,2022,1,Makkah Al-Mukarramah Office,الأنشطة الرياضية وأنشطة التسلية والترفيه,67,26,0,0,93
748,2022,1,Makkah Al-Mukarramah Office,الأنشطة العقارية,191,29,4,0,224
749,2022,1,Makkah Al-Mukarramah Office,الأنشطة القانونية وأنشطة المحاسبة,40,3,0,0,43
750,2022,1,Makkah Al-Mukarramah Office,الأنشطة المساعدة لأنشطة الخدمات المالية وأنشطة التأمين,11,11,1,0,23
751,2022,1,Makkah Al-Mukarramah Office,الأنشطة المهنية والعلمية والتقنية الأخرى,57,12,0,0,69
752,2022,1,Makkah Al-Mukarramah Office,الاتصالات,44,2,0,0,46
753,2022,1,Makkah Al-Mukarramah Office,البحث والتطوير في المجال العلمي,1,0,0,0,1
754,2022,1,Makkah Al-Mukarramah Office,التخزين وأنشطة الدعم للنقل,84,11,1,0,96
755,2022,1,Makkah Al-Mukarramah Office,التعليم,62,47,21,2,132
756,2022,1,Makkah Al-Mukarramah Office,الحراجة وقطع الأخشاب,1,1,0,0,2
757,2022,1,Makkah Al-Mukarramah Office,الرعاية مع الإقامة,13,5,1,0,19
758,2022,1,Makkah Al-Mukarramah Office,الصحة البشرية,76,117,33,3,229
759,2022,1,Makkah Al-Mukarramah Office,الصرف الصحي,6,0,1,0,7
760,2022,1,Makkah Al-Mukarramah Office,الصناعة التحويلية الأخرى,35,13,2,0,50
761,2022,1,Makkah Al-Mukarramah Office,الطباعة واستنساخ وسائط الأعلام المسجّلة,62,21,3,0,86
762,2022,1,Makkah Al-Mukarramah Office,النقل البري و النقل عبر الأنابيب,925,135,10,2,1072
763,2022,1,Makkah Al-Mukarramah Office,النقل الجوي,20,4,1,0,25
764,2022,1,Makkah Al-Mukarramah Office,النقل المائي,19,1,0,0,20
765,2022,1,Makkah Al-Mukarramah Office,الهندسة المدنية,44,8,0,1,53
766,2022,1,Makkah Al-Mukarramah Office,تجارة التجزئة، باستثناء المركبات ذات المحركات والدراجات النارية,5130,1098,60,4,6292
767,2022,1,Makkah Al-Mukarramah Office,تجارة الجملة ، باستثناء المركبات ذات المحركات والدراجات النارية,1635,445,32,3,2115
768,2022,1,Makkah Al-Mukarramah Office,تجارة الجملة والتجزئة ، وإصلاح المركبات ذات المحركات والدراجات النارية,1919,310,8,0,2237
769,2022,1,Makkah Al-Mukarramah Office,تجميع المياه ومعالجتها وتوصيلها,59,24,0,1,84
770,2022,1,Makkah Al-Mukarramah Office,تشييد المباني,5079,1706,157,13,6955
771,2022,1,Makkah Al-Mukarramah Office,تعدين ركازات الفلزات,23,4,0,0,27
772,2022,1,Makkah Al-Mukarramah Office,تمويل التأمين وإعادة التأمين وصناديق المعاشات التقاعدية باستثناء الضمان الاجتماعي الإلزامي,4,2,0,0,6
773,2022,1,Makkah Al-Mukarramah Office,توصيل الكهرباء والغاز والبخار وتكييف الهواء,8,9,3,0,20
774,2022,1,Makkah Al-Mukarramah Office,صناعة الآلات والمعدات غير المصنفة في موضع أخر,30,1,0,0,31
775,2022,1,Makkah Al-Mukarramah Office,صناعة المركبات ذات المحركات والمركبات المقطورة ونصف المقطورة,43,5,1,0,49
776,2022,1,Makkah Al-Mukarramah Office,صناعة معدات النقل الأخرى,14,0,0,1,15
777,2022,1,Makkah Al-Mukarramah Office,صنع الأثاث,132,37,0,0,169
778,2022,1,Makkah Al-Mukarramah Office,صنع الحواسيب والمنتجات الإلكترونية والبصرية,67,17,0,0,84
779,2022,1,Makkah Al-Mukarramah Office,صُنع الخشب ومنتجات الخشب والفلين ، باستثناء الأثاث ، صُنع أصناف من القش ومواد الضفر,198,40,3,0,241
780,2022,1,Makkah Al-Mukarramah Office,صنع الفلزات القاعدية,64,23,2,0,89
781,2022,1,Makkah Al-Mukarramah Office,صُنع المشروبات,19,7,3,0,29
782,2022,1,Makkah Al-Mukarramah Office,صنع المعدات الكهربائية,90,16,1,0,107
783,2022,1,Makkah Al-Mukarramah Office,صُنع الملبوسات,678,90,0,0,768
784,2022,1,Makkah Al-Mukarramah Office,صُنع المنتجات الجلدية والمنتجات ذات الصلة,15,3,0,0,18
785,2022,1,Makkah Al-Mukarramah Office,صنع المنتجات الصيدلانية الأساسية والمستحضرات الصيدلانية,3,1,0,0,4
786,2022,1,Makkah Al-Mukarramah Office,صُنع المنتجات الغذائية,519,152,18,2,691
787,2022,1,Makkah Al-Mukarramah Office,صُنع المنسوجات,113,28,0,0,141
788,2022,1,Makkah Al-Mukarramah Office,صُنع المواد الكيميائية والمنتجات الكيميائية,72,26,1,0,99
789,2022,1,Makkah Al-Mukarramah Office,صُنع الورق ومنتجات الورق,4,4,0,0,8
790,2022,1,Makkah Al-Mukarramah Office,صُنع منتجات التبغ,3,0,0,0,3
791,2022,1,Makkah Al-Mukarramah Office,صنع منتجات المطاط واللدائن,14,10,2,1,27
792,2022,1,Makkah Al-Mukarramah Office,صنع منتجات المعادن اللافلزية الأخرى,95,32,9,0,136
793,2022,1,Makkah Al-Mukarramah Office,صنع منتجات المعادن المشكلة ( باستثناء الآلات والمعدات ),442,89,10,0,541
794,2022,1,Makkah Al-Mukarramah Office,صيد الأسماك وتربية المائيات,58,15,1,0,74
795,2022,1,Makkah Al-Mukarramah Office,وكالات السفر ومشغّلو الجولات السياحية وخدمات الحجز والأنشطة المتصلة بها,105,41,4,0,150
796,2022,1,Al-Baha District Office,أبحاث الإعلان والسوق,3,2,0,0,5
797,2022,1,Al-Baha District Office,إصلاح أجهزة الحاسوب والسلع الشخصية والمنزلية,37,3,0,0,40
798,2022,1,Al-Baha District Office,إصلاح وتركيب الآلات والمعدات,11,4,0,0,15
799,2022,1,Al-Baha District Office,أنشطة أنتاج الأفلام والبرامج التلفزيونية والتسجيلات الصوتية و نشرالموسيقى,2,0,0,0,2
800,2022,1,Al-Baha District Office,أنشطة الأمن والتحقيقات,1,0,0,0,1
801,2022,1,Al-Baha District Office,أنشطة الاستخدام,6,1,0,0,7
802,2022,1,Al-Baha District Office,أنشطة البرمجة الحاسوبية والخبرة الاستشارية وما يتصل بها من أنشطة,1,0,0,0,1
803,2022,1,Al-Baha District Office,أنشطة التشييد المتخصصة,450,71,0,1,522
804,2022,1,Al-Baha District Office,أنشطة الخدمات الشخصية الأخرى,256,21,0,0,277
805,2022,1,Al-Baha District Office,أنشطة الخدمات المالية ، فيما عدا تمويل التأمين وصناديق المعاشات,8,0,0,0,8
806,2022,1,Al-Baha District Office,أنشطة العمل الاجتماعي، دون إقامة، لكبار السن وذوي الإعاقة,27,14,0,0,41
807,2022,1,Al-Baha District Office,أنشطة المعمارية والهندسية ، والاختبارات الفنية والتحليل,82,38,5,0,125
808,2022,1,Al-Baha District Office,أنشطة المكاتب الرئيسية ، وألأنشطة الاستشارية في مجال الإدارة,5,1,0,0,6
809,2022,1,Al-Baha District Office,أنشطة المكتبات ودور المحفوظات، والمتاحف والأنشطة الثقافية الأخرى,7,2,0,0,9
810,2022,1,Al-Baha District Office,أنشطة المنظمات الدولية,0,1,0,0,1
811,2022,1,Al-Baha District Office,أنشطة المنظمات ذات العضوية,11,6,0,0,17
812,2022,1,Al-Baha District Office,أنشطة النشر,6,1,0,0,7
813,2022,1,Al-Baha District Office,أنشطة تقديم الخدمات للمباني وتجميل المواقع,53,6,1,0,60
814,2022,1,Al-Baha District Office,أنشطة جمع النفايات ومعالجتها وتصريفها ، واسترجاع المواد,1,0,0,0,1
815,2022,1,Al-Baha District Office,أنشطة خدمات الأطعمة والمشروبات,555,159,7,0,721
816,2022,1,Al-Baha District Office,أنشطة خدمات المعلومات,2,0,0,0,2
817,2022,1,Al-Baha District Office,أنشطة خدمات دعم التعدين,7,0,0,0,7
818,2022,1,Al-Baha District Office,أنشطة زراعة المحاصيل والإنتاج الحيواني والصيد والخدمات المتصلة,202,5,0,0,207
819,2022,1,Al-Baha District Office,الإدارة العامة والدفاع ؛ والضمان الاجتماعي الإلزامي,5,10,1,0,16
820,2022,1,Al-Baha District Office,الإقامة,41,21,1,0,63
821,2022,1,Al-Baha District Office,الأنشطة الإبداعية والفنون وأنشطة الترفيه,1,0,0,0,1
822,2022,1,Al-Baha District Office,الأنشطة الأخرى للتعدين واستغلال المحاجر,1,3,0,0,4
823,2022,1,Al-Baha District Office,الأنشطة الإدارية للمكاتب ، وأنشطة الدعم للمكاتب وغير ذلك من أنشطة الدعم للأعمال,19,0,0,0,19
824,2022,1,Al-Baha District Office,الأنشطة الإيجارية,136,2,0,0,138
825,2022,1,Al-Baha District Office,الأنشطة البيطرية,1,0,0,0,1
826,2022,1,Al-Baha District Office,الأنشطة الرياضية وأنشطة التسلية والترفيه,24,1,0,0,25
827,2022,1,Al-Baha District Office,الأنشطة العقارية,9,1,0,0,10
828,2022,1,Al-Baha District Office,الأنشطة القانونية وأنشطة المحاسبة,5,0,0,0,5
829,2022,1,Al-Baha District Office,الأنشطة المهنية والعلمية والتقنية الأخرى,6,1,0,0,7
830,2022,1,Al-Baha District Office,الاتصالات,9,1,0,0,10
831,2022,1,Al-Baha District Office,التخزين وأنشطة الدعم للنقل,27,3,0,0,30
832,2022,1,Al-Baha District Office,التعليم,11,7,0,0,18
833,2022,1,Al-Baha District Office,الرعاية مع الإقامة,2,5,0,0,7
834,2022,1,Al-Baha District Office,الصحة البشرية,12,21,1,0,34
835,2022,1,Al-Baha District Office,الصرف الصحي,1,0,0,0,1
836,2022,1,Al-Baha District Office,الصناعة التحويلية الأخرى,6,0,0,0,6
837,2022,1,Al-Baha District Office,الطباعة واستنساخ وسائط الأعلام المسجّلة,12,5,0,0,17
838,2022,1,Al-Baha District Office,النقل البري و النقل عبر الأنابيب,142,20,0,0,162
839,2022,1,Al-Baha District Office,النقل الجوي,0,2,0,0,2
840,2022,1,Al-Baha District Office,الهندسة المدنية,7,3,0,0,10
841,2022,1,Al-Baha District Office,تجارة التجزئة، باستثناء المركبات ذات المحركات والدراجات النارية,944,228,12,1,1185
842,2022,1,Al-Baha District Office,تجارة الجملة ، باستثناء المركبات ذات المحركات والدراجات النارية,362,200,6,0,568
843,2022,1,Al-Baha District Office,تجارة الجملة والتجزئة ، وإصلاح المركبات ذات المحركات والدراجات النارية,352,50,1,0,403
844,2022,1,Al-Baha District Office,تجميع المياه ومعالجتها وتوصيلها,16,3,0,0,19
845,2022,1,Al-Baha District Office,تشييد المباني,671,152,12,1,836
846,2022,1,Al-Baha District Office,تعدين ركازات الفلزات,11,3,0,0,14
847,2022,1,Al-Baha District Office,توصيل الكهرباء والغاز والبخار وتكييف الهواء,1,1,0,0,2
848,2022,1,Al-Baha District Office,صناعة الآلات والمعدات غير المصنفة في موضع أخر,4,0,0,0,4
849,2022,1,Al-Baha District Office,صناعة المركبات ذات المحركات والمركبات المقطورة ونصف المقطورة,4,0,0,0,4
850,2022,1,Al-Baha District Office,صناعة معدات النقل الأخرى,4,0,0,0,4
851,2022,1,Al-Baha District Office,صنع الأثاث,41,9,0,0,50
852,2022,1,Al-Baha District Office,صنع الحواسيب والمنتجات الإلكترونية والبصرية,16,5,0,0,21
853,2022,1,Al-Baha District Office,صُنع الخشب ومنتجات الخشب والفلين ، باستثناء الأثاث ، صُنع أصناف من القش ومواد الضفر,48,12,0,0,60
854,2022,1,Al-Baha District Office,صنع الفلزات القاعدية,21,3,0,0,24
855,2022,1,Al-Baha District Office,صُنع المشروبات,3,2,0,0,5
856,2022,1,Al-Baha District Office,صنع المعدات الكهربائية,15,2,0,0,17
857,2022,1,Al-Baha District Office,صُنع الملبوسات,107,15,0,0,122
858,2022,1,Al-Baha District Office,صُنع المنتجات الجلدية والمنتجات ذات الصلة,1,0,0,0,1
859,2022,1,Al-Baha District Office,صنع المنتجات الصيدلانية الأساسية والمستحضرات الصيدلانية,2,0,0,0,2
860,2022,1,Al-Baha District Office,صُنع المنتجات الغذائية,92,15,0,0,107
861,2022,1,Al-Baha District Office,صُنع المنسوجات,8,2,0,0,10
862,2022,1,Al-Baha District Office,صُنع المواد الكيميائية والمنتجات الكيميائية,6,1,0,0,7
863,2022,1,Al-Baha District Office,صُنع الورق ومنتجات الورق,2,0,0,0,2
864,2022,1,Al-Baha District Office,صنع منتجات المطاط واللدائن,4,1,0,0,5
865,2022,1,Al-Baha District Office,صنع منتجات المعادن اللافلزية الأخرى,40,15,4,0,59
866,2022,1,Al-Baha District Office,صنع منتجات المعادن المشكلة ( باستثناء الآلات والمعدات ),112,17,0,0,129
867,2022,1,Al-Baha District Office,صيد الأسماك وتربية المائيات,1,0,0,0,1
868,2022,1,Al-Baha District Office,وكالات السفر ومشغّلو الجولات السياحية وخدمات الحجز والأنشطة المتصلة بها,2,0,0,0,2
869,2022,1,Al-Jouf Region Office,أبحاث الإعلان والسوق,33,4,0,0,37
870,2022,1,Al-Jouf Region Office,إصلاح أجهزة الحاسوب والسلع الشخصية والمنزلية,78,9,1,0,88
871,2022,1,Al-Jouf Region Office,إصلاح وتركيب الآلات والمعدات,20,3,0,0,23
872,2022,1,Al-Jouf Region Office,أنشطة أنتاج الأفلام والبرامج التلفزيونية والتسجيلات الصوتية و نشرالموسيقى,3,0,0,0,3
873,2022,1,Al-Jouf Region Office,أنشطة الأمن والتحقيقات,2,2,0,0,4
874,2022,1,Al-Jouf Region Office,أنشطة الاستخدام,13,1,0,0,14
875,2022,1,Al-Jouf Region Office,أنشطة الاسر المعيشية التي تستخدم أفراداً للعمل المنزلي,0,1,0,0,1
876,2022,1,Al-Jouf Region Office,أنشطة البرمجة الحاسوبية والخبرة الاستشارية وما يتصل بها من أنشطة,10,3,0,0,13
877,2022,1,Al-Jouf Region Office,أنشطة البرمجة والإذاعة,1,0,0,0,1
878,2022,1,Al-Jouf Region Office,أنشطة البريد ونقل الرسائل والطرود بواسطة مندوبين,1,0,0,0,1
879,2022,1,Al-Jouf Region Office,أنشطة التشييد المتخصصة,676,180,8,0,864
880,2022,1,Al-Jouf Region Office,أنشطة الخدمات الشخصية الأخرى,474,57,1,0,532
881,2022,1,Al-Jouf Region Office,أنشطة الخدمات المالية ، فيما عدا تمويل التأمين وصناديق المعاشات,13,1,0,0,14
882,2022,1,Al-Jouf Region Office,أنشطة العمل الاجتماعي، دون إقامة، لكبار السن وذوي الإعاقة,16,15,1,0,32
883,2022,1,Al-Jouf Region Office,أنشطة المعمارية والهندسية ، والاختبارات الفنية والتحليل,103,35,2,0,140
884,2022,1,Al-Jouf Region Office,أنشطة المكاتب الرئيسية ، وألأنشطة الاستشارية في مجال الإدارة,10,1,0,0,11
885,2022,1,Al-Jouf Region Office,أنشطة المكتبات ودور المحفوظات، والمتاحف والأنشطة الثقافية الأخرى,11,5,0,0,16
886,2022,1,Al-Jouf Region Office,أنشطة المنظمات ذات العضوية,14,5,0,0,19
887,2022,1,Al-Jouf Region Office,أنشطة النشر,5,1,0,0,6
888,2022,1,Al-Jouf Region Office,أنشطة تقديم الخدمات للمباني وتجميل المواقع,299,87,8,1,395
889,2022,1,Al-Jouf Region Office,أنشطة جمع النفايات ومعالجتها وتصريفها ، واسترجاع المواد,1,1,0,0,2
890,2022,1,Al-Jouf Region Office,أنشطة خدمات الأطعمة والمشروبات,842,194,6,0,1042
891,2022,1,Al-Jouf Region Office,أنشطة خدمات المعلومات,5,2,0,0,7
892,2022,1,Al-Jouf Region Office,أنشطة خدمات دعم التعدين,5,1,0,0,6
893,2022,1,Al-Jouf Region Office,أنشطة زراعة المحاصيل والإنتاج الحيواني والصيد والخدمات المتصلة,429,26,0,2,457
894,2022,1,Al-Jouf Region Office,الإدارة العامة والدفاع ؛ والضمان الاجتماعي الإلزامي,14,6,0,0,20
895,2022,1,Al-Jouf Region Office,الإقامة,54,11,1,0,66
896,2022,1,Al-Jouf Region Office,الأنشطة الإبداعية والفنون وأنشطة الترفيه,2,0,0,0,2
897,2022,1,Al-Jouf Region Office,الأنشطة الأخرى للتعدين واستغلال المحاجر,6,0,0,0,6
898,2022,1,Al-Jouf Region Office,الأنشطة الإدارية للمكاتب ، وأنشطة الدعم للمكاتب وغير ذلك من أنشطة الدعم للأعمال,24,1,0,0,25
899,2022,1,Al-Jouf Region Office,الأنشطة الإيجارية,547,23,0,0,570
900,2022,1,Al-Jouf Region Office,الأنشطة البيطرية,3,3,0,0,6
901,2022,1,Al-Jouf Region Office,الأنشطة الرياضية وأنشطة التسلية والترفيه,38,5,0,0,43
902,2022,1,Al-Jouf Region Office,الأنشطة العقارية,26,2,1,0,29
903,2022,1,Al-Jouf Region Office,الأنشطة القانونية وأنشطة المحاسبة,8,1,0,0,9
904,2022,1,Al-Jouf Region Office,الأنشطة المهنية والعلمية والتقنية الأخرى,12,2,0,0,14
905,2022,1,Al-Jouf Region Office,الاتصالات,23,1,0,0,24
906,2022,1,Al-Jouf Region Office,التخزين وأنشطة الدعم للنقل,110,15,3,0,128
907,2022,1,Al-Jouf Region Office,التعليم,18,27,10,0,55
908,2022,1,Al-Jouf Region Office,الحراجة وقطع الأخشاب,1,0,0,0,1
909,2022,1,Al-Jouf Region Office,الرعاية مع الإقامة,6,2,0,0,8
910,2022,1,Al-Jouf Region Office,الصحة البشرية,18,29,7,0,54
911,2022,1,Al-Jouf Region Office,الصرف الصحي,3,1,0,0,4
912,2022,1,Al-Jouf Region Office,الصناعة التحويلية الأخرى,6,0,0,0,6
913,2022,1,Al-Jouf Region Office,الطباعة واستنساخ وسائط الأعلام المسجّلة,14,4,0,0,18
914,2022,1,Al-Jouf Region Office,النقل البري و النقل عبر الأنابيب,435,65,0,0,500
915,2022,1,Al-Jouf Region Office,النقل الجوي,14,0,0,0,14
916,2022,1,Al-Jouf Region Office,الهندسة المدنية,12,4,0,0,16
917,2022,1,Al-Jouf Region Office,تجارة التجزئة، باستثناء المركبات ذات المحركات والدراجات النارية,1131,222,8,1,1362
918,2022,1,Al-Jouf Region Office,تجارة الجملة ، باستثناء المركبات ذات المحركات والدراجات النارية,363,85,3,1,452
919,2022,1,Al-Jouf Region Office,تجارة الجملة والتجزئة ، وإصلاح المركبات ذات المحركات والدراجات النارية,508,107,1,0,616
920,2022,1,Al-Jouf Region Office,تجميع المياه ومعالجتها وتوصيلها,8,1,0,0,9
921,2022,1,Al-Jouf Region Office,تشييد المباني,857,187,17,1,1062
922,2022,1,Al-Jouf Region Office,تعدين الفحم والليغنيت,1,1,0,0,2
923,2022,1,Al-Jouf Region Office,تعدين ركازات الفلزات,6,1,0,0,7
924,2022,1,Al-Jouf Region Office,توصيل الكهرباء والغاز والبخار وتكييف الهواء,7,1,0,0,8
925,2022,1,Al-Jouf Region Office,صناعة الآلات والمعدات غير المصنفة في موضع أخر,15,0,0,0,15
926,2022,1,Al-Jouf Region Office,صناعة المركبات ذات المحركات والمركبات المقطورة ونصف المقطورة,14,3,0,0,17
927,2022,1,Al-Jouf Region Office,صناعة معدات النقل الأخرى,2,3,0,0,5
928,2022,1,Al-Jouf Region Office,صنع الأثاث,87,12,0,0,99
929,2022,1,Al-Jouf Region Office,صنع الحواسيب والمنتجات الإلكترونية والبصرية,12,1,0,0,13
930,2022,1,Al-Jouf Region Office,صُنع الخشب ومنتجات الخشب والفلين ، باستثناء الأثاث ، صُنع أصناف من القش ومواد الضفر,45,3,0,0,48
931,2022,1,Al-Jouf Region Office,صنع الفلزات القاعدية,36,9,0,0,45
932,2022,1,Al-Jouf Region Office,صُنع المشروبات,6,4,1,1,12
933,2022,1,Al-Jouf Region Office,صنع المعدات الكهربائية,26,3,0,0,29
934,2022,1,Al-Jouf Region Office,صُنع الملبوسات,206,22,0,0,228
935,2022,1,Al-Jouf Region Office,صُنع المنتجات الجلدية والمنتجات ذات الصلة,2,0,0,0,2
936,2022,1,Al-Jouf Region Office,صنع المنتجات الصيدلانية الأساسية والمستحضرات الصيدلانية,2,1,0,0,3
937,2022,1,Al-Jouf Region Office,صُنع المنتجات الغذائية,144,48,1,0,193
938,2022,1,Al-Jouf Region Office,صُنع المنسوجات,27,9,0,0,36
939,2022,1,Al-Jouf Region Office,صُنع المواد الكيميائية والمنتجات الكيميائية,24,2,0,0,26
940,2022,1,Al-Jouf Region Office,صُنع الورق ومنتجات الورق,5,1,0,0,6
941,2022,1,Al-Jouf Region Office,صنع منتجات المطاط واللدائن,4,4,0,0,8
942,2022,1,Al-Jouf Region Office,صنع منتجات المعادن اللافلزية الأخرى,45,21,2,0,68
943,2022,1,Al-Jouf Region Office,صنع منتجات المعادن المشكلة ( باستثناء الآلات والمعدات ),108,18,1,0,127
944,2022,1,Al-Jouf Region Office,صيد الأسماك وتربية المائيات,0,1,0,0,1
945,2022,1,Al-Jouf Region Office,وكالات السفر ومشغّلو الجولات السياحية وخدمات الحجز والأنشطة المتصلة بها,6,3,0,0,9
946,2022,1,Northern Border Region Office,أبحاث الإعلان والسوق,4,0,0,0,4
947,2022,1,Northern Border Region Office,إصلاح أجهزة الحاسوب والسلع الشخصية والمنزلية,41,4,0,0,45
948,2022,1,Northern Border Region Office,إصلاح وتركيب الآلات والمعدات,15,0,0,0,15
949,2022,1,Northern Border Region Office,أنشطة أنتاج الأفلام والبرامج التلفزيونية والتسجيلات الصوتية و نشرالموسيقى,1,0,0,0,1
950,2022,1,Northern Border Region Office,أنشطة الأمن والتحقيقات,0,2,1,1,4
951,2022,1,Northern Border Region Office,أنشطة الاستخدام,8,1,0,0,9
952,2022,1,Northern Border Region Office,أنشطة الاسر المعيشية التي تستخدم أفراداً للعمل المنزلي,1,0,0,0,1
953,2022,1,Northern Border Region Office,أنشطة البرمجة الحاسوبية والخبرة الاستشارية وما يتصل بها من أنشطة,5,0,0,0,5
954,2022,1,Northern Border Region Office,أنشطة البريد ونقل الرسائل والطرود بواسطة مندوبين,0,1,0,0,1
955,2022,1,Northern Border Region Office,أنشطة التشييد المتخصصة,317,47,2,0,366
956,2022,1,Northern Border Region Office,أنشطة الخدمات الشخصية الأخرى,399,29,0,0,428
957,2022,1,Northern Border Region Office,أنشطة الخدمات المالية ، فيما عدا تمويل التأمين وصناديق المعاشات,9,3,0,0,12
958,2022,1,Northern Border Region Office,أنشطة العمل الاجتماعي، دون إقامة، لكبار السن وذوي الإعاقة,13,10,0,0,23
959,2022,1,Northern Border Region Office,أنشطة المعمارية والهندسية ، والاختبارات الفنية والتحليل,109,31,1,0,141
960,2022,1,Northern Border Region Office,أنشطة المكاتب الرئيسية ، وألأنشطة الاستشارية في مجال الإدارة,8,2,0,0,10
961,2022,1,Northern Border Region Office,أنشطة المكتبات ودور المحفوظات، والمتاحف والأنشطة الثقافية الأخرى,11,3,0,0,14
962,2022,1,Northern Border Region Office,أنشطة المنظمات ذات العضوية,9,1,0,0,10
963,2022,1,Northern Border Region Office,أنشطة تقديم الخدمات للمباني وتجميل المواقع,109,17,0,0,126
964,2022,1,Northern Border Region Office,أنشطة خدمات الأطعمة والمشروبات,784,138,3,0,925
965,2022,1,Northern Border Region Office,أنشطة خدمات المعلومات,1,2,0,0,3
966,2022,1,Northern Border Region Office,أنشطة خدمات دعم التعدين,1,1,0,0,2
967,2022,1,Northern Border Region Office,أنشطة زراعة المحاصيل والإنتاج الحيواني والصيد والخدمات المتصلة,107,4,0,0,111
968,2022,1,Northern Border Region Office,الإدارة العامة والدفاع ؛ والضمان الاجتماعي الإلزامي,5,1,0,0,6
969,2022,1,Northern Border Region Office,الإقامة,21,11,1,0,33
970,2022,1,Northern Border Region Office,الأنشطة الإبداعية والفنون وأنشطة الترفيه,3,0,0,0,3
971,2022,1,Northern Border Region Office,الأنشطة الأخرى للتعدين واستغلال المحاجر,3,1,0,1,5
972,2022,1,Northern Border Region Office,الأنشطة الإدارية للمكاتب ، وأنشطة الدعم للمكاتب وغير ذلك من أنشطة الدعم للأعمال,31,0,0,0,31
973,2022,1,Northern Border Region Office,الأنشطة الإيجارية,205,6,0,0,211
974,2022,1,Northern Border Region Office,الأنشطة البيطرية,6,1,0,0,7
975,2022,1,Northern Border Region Office,الأنشطة الرياضية وأنشطة التسلية والترفيه,28,7,0,0,35
976,2022,1,Northern Border Region Office,الأنشطة العقارية,26,3,0,0,29
977,2022,1,Northern Border Region Office,الأنشطة القانونية وأنشطة المحاسبة,5,0,0,0,5
978,2022,1,Northern Border Region Office,الأنشطة المهنية والعلمية والتقنية الأخرى,5,1,0,0,6
979,2022,1,Northern Border Region Office,الاتصالات,6,1,0,0,7
980,2022,1,Northern Border Region Office,التخزين وأنشطة الدعم للنقل,24,5,1,0,30
981,2022,1,Northern Border Region Office,التعليم,13,20,4,0,37
982,2022,1,Northern Border Region Office,الرعاية مع الإقامة,3,1,0,0,4
983,2022,1,Northern Border Region Office,الصحة البشرية,17,23,2,0,42
984,2022,1,Northern Border Region Office,الصناعة التحويلية الأخرى,4,1,0,0,5
985,2022,1,Northern Border Region Office,الطباعة واستنساخ وسائط الأعلام المسجّلة,10,2,0,0,12
986,2022,1,Northern Border Region Office,النقل البري و النقل عبر الأنابيب,311,38,0,0,349
987,2022,1,Northern Border Region Office,النقل الجوي,1,2,0,1,4
988,2022,1,Northern Border Region Office,النقل المائي,3,0,0,0,3
989,2022,1,Northern Border Region Office,الهندسة المدنية,8,0,0,0,8
990,2022,1,Northern Border Region Office,تجارة التجزئة، باستثناء المركبات ذات المحركات والدراجات النارية,804,109,10,0,923
991,2022,1,Northern Border Region Office,تجارة الجملة ، باستثناء المركبات ذات المحركات والدراجات النارية,215,32,1,0,248
992,2022,1,Northern Border Region Office,تجارة الجملة والتجزئة ، وإصلاح المركبات ذات المحركات والدراجات النارية,424,62,1,0,487
993,2022,1,Northern Border Region Office,تجميع المياه ومعالجتها وتوصيلها,8,4,0,0,12
994,2022,1,Northern Border Region Office,تشييد المباني,1194,224,21,4,1443
995,2022,1,Northern Border Region Office,تعدين ركازات الفلزات,8,0,0,0,8
996,2022,1,Northern Border Region Office,توصيل الكهرباء والغاز والبخار وتكييف الهواء,3,1,0,0,4
997,2022,1,Northern Border Region Office,صناعة الآلات والمعدات غير المصنفة في موضع أخر,7,0,0,0,7
998,2022,1,Northern Border Region Office,صناعة المركبات ذات المحركات والمركبات المقطورة ونصف المقطورة,11,1,0,0,12
999,2022,1,Northern Border Region Office,صناعة معدات النقل الأخرى,3,1,0,0,4
1000,2022,1,Northern Border Region Office,صنع الأثاث,45,8,0,0,53
1001,2022,1,Northern Border Region Office,صنع الحواسيب والمنتجات الإلكترونية والبصرية,13,4,0,0,17
1002,2022,1,Northern Border Region Office,صُنع الخشب ومنتجات الخشب والفلين ، باستثناء الأثاث ، صُنع أصناف من القش ومواد الضفر,38,5,0,0,43
1003,2022,1,Northern Border Region Office,صنع الفلزات القاعدية,22,6,0,0,28
1004,2022,1,Northern Border Region Office,صُنع المشروبات,2,3,0,0,5
1005,2022,1,Northern Border Region Office,صنع المعدات الكهربائية,39,5,0,0,44
1006,2022,1,Northern Border Region Office,صُنع الملبوسات,213,12,1,0,226
1007,2022,1,Northern Border Region Office,صُنع المنتجات الجلدية والمنتجات ذات الصلة,5,1,0,0,6
1008,2022,1,Northern Border Region Office,صنع المنتجات الصيدلانية الأساسية والمستحضرات الصيدلانية,0,1,0,0,1
1009,2022,1,Northern Border Region Office,صُنع المنتجات الغذائية,111,30,0,0,141
1010,2022,1,Northern Border Region Office,صُنع المنسوجات,21,1,0,0,22
1011,2022,1,Northern Border Region Office,صُنع المواد الكيميائية والمنتجات الكيميائية,13,1,0,0,14
1012,2022,1,Northern Border Region Office,صُنع الورق ومنتجات الورق,1,1,0,0,2
1013,2022,1,Northern Border Region Office,صنع فحم الكوك والمنتجات النفطية المكررة,1,0,0,0,1
1014,2022,1,Northern Border Region Office,صنع منتجات المطاط واللدائن,1,3,0,0,4
1015,2022,1,Northern Border Region Office,صنع منتجات المعادن اللافلزية الأخرى,35,13,0,1,49
1016,2022,1,Northern Border Region Office,صنع منتجات المعادن المشكلة ( باستثناء الآلات والمعدات ),52,3,0,0,55
1017,2022,1,Northern Border Region Office,وكالات السفر ومشغّلو الجولات السياحية وخدمات الحجز والأنشطة المتصلة بها,1,2,0,0,3
1018,2022,1,Riyadh Region Office,أبحاث الإعلان والسوق,442,110,0,0,552
1019,2022,1,Riyadh Region Office,إصلاح أجهزة الحاسوب والسلع الشخصية والمنزلية,833,188,28,7,1056
1020,2022,1,Riyadh Region Office,إصلاح وتركيب الآلات والمعدات,491,95,9,5,600
1021,2022,1,Riyadh Region Office,أنشطة أنتاج الأفلام والبرامج التلفزيونية والتسجيلات الصوتية و نشرالموسيقى,191,85,4,3,283
1022,2022,1,Riyadh Region Office,أنشطة الأمن والتحقيقات,91,42,19,10,162
1023,2022,1,Riyadh Region Office,أنشطة الاستخدام,412,91,16,24,543
1024,2022,1,Riyadh Region Office,أنشطة الاسر المعيشية التي تستخدم أفراداً للعمل المنزلي,13,1,0,0,14
1025,2022,1,Riyadh Region Office,أنشطة البرمجة الحاسوبية والخبرة الاستشارية وما يتصل بها من أنشطة,806,393,48,9,1256
1026,2022,1,Riyadh Region Office,أنشطة البرمجة والإذاعة,11,1,0,0,12
1027,2022,1,Riyadh Region Office,أنشطة البريد ونقل الرسائل والطرود بواسطة مندوبين,132,26,6,0,164
1028,2022,1,Riyadh Region Office,أنشطة التشييد المتخصصة,9619,3174,323,50,13166
1029,2022,1,Riyadh Region Office,أنشطة الخدمات الشخصية الأخرى,5750,1476,127,37,7390
1030,2022,1,Riyadh Region Office,أنشطة الخدمات المالية ، فيما عدا تمويل التأمين وصناديق المعاشات,253,110,14,12,389
1031,2022,1,Riyadh Region Office,أنشطة العمل الاجتماعي، دون إقامة، لكبار السن وذوي الإعاقة,164,155,25,1,345
1032,2022,1,Riyadh Region Office,أنشطة المعالجة وخدمات إدارة النفايات الأخرى,8,1,1,0,10
1033,2022,1,Riyadh Region Office,أنشطة المعمارية والهندسية ، والاختبارات الفنية والتحليل,658,408,88,20,1174
1034,2022,1,Riyadh Region Office,أنشطة المكاتب الرئيسية ، وألأنشطة الاستشارية في مجال الإدارة,889,319,33,8,1249
1035,2022,1,Riyadh Region Office,أنشطة المكتبات ودور المحفوظات، والمتاحف والأنشطة الثقافية الأخرى,100,43,2,0,145
1036,2022,1,Riyadh Region Office,أنشطة المنظمات الدولية,6,4,1,0,11
1037,2022,1,Riyadh Region Office,أنشطة المنظمات ذات العضوية,177,47,3,0,227
1038,2022,1,Riyadh Region Office,أنشطة النشر,182,66,5,1,254
1039,2022,1,Riyadh Region Office,أنشطة تقديم الخدمات للمباني وتجميل المواقع,5549,3143,580,118,9390
1040,2022,1,Riyadh Region Office,أنشطة جمع النفايات ومعالجتها وتصريفها ، واسترجاع المواد,26,7,4,4,41
1041,2022,1,Riyadh Region Office,أنشطة خدمات الأطعمة والمشروبات,8976,3318,424,76,12794
1042,2022,1,Riyadh Region Office,أنشطة خدمات المعلومات,232,89,9,2,332
1043,2022,1,Riyadh Region Office,أنشطة خدمات دعم التعدين,74,36,8,2,120
1044,2022,1,Riyadh Region Office,أنشطة زراعة المحاصيل والإنتاج الحيواني والصيد والخدمات المتصلة,2529,291,87,15,2922
1045,2022,1,Riyadh Region Office,استخراج النفط الخام والغاز الطبيعي,3,0,0,0,3
1046,2022,1,Riyadh Region Office,الإدارة العامة والدفاع ؛ والضمان الاجتماعي الإلزامي,341,215,46,15,617
1047,2022,1,Riyadh Region Office,الإقامة,560,321,81,9,971
1048,2022,1,Riyadh Region Office,الأنشطة الإبداعية والفنون وأنشطة الترفيه,103,23,4,1,131
1049,2022,1,Riyadh Region Office,الأنشطة الأخرى للتعدين واستغلال المحاجر,110,56,14,3,183
1050,2022,1,Riyadh Region Office,الأنشطة الإدارية للمكاتب ، وأنشطة الدعم للمكاتب وغير ذلك من أنشطة الدعم للأعمال,716,120,14,3,853
1051,2022,1,Riyadh Region Office,الأنشطة الإيجارية,51626,1046,41,3,52716
1052,2022,1,Riyadh Region Office,الأنشطة البيطرية,45,45,4,0,94
1053,2022,1,Riyadh Region Office,الأنشطة الرياضية وأنشطة التسلية والترفيه,469,164,19,5,657
1054,2022,1,Riyadh Region Office,الأنشطة العقارية,1122,452,67,8,1649
1055,2022,1,Riyadh Region Office,الأنشطة القانونية وأنشطة المحاسبة,482,195,11,2,690
1056,2022,1,Riyadh Region Office,الأنشطة المساعدة لأنشطة الخدمات المالية وأنشطة التأمين,77,76,14,2,169
1057,2022,1,Riyadh Region Office,الأنشطة المهنية والعلمية والتقنية الأخرى,352,49,3,0,404
1058,2022,1,Riyadh Region Office,الأنشطة غير المتميزة لإنتاج السلع والخدمات التي تقوم بها الأسر المعيشية الخاصة لإستعمالها الخاص,2,0,0,0,2
1059,2022,1,Riyadh Region Office,الاتصالات,372,164,22,13,571
1060,2022,1,Riyadh Region Office,البحث والتطوير في المجال العلمي,27,9,1,1,38
1061,2022,1,Riyadh Region Office,التخزين وأنشطة الدعم للنقل,827,234,51,17,1129
1062,2022,1,Riyadh Region Office,التعليم,682,402,165,47,1296
1063,2022,1,Riyadh Region Office,الحراجة وقطع الأخشاب,5,5,2,0,12
1064,2022,1,Riyadh Region Office,الرعاية مع الإقامة,35,19,1,0,55
1065,2022,1,Riyadh Region Office,الصحة البشرية,441,609,191,59,1300
1066,2022,1,Riyadh Region Office,الصرف الصحي,34,16,3,2,55
1067,2022,1,Riyadh Region Office,الصناعة التحويلية الأخرى,171,96,18,4,289
1068,2022,1,Riyadh Region Office,الطباعة واستنساخ وسائط الأعلام المسجّلة,329,205,22,6,562
1069,2022,1,Riyadh Region Office,النقل البري و النقل عبر الأنابيب,8567,650,72,16,9305
1070,2022,1,Riyadh Region Office,النقل الجوي,281,74,35,18,408
1071,2022,1,Riyadh Region Office,النقل المائي,86,17,3,0,106
1072,2022,1,Riyadh Region Office,الهندسة المدنية,254,89,24,7,374
1073,2022,1,Riyadh Region Office,تجارة التجزئة، باستثناء المركبات ذات المحركات والدراجات النارية,18228,5820,781,147,24976
1074,2022,1,Riyadh Region Office,تجارة الجملة ، باستثناء المركبات ذات المحركات والدراجات النارية,10998,5376,773,189,17336
1075,2022,1,Riyadh Region Office,تجارة الجملة والتجزئة ، وإصلاح المركبات ذات المحركات والدراجات النارية,6306,1503,70,8,7887
1076,2022,1,Riyadh Region Office,تجميع المياه ومعالجتها وتوصيلها,100,30,7,0,137
1077,2022,1,Riyadh Region Office,تشييد المباني,10456,4678,1015,355,16504
1078,2022,1,Riyadh Region Office,تعدين الفحم والليغنيت,6,1,1,0,8
1079,2022,1,Riyadh Region Office,تعدين ركازات الفلزات,49,39,0,1,89
1080,2022,1,Riyadh Region Office,تمويل التأمين وإعادة التأمين وصناديق المعاشات التقاعدية باستثناء الضمان الاجتماعي الإلزامي,52,52,17,8,129
1081,2022,1,Riyadh Region Office,توصيل الكهرباء والغاز والبخار وتكييف الهواء,93,70,23,16,202
1082,2022,1,Riyadh Region Office,صناعة الآلات والمعدات غير المصنفة في موضع أخر,160,52,9,2,223
1083,2022,1,Riyadh Region Office,صناعة المركبات ذات المحركات والمركبات المقطورة ونصف المقطورة,90,58,3,1,152
1084,2022,1,Riyadh Region Office,صناعة معدات النقل الأخرى,109,48,8,1,166
1085,2022,1,Riyadh Region Office,صنع الأثاث,824,383,37,4,1248
1086,2022,1,Riyadh Region Office,صنع الحواسيب والمنتجات الإلكترونية والبصرية,253,128,30,8,419
1087,2022,1,Riyadh Region Office,صُنع الخشب ومنتجات الخشب والفلين ، باستثناء الأثاث ، صُنع أصناف من القش ومواد الضفر,667,236,35,9,947
1088,2022,1,Riyadh Region Office,صنع الفلزات القاعدية,478,282,73,17,850
1089,2022,1,Riyadh Region Office,صُنع المشروبات,62,35,17,6,120
1090,2022,1,Riyadh Region Office,صنع المعدات الكهربائية,221,122,27,6,376
1091,2022,1,Riyadh Region Office,صُنع الملبوسات,2035,458,25,1,2519
1092,2022,1,Riyadh Region Office,صُنع المنتجات الجلدية والمنتجات ذات الصلة,63,16,1,0,80
1093,2022,1,Riyadh Region Office,صنع المنتجات الصيدلانية الأساسية والمستحضرات الصيدلانية,50,25,4,0,79
1094,2022,1,Riyadh Region Office,صُنع المنتجات الغذائية,1210,511,75,26,1822
1095,2022,1,Riyadh Region Office,صُنع المنسوجات,174,76,13,9,272
1096,2022,1,Riyadh Region Office,صُنع المواد الكيميائية والمنتجات الكيميائية,361,204,32,2,599
1097,2022,1,Riyadh Region Office,صُنع الورق ومنتجات الورق,67,49,8,0,124
1098,2022,1,Riyadh Region Office,صنع فحم الكوك والمنتجات النفطية المكررة,25,12,1,0,38
1099,2022,1,Riyadh Region Office,صُنع منتجات التبغ,1,0,0,0,1
1100,2022,1,Riyadh Region Office,صنع منتجات المطاط واللدائن,264,180,83,13,540
1101,2022,1,Riyadh Region Office,صنع منتجات المعادن اللافلزية الأخرى,895,495,90,21,1501
1102,2022,1,Riyadh Region Office,صنع منتجات المعادن المشكلة ( باستثناء الآلات والمعدات ),896,453,97,24,1470
1103,2022,1,Riyadh Region Office,صيد الأسماك وتربية المائيات,24,3,1,1,29
1104,2022,1,Riyadh Region Office,وكالات السفر ومشغّلو الجولات السياحية وخدمات الحجز والأنشطة المتصلة بها,223,103,15,5,346
1105,2022,1,Qassim Region Office,أبحاث الإعلان والسوق,30,6,0,0,36
1106,2022,1,Qassim Region Office,إصلاح أجهزة الحاسوب والسلع الشخصية والمنزلية,272,39,3,0,314
1107,2022,1,Qassim Region Office,إصلاح وتركيب الآلات والمعدات,90,9,0,0,99
1108,2022,1,Qassim Region Office,أنشطة أنتاج الأفلام والبرامج التلفزيونية والتسجيلات الصوتية و نشرالموسيقى,11,2,0,0,13
1109,2022,1,Qassim Region Office,أنشطة الأمن والتحقيقات,4,4,0,0,8
1110,2022,1,Qassim Region Office,أنشطة الاستخدام,22,10,1,0,33
1111,2022,1,Qassim Region Office,أنشطة الاسر المعيشية التي تستخدم أفراداً للعمل المنزلي,8,1,0,0,9
1112,2022,1,Qassim Region Office,أنشطة البرمجة الحاسوبية والخبرة الاستشارية وما يتصل بها من أنشطة,38,9,0,0,47
1113,2022,1,Qassim Region Office,أنشطة البرمجة والإذاعة,1,0,0,0,1
1114,2022,1,Qassim Region Office,أنشطة البريد ونقل الرسائل والطرود بواسطة مندوبين,3,0,0,0,3
1115,2022,1,Qassim Region Office,أنشطة التشييد المتخصصة,3381,602,86,3,4072
1116,2022,1,Qassim Region Office,أنشطة الخدمات الشخصية الأخرى,1287,127,9,1,1424
1117,2022,1,Qassim Region Office,أنشطة الخدمات المالية ، فيما عدا تمويل التأمين وصناديق المعاشات,29,2,0,1,32
1118,2022,1,Qassim Region Office,أنشطة العمل الاجتماعي، دون إقامة، لكبار السن وذوي الإعاقة,56,48,4,0,108
1119,2022,1,Qassim Region Office,أنشطة المعمارية والهندسية ، والاختبارات الفنية والتحليل,220,75,9,0,304
1120,2022,1,Qassim Region Office,أنشطة المكاتب الرئيسية ، وألأنشطة الاستشارية في مجال الإدارة,61,17,2,0,80
1121,2022,1,Qassim Region Office,أنشطة المكتبات ودور المحفوظات، والمتاحف والأنشطة الثقافية الأخرى,22,13,0,0,35
1122,2022,1,Qassim Region Office,أنشطة المنظمات الدولية,2,0,0,0,2
1123,2022,1,Qassim Region Office,أنشطة المنظمات ذات العضوية,34,13,1,0,48
1124,2022,1,Qassim Region Office,أنشطة النشر,17,6,0,0,23
1125,2022,1,Qassim Region Office,أنشطة تقديم الخدمات للمباني وتجميل المواقع,1300,287,48,12,1647
1126,2022,1,Qassim Region Office,أنشطة جمع النفايات ومعالجتها وتصريفها ، واسترجاع المواد,4,2,0,0,6
1127,2022,1,Qassim Region Office,أنشطة خدمات الأطعمة والمشروبات,2906,902,63,3,3874
1128,2022,1,Qassim Region Office,أنشطة خدمات المعلومات,14,3,0,0,17
1129,2022,1,Qassim Region Office,أنشطة خدمات دعم التعدين,7,2,0,0,9
1130,2022,1,Qassim Region Office,أنشطة زراعة المحاصيل والإنتاج الحيواني والصيد والخدمات المتصلة,920,91,13,6,1030
1131,2022,1,Qassim Region Office,الإدارة العامة والدفاع ؛ والضمان الاجتماعي الإلزامي,31,27,2,0,60
1132,2022,1,Qassim Region Office,الإقامة,91,48,7,1,147
1133,2022,1,Qassim Region Office,الأنشطة الإبداعية والفنون وأنشطة الترفيه,8,3,0,0,11
1134,2022,1,Qassim Region Office,الأنشطة الأخرى للتعدين واستغلال المحاجر,11,1,0,0,12
1135,2022,1,Qassim Region Office,الأنشطة الإدارية للمكاتب ، وأنشطة الدعم للمكاتب وغير ذلك من أنشطة الدعم للأعمال,69,10,4,0,83
1136,2022,1,Qassim Region Office,الأنشطة الإيجارية,1053,62,5,0,1120
1137,2022,1,Qassim Region Office,الأنشطة البيطرية,10,5,1,0,16
1138,2022,1,Qassim Region Office,الأنشطة الرياضية وأنشطة التسلية والترفيه,71,31,0,0,102
1139,2022,1,Qassim Region Office,الأنشطة العقارية,99,15,0,0,114
1140,2022,1,Qassim Region Office,الأنشطة القانونية وأنشطة المحاسبة,34,1,0,0,35
1141,2022,1,Qassim Region Office,الأنشطة المساعدة لأنشطة الخدمات المالية وأنشطة التأمين,1,0,0,0,1
1142,2022,1,Qassim Region Office,الأنشطة المهنية والعلمية والتقنية الأخرى,21,5,0,0,26
1143,2022,1,Qassim Region Office,الاتصالات,81,22,1,0,104
1144,2022,1,Qassim Region Office,البحث والتطوير في المجال العلمي,2,0,0,0,2
1145,2022,1,Qassim Region Office,التخزين وأنشطة الدعم للنقل,108,32,6,0,146
1146,2022,1,Qassim Region Office,التعليم,53,38,18,2,111
1147,2022,1,Qassim Region Office,الحراجة وقطع الأخشاب,4,0,0,0,4
1148,2022,1,Qassim Region Office,الرعاية مع الإقامة,11,5,0,0,16
1149,2022,1,Qassim Region Office,الصحة البشرية,38,82,26,4,150
1150,2022,1,Qassim Region Office,الصرف الصحي,2,1,0,0,3
1151,2022,1,Qassim Region Office,الصناعة التحويلية الأخرى,30,5,0,0,35
1152,2022,1,Qassim Region Office,الطباعة واستنساخ وسائط الأعلام المسجّلة,54,25,1,0,80
1153,2022,1,Qassim Region Office,النقل البري و النقل عبر الأنابيب,838,159,11,2,1010
1154,2022,1,Qassim Region Office,النقل الجوي,11,9,2,2,24
1155,2022,1,Qassim Region Office,النقل المائي,10,1,0,0,11
1156,2022,1,Qassim Region Office,الهندسة المدنية,34,9,5,1,49
1157,2022,1,Qassim Region Office,تجارة التجزئة، باستثناء المركبات ذات المحركات والدراجات النارية,3171,658,53,7,3889
1158,2022,1,Qassim Region Office,تجارة الجملة ، باستثناء المركبات ذات المحركات والدراجات النارية,1637,558,60,6,2261
1159,2022,1,Qassim Region Office,تجارة الجملة والتجزئة ، وإصلاح المركبات ذات المحركات والدراجات النارية,2142,416,17,2,2577
1160,2022,1,Qassim Region Office,تجميع المياه ومعالجتها وتوصيلها,32,6,0,0,38
1161,2022,1,Qassim Region Office,تشييد المباني,7212,1896,259,40,9407
1162,2022,1,Qassim Region Office,تعدين الفحم والليغنيت,2,0,0,0,2
1163,2022,1,Qassim Region Office,تعدين ركازات الفلزات,40,12,1,0,53
1164,2022,1,Qassim Region Office,تمويل التأمين وإعادة التأمين وصناديق المعاشات التقاعدية باستثناء الضمان الاجتماعي الإلزامي,2,2,0,0,4
1165,2022,1,Qassim Region Office,توصيل الكهرباء والغاز والبخار وتكييف الهواء,12,3,0,0,15
1166,2022,1,Qassim Region Office,صناعة الآلات والمعدات غير المصنفة في موضع أخر,36,8,2,0,46
1167,2022,1,Qassim Region Office,صناعة المركبات ذات المحركات والمركبات المقطورة ونصف المقطورة,30,6,1,0,37
1168,2022,1,Qassim Region Office,صناعة معدات النقل الأخرى,18,6,0,0,24
1169,2022,1,Qassim Region Office,صنع الأثاث,179,60,7,0,246
1170,2022,1,Qassim Region Office,صنع الحواسيب والمنتجات الإلكترونية والبصرية,54,12,1,0,67
1171,2022,1,Qassim Region Office,صُنع الخشب ومنتجات الخشب والفلين ، باستثناء الأثاث ، صُنع أصناف من القش ومواد الضفر,242,47,4,1,294
1172,2022,1,Qassim Region Office,صنع الفلزات القاعدية,232,40,3,0,275
1173,2022,1,Qassim Region Office,صُنع المشروبات,12,10,3,1,26
1174,2022,1,Qassim Region Office,صنع المعدات الكهربائية,84,15,3,0,102
1175,2022,1,Qassim Region Office,صُنع الملبوسات,540,78,6,1,625
1176,2022,1,Qassim Region Office,صُنع المنتجات الجلدية والمنتجات ذات الصلة,6,1,0,0,7
1177,2022,1,Qassim Region Office,صنع المنتجات الصيدلانية الأساسية والمستحضرات الصيدلانية,3,4,1,0,8
1178,2022,1,Qassim Region Office,صُنع المنتجات الغذائية,378,93,32,5,508
1179,2022,1,Qassim Region Office,صُنع المنسوجات,84,20,1,0,105
1180,2022,1,Qassim Region Office,صُنع المواد الكيميائية والمنتجات الكيميائية,52,16,3,0,71
1181,2022,1,Qassim Region Office,صُنع الورق ومنتجات الورق,6,8,4,0,18
1182,2022,1,Qassim Region Office,صنع فحم الكوك والمنتجات النفطية المكررة,2,0,0,0,2
1183,2022,1,Qassim Region Office,صُنع منتجات التبغ,2,0,0,0,2
1184,2022,1,Qassim Region Office,صنع منتجات المطاط واللدائن,24,21,9,1,55
1185,2022,1,Qassim Region Office,صنع منتجات المعادن اللافلزية الأخرى,144,58,15,3,220
1186,2022,1,Qassim Region Office,صنع منتجات المعادن المشكلة ( باستثناء الآلات والمعدات ),613,104,8,3,728
1187,2022,1,Qassim Region Office,صيد الأسماك وتربية المائيات,4,1,0,0,5
1188,2022,1,Qassim Region Office,وكالات السفر ومشغّلو الجولات السياحية وخدمات الحجز والأنشطة المتصلة بها,38,13,0,0,51
1189,2022,1,Al-Madinah Al-Munawwarah Region Office,أبحاث الإعلان والسوق,37,5,0,0,42
1190,2022,1,Al-Madinah Al-Munawwarah Region Office,إصلاح أجهزة الحاسوب والسلع الشخصية والمنزلية,151,11,0,0,162
1191,2022,1,Al-Madinah Al-Munawwarah Region Office,إصلاح وتركيب الآلات والمعدات,64,6,0,0,70
1192,2022,1,Al-Madinah Al-Munawwarah Region Office,أنشطة أنتاج الأفلام والبرامج التلفزيونية والتسجيلات الصوتية و نشرالموسيقى,13,2,0,0,15
1193,2022,1,Al-Madinah Al-Munawwarah Region Office,أنشطة الأمن والتحقيقات,6,2,1,0,9
1194,2022,1,Al-Madinah Al-Munawwarah Region Office,أنشطة الاستخدام,33,12,0,0,45
1195,2022,1,Al-Madinah Al-Munawwarah Region Office,أنشطة الاسر المعيشية التي تستخدم أفراداً للعمل المنزلي,4,0,0,0,4
1196,2022,1,Al-Madinah Al-Munawwarah Region Office,أنشطة البرمجة الحاسوبية والخبرة الاستشارية وما يتصل بها من أنشطة,53,8,0,0,61
1197,2022,1,Al-Madinah Al-Munawwarah Region Office,أنشطة البرمجة والإذاعة,4,0,0,0,4
1198,2022,1,Al-Madinah Al-Munawwarah Region Office,أنشطة البريد ونقل الرسائل والطرود بواسطة مندوبين,6,1,0,0,7
1199,2022,1,Al-Madinah Al-Munawwarah Region Office,أنشطة التشييد المتخصصة,1627,346,11,0,1984
1200,2022,1,Al-Madinah Al-Munawwarah Region Office,أنشطة الخدمات الشخصية الأخرى,1447,147,3,0,1597
1201,2022,1,Al-Madinah Al-Munawwarah Region Office,أنشطة الخدمات المالية ، فيما عدا تمويل التأمين وصناديق المعاشات,27,2,0,0,29
1202,2022,1,Al-Madinah Al-Munawwarah Region Office,أنشطة العمل الاجتماعي، دون إقامة، لكبار السن وذوي الإعاقة,64,36,10,0,110
1203,2022,1,Al-Madinah Al-Munawwarah Region Office,أنشطة المعمارية والهندسية ، والاختبارات الفنية والتحليل,84,54,4,1,143
1204,2022,1,Al-Madinah Al-Munawwarah Region Office,أنشطة المكاتب الرئيسية ، وألأنشطة الاستشارية في مجال الإدارة,59,10,1,0,70
1205,2022,1,Al-Madinah Al-Munawwarah Region Office,أنشطة المكتبات ودور المحفوظات، والمتاحف والأنشطة الثقافية الأخرى,65,19,0,0,84
1206,2022,1,Al-Madinah Al-Munawwarah Region Office,أنشطة المنظمات ذات العضوية,14,5,2,0,21
1207,2022,1,Al-Madinah Al-Munawwarah Region Office,أنشطة النشر,34,12,0,0,46
1208,2022,1,Al-Madinah Al-Munawwarah Region Office,أنشطة تقديم الخدمات للمباني وتجميل المواقع,841,220,17,2,1080
1209,2022,1,Al-Madinah Al-Munawwarah Region Office,أنشطة جمع النفايات ومعالجتها وتصريفها ، واسترجاع المواد,4,2,0,0,6
1210,2022,1,Al-Madinah Al-Munawwarah Region Office,أنشطة خدمات الأطعمة والمشروبات,3093,776,39,3,3911
1211,2022,1,Al-Madinah Al-Munawwarah Region Office,أنشطة خدمات المعلومات,15,5,0,0,20
1212,2022,1,Al-Madinah Al-Munawwarah Region Office,أنشطة خدمات دعم التعدين,6,8,0,0,14
1213,2022,1,Al-Madinah Al-Munawwarah Region Office,أنشطة زراعة المحاصيل والإنتاج الحيواني والصيد والخدمات المتصلة,470,60,4,0,534
1214,2022,1,Al-Madinah Al-Munawwarah Region Office,الإدارة العامة والدفاع ؛ والضمان الاجتماعي الإلزامي,48,24,2,0,74
1215,2022,1,Al-Madinah Al-Munawwarah Region Office,الإقامة,197,106,31,5,339
1216,2022,1,Al-Madinah Al-Munawwarah Region Office,الأنشطة الإبداعية والفنون وأنشطة الترفيه,3,0,0,0,3
1217,2022,1,Al-Madinah Al-Munawwarah Region Office,الأنشطة الأخرى للتعدين واستغلال المحاجر,19,4,0,0,23
1218,2022,1,Al-Madinah Al-Munawwarah Region Office,الأنشطة الإدارية للمكاتب ، وأنشطة الدعم للمكاتب وغير ذلك من أنشطة الدعم للأعمال,84,7,0,0,91
1219,2022,1,Al-Madinah Al-Munawwarah Region Office,الأنشطة الإيجارية,671,44,3,0,718
1220,2022,1,Al-Madinah Al-Munawwarah Region Office,الأنشطة البيطرية,15,4,0,0,19
1221,2022,1,Al-Madinah Al-Munawwarah Region Office,الأنشطة الرياضية وأنشطة التسلية والترفيه,65,21,1,0,87
1222,2022,1,Al-Madinah Al-Munawwarah Region Office,الأنشطة العقارية,153,24,4,0,181
1223,2022,1,Al-Madinah Al-Munawwarah Region Office,الأنشطة القانونية وأنشطة المحاسبة,39,10,0,0,49
1224,2022,1,Al-Madinah Al-Munawwarah Region Office,الأنشطة المساعدة لأنشطة الخدمات المالية وأنشطة التأمين,10,5,0,0,15
1225,2022,1,Al-Madinah Al-Munawwarah Region Office,الأنشطة المهنية والعلمية والتقنية الأخرى,42,14,1,0,57
1226,2022,1,Al-Madinah Al-Munawwarah Region Office,الأنشطة غير المتميزة لإنتاج السلع والخدمات التي تقوم بها الأسر المعيشية الخاصة لإستعمالها الخاص,1,0,0,0,1
1227,2022,1,Al-Madinah Al-Munawwarah Region Office,الاتصالات,40,3,0,0,43
1228,2022,1,Al-Madinah Al-Munawwarah Region Office,البحث والتطوير في المجال العلمي,1,1,0,0,2
1229,2022,1,Al-Madinah Al-Munawwarah Region Office,التخزين وأنشطة الدعم للنقل,214,34,1,2,251
1230,2022,1,Al-Madinah Al-Munawwarah Region Office,التعليم,73,61,23,1,158
1231,2022,1,Al-Madinah Al-Munawwarah Region Office,الحراجة وقطع الأخشاب,1,1,0,0,2
1232,2022,1,Al-Madinah Al-Munawwarah Region Office,الرعاية مع الإقامة,11,5,0,0,16
1233,2022,1,Al-Madinah Al-Munawwarah Region Office,الصحة البشرية,31,95,21,5,152
1234,2022,1,Al-Madinah Al-Munawwarah Region Office,الصرف الصحي,3,1,0,0,4
1235,2022,1,Al-Madinah Al-Munawwarah Region Office,الصناعة التحويلية الأخرى,30,14,1,1,46
1236,2022,1,Al-Madinah Al-Munawwarah Region Office,الطباعة واستنساخ وسائط الأعلام المسجّلة,58,13,2,0,73
1237,2022,1,Al-Madinah Al-Munawwarah Region Office,النقل البري و النقل عبر الأنابيب,647,66,0,0,713
1238,2022,1,Al-Madinah Al-Munawwarah Region Office,النقل الجوي,10,2,0,0,12
1239,2022,1,Al-Madinah Al-Munawwarah Region Office,النقل المائي,7,0,0,0,7
1240,2022,1,Al-Madinah Al-Munawwarah Region Office,الهندسة المدنية,38,3,1,0,42
1241,2022,1,Al-Madinah Al-Munawwarah Region Office,تجارة التجزئة، باستثناء المركبات ذات المحركات والدراجات النارية,4612,964,51,5,5632
1242,2022,1,Al-Madinah Al-Munawwarah Region Office,تجارة الجملة ، باستثناء المركبات ذات المحركات والدراجات النارية,1517,393,34,3,1947
1243,2022,1,Al-Madinah Al-Munawwarah Region Office,تجارة الجملة والتجزئة ، وإصلاح المركبات ذات المحركات والدراجات النارية,1489,224,5,0,1718
1244,2022,1,Al-Madinah Al-Munawwarah Region Office,تجميع المياه ومعالجتها وتوصيلها,27,6,1,0,34
1245,2022,1,Al-Madinah Al-Munawwarah Region Office,تشييد المباني,2941,847,60,19,3867
1246,2022,1,Al-Madinah Al-Munawwarah Region Office,تعدين ركازات الفلزات,20,6,0,0,26
1247,2022,1,Al-Madinah Al-Munawwarah Region Office,تمويل التأمين وإعادة التأمين وصناديق المعاشات التقاعدية باستثناء الضمان الاجتماعي الإلزامي,2,1,0,0,3
1248,2022,1,Al-Madinah Al-Munawwarah Region Office,توصيل الكهرباء والغاز والبخار وتكييف الهواء,17,9,2,0,28
1249,2022,1,Al-Madinah Al-Munawwarah Region Office,صناعة الآلات والمعدات غير المصنفة في موضع أخر,19,2,0,0,21
1250,2022,1,Al-Madinah Al-Munawwarah Region Office,صناعة المركبات ذات المحركات والمركبات المقطورة ونصف المقطورة,42,2,0,0,44
1251,2022,1,Al-Madinah Al-Munawwarah Region Office,صناعة معدات النقل الأخرى,10,3,0,0,13
1252,2022,1,Al-Madinah Al-Munawwarah Region Office,صنع الأثاث,179,37,1,0,217
1253,2022,1,Al-Madinah Al-Munawwarah Region Office,صنع الحواسيب والمنتجات الإلكترونية والبصرية,41,12,0,0,53
1254,2022,1,Al-Madinah Al-Munawwarah Region Office,صُنع الخشب ومنتجات الخشب والفلين ، باستثناء الأثاث ، صُنع أصناف من القش ومواد الضفر,105,18,0,0,123
1255,2022,1,Al-Madinah Al-Munawwarah Region Office,صنع الفلزات القاعدية,90,20,4,1,115
1256,2022,1,Al-Madinah Al-Munawwarah Region Office,صُنع المشروبات,16,14,6,1,37
1257,2022,1,Al-Madinah Al-Munawwarah Region Office,صنع المعدات الكهربائية,69,17,0,0,86
1258,2022,1,Al-Madinah Al-Munawwarah Region Office,صُنع الملبوسات,652,74,2,0,728
1259,2022,1,Al-Madinah Al-Munawwarah Region Office,صُنع المنتجات الجلدية والمنتجات ذات الصلة,8,1,1,0,10
1260,2022,1,Al-Madinah Al-Munawwarah Region Office,صنع المنتجات الصيدلانية الأساسية والمستحضرات الصيدلانية,5,1,0,0,6
1261,2022,1,Al-Madinah Al-Munawwarah Region Office,صُنع المنتجات الغذائية,444,114,5,2,565
1262,2022,1,Al-Madinah Al-Munawwarah Region Office,صُنع المنسوجات,78,23,2,0,103
1263,2022,1,Al-Madinah Al-Munawwarah Region Office,صُنع المواد الكيميائية والمنتجات الكيميائية,35,14,2,0,51
1264,2022,1,Al-Madinah Al-Munawwarah Region Office,صُنع الورق ومنتجات الورق,4,4,1,0,9
1265,2022,1,Al-Madinah Al-Munawwarah Region Office,صنع فحم الكوك والمنتجات النفطية المكررة,1,1,0,0,2
1266,2022,1,Al-Madinah Al-Munawwarah Region Office,صُنع منتجات التبغ,1,0,0,0,1
1267,2022,1,Al-Madinah Al-Munawwarah Region Office,صنع منتجات المطاط واللدائن,27,18,4,0,49
1268,2022,1,Al-Madinah Al-Munawwarah Region Office,صنع منتجات المعادن اللافلزية الأخرى,109,41,11,0,161
1269,2022,1,Al-Madinah Al-Munawwarah Region Office,صنع منتجات المعادن المشكلة ( باستثناء الآلات والمعدات ),258,55,4,0,317
1270,2022,1,Al-Madinah Al-Munawwarah Region Office,صيد الأسماك وتربية المائيات,5,1,0,0,6
1271,2022,1,Al-Madinah Al-Munawwarah Region Office,وكالات السفر ومشغّلو الجولات السياحية وخدمات الحجز والأنشطة المتصلة بها,65,13,1,0,79
1272,2022,1,Tabuk Region Office,أبحاث الإعلان والسوق,15,0,1,0,16
1273,2022,1,Tabuk Region Office,إصلاح أجهزة الحاسوب والسلع الشخصية والمنزلية,174,34,0,0,208
1274,2022,1,Tabuk Region Office,إصلاح وتركيب الآلات والمعدات,56,1,0,0,57
1275,2022,1,Tabuk Region Office,أنشطة أنتاج الأفلام والبرامج التلفزيونية والتسجيلات الصوتية و نشرالموسيقى,5,0,0,0,5
1276,2022,1,Tabuk Region Office,أنشطة الأمن والتحقيقات,2,0,0,0,2
1277,2022,1,Tabuk Region Office,أنشطة الاستخدام,19,2,0,0,21
1278,2022,1,Tabuk Region Office,أنشطة الاسر المعيشية التي تستخدم أفراداً للعمل المنزلي,2,1,0,0,3
1279,2022,1,Tabuk Region Office,أنشطة البرمجة الحاسوبية والخبرة الاستشارية وما يتصل بها من أنشطة,6,2,0,0,8
1280,2022,1,Tabuk Region Office,أنشطة البرمجة والإذاعة,1,0,0,0,1
1281,2022,1,Tabuk Region Office,أنشطة البريد ونقل الرسائل والطرود بواسطة مندوبين,2,0,0,0,2
1282,2022,1,Tabuk Region Office,أنشطة التشييد المتخصصة,1113,136,3,0,1252
1283,2022,1,Tabuk Region Office,أنشطة الخدمات الشخصية الأخرى,912,74,2,0,988
1284,2022,1,Tabuk Region Office,أنشطة الخدمات المالية ، فيما عدا تمويل التأمين وصناديق المعاشات,18,2,0,0,20
1285,2022,1,Tabuk Region Office,أنشطة العمل الاجتماعي، دون إقامة، لكبار السن وذوي الإعاقة,28,10,1,0,39
1286,2022,1,Tabuk Region Office,أنشطة المعمارية والهندسية ، والاختبارات الفنية والتحليل,63,24,1,0,88
1287,2022,1,Tabuk Region Office,أنشطة المكاتب الرئيسية ، وألأنشطة الاستشارية في مجال الإدارة,11,1,0,0,12
1288,2022,1,Tabuk Region Office,أنشطة المكتبات ودور المحفوظات، والمتاحف والأنشطة الثقافية الأخرى,24,8,0,0,32
1289,2022,1,Tabuk Region Office,أنشطة المنظمات ذات العضوية,5,2,1,0,8
1290,2022,1,Tabuk Region Office,أنشطة النشر,6,2,0,0,8
1291,2022,1,Tabuk Region Office,أنشطة تقديم الخدمات للمباني وتجميل المواقع,359,61,4,1,425
1292,2022,1,Tabuk Region Office,أنشطة جمع النفايات ومعالجتها وتصريفها ، واسترجاع المواد,1,0,0,0,1
1293,2022,1,Tabuk Region Office,أنشطة خدمات الأطعمة والمشروبات,1670,370,24,0,2064
1294,2022,1,Tabuk Region Office,أنشطة خدمات المعلومات,9,2,0,0,11
1295,2022,1,Tabuk Region Office,أنشطة خدمات دعم التعدين,2,1,0,0,3
1296,2022,1,Tabuk Region Office,أنشطة زراعة المحاصيل والإنتاج الحيواني والصيد والخدمات المتصلة,418,35,1,2,456
1297,2022,1,Tabuk Region Office,الإدارة العامة والدفاع ؛ والضمان الاجتماعي الإلزامي,9,8,1,0,18
1298,2022,1,Tabuk Region Office,الإقامة,71,34,2,0,107
1299,2022,1,Tabuk Region Office,الأنشطة الإبداعية والفنون وأنشطة الترفيه,2,0,0,0,2
1300,2022,1,Tabuk Region Office,الأنشطة الأخرى للتعدين واستغلال المحاجر,4,2,0,0,6
1301,2022,1,Tabuk Region Office,الأنشطة الإدارية للمكاتب ، وأنشطة الدعم للمكاتب وغير ذلك من أنشطة الدعم للأعمال,40,3,1,0,44
1302,2022,1,Tabuk Region Office,الأنشطة الإيجارية,385,9,0,0,394
1303,2022,1,Tabuk Region Office,الأنشطة البيطرية,6,2,0,0,8
1304,2022,1,Tabuk Region Office,الأنشطة الرياضية وأنشطة التسلية والترفيه,52,9,0,0,61
1305,2022,1,Tabuk Region Office,الأنشطة العقارية,51,6,0,0,57
1306,2022,1,Tabuk Region Office,الأنشطة القانونية وأنشطة المحاسبة,8,0,0,0,8
1307,2022,1,Tabuk Region Office,الأنشطة المساعدة لأنشطة الخدمات المالية وأنشطة التأمين,3,0,0,0,3
1308,2022,1,Tabuk Region Office,الأنشطة المهنية والعلمية والتقنية الأخرى,21,2,0,0,23
1309,2022,1,Tabuk Region Office,الاتصالات,18,1,0,0,19
1310,2022,1,Tabuk Region Office,البحث والتطوير في المجال العلمي,1,0,0,0,1
1311,2022,1,Tabuk Region Office,التخزين وأنشطة الدعم للنقل,69,7,0,0,76
1312,2022,1,Tabuk Region Office,التعليم,34,36,17,1,88
1313,2022,1,Tabuk Region Office,الرعاية مع الإقامة,9,0,1,0,10
1314,2022,1,Tabuk Region Office,الصحة البشرية,19,48,10,1,78
1315,2022,1,Tabuk Region Office,الصرف الصحي,1,0,0,0,1
1316,2022,1,Tabuk Region Office,الصناعة التحويلية الأخرى,15,0,0,0,15
1317,2022,1,Tabuk Region Office,الطباعة واستنساخ وسائط الأعلام المسجّلة,24,7,0,0,31
1318,2022,1,Tabuk Region Office,النقل البري و النقل عبر الأنابيب,458,57,5,0,520
1319,2022,1,Tabuk Region Office,النقل الجوي,8,4,3,0,15
1320,2022,1,Tabuk Region Office,النقل المائي,8,1,0,0,9
1321,2022,1,Tabuk Region Office,الهندسة المدنية,11,1,0,0,12
1322,2022,1,Tabuk Region Office,تجارة التجزئة، باستثناء المركبات ذات المحركات والدراجات النارية,1867,280,13,1,2161
1323,2022,1,Tabuk Region Office,تجارة الجملة ، باستثناء المركبات ذات المحركات والدراجات النارية,570,104,7,0,681
1324,2022,1,Tabuk Region Office,تجارة الجملة والتجزئة ، وإصلاح المركبات ذات المحركات والدراجات النارية,907,129,0,0,1036
1325,2022,1,Tabuk Region Office,تجميع المياه ومعالجتها وتوصيلها,38,4,0,0,42
1326,2022,1,Tabuk Region Office,تشييد المباني,2137,387,29,5,2558
1327,2022,1,Tabuk Region Office,تعدين الفحم والليغنيت,1,0,0,0,1
1328,2022,1,Tabuk Region Office,تعدين ركازات الفلزات,6,2,0,0,8
1329,2022,1,Tabuk Region Office,توصيل الكهرباء والغاز والبخار وتكييف الهواء,8,2,0,0,10
1330,2022,1,Tabuk Region Office,صناعة الآلات والمعدات غير المصنفة في موضع أخر,18,3,0,0,21
1331,2022,1,Tabuk Region Office,صناعة المركبات ذات المحركات والمركبات المقطورة ونصف المقطورة,30,1,0,0,31
1332,2022,1,Tabuk Region Office,صناعة معدات النقل الأخرى,2,1,0,0,3
1333,2022,1,Tabuk Region Office,صنع الأثاث,137,23,0,0,160
1334,2022,1,Tabuk Region Office,صنع الحواسيب والمنتجات الإلكترونية والبصرية,45,4,1,0,50
1335,2022,1,Tabuk Region Office,صُنع الخشب ومنتجات الخشب والفلين ، باستثناء الأثاث ، صُنع أصناف من القش ومواد الضفر,83,21,0,0,104
1336,2022,1,Tabuk Region Office,صنع الفلزات القاعدية,22,4,1,0,27
1337,2022,1,Tabuk Region Office,صُنع المشروبات,25,6,1,0,32
1338,2022,1,Tabuk Region Office,صنع المعدات الكهربائية,46,4,0,0,50
1339,2022,1,Tabuk Region Office,صُنع الملبوسات,622,40,0,0,662
1340,2022,1,Tabuk Region Office,صُنع المنتجات الجلدية والمنتجات ذات الصلة,3,4,0,0,7
1341,2022,1,Tabuk Region Office,صنع المنتجات الصيدلانية الأساسية والمستحضرات الصيدلانية,0,0,0,1,1
1342,2022,1,Tabuk Region Office,صُنع المنتجات الغذائية,194,42,2,2,240
1343,2022,1,Tabuk Region Office,صُنع المنسوجات,40,14,0,0,54
1344,2022,1,Tabuk Region Office,صُنع المواد الكيميائية والمنتجات الكيميائية,21,7,0,0,28
1345,2022,1,Tabuk Region Office,صُنع الورق ومنتجات الورق,2,3,0,0,5
1346,2022,1,Tabuk Region Office,صُنع منتجات التبغ,4,0,0,0,4
1347,2022,1,Tabuk Region Office,صنع منتجات المطاط واللدائن,6,8,1,0,15
1348,2022,1,Tabuk Region Office,صنع منتجات المعادن اللافلزية الأخرى,44,19,0,0,63
1349,2022,1,Tabuk Region Office,صنع منتجات المعادن المشكلة ( باستثناء الآلات والمعدات ),152,37,1,1,191
1350,2022,1,Tabuk Region Office,صيد الأسماك وتربية المائيات,21,10,0,0,31
1351,2022,1,Tabuk Region Office,وكالات السفر ومشغّلو الجولات السياحية وخدمات الحجز والأنشطة المتصلة بها,21,5,0,0,26
1352,2022,1,Jazan Region Office,أبحاث الإعلان والسوق,20,2,0,0,22
1353,2022,1,Jazan Region Office,إصلاح أجهزة الحاسوب والسلع الشخصية والمنزلية,156,15,0,0,171
1354,2022,1,Jazan Region Office,إصلاح وتركيب الآلات والمعدات,155,5,0,0,160
1355,2022,1,Jazan Region Office,أنشطة أنتاج الأفلام والبرامج التلفزيونية والتسجيلات الصوتية و نشرالموسيقى,8,0,0,0,8
1356,2022,1,Jazan Region Office,أنشطة الأمن والتحقيقات,6,1,0,0,7
1357,2022,1,Jazan Region Office,أنشطة الاستخدام,21,2,0,0,23
1358,2022,1,Jazan Region Office,أنشطة الاسر المعيشية التي تستخدم أفراداً للعمل المنزلي,4,0,0,0,4
1359,2022,1,Jazan Region Office,أنشطة البرمجة الحاسوبية والخبرة الاستشارية وما يتصل بها من أنشطة,11,0,0,0,11
1360,2022,1,Jazan Region Office,أنشطة التشييد المتخصصة,1246,149,6,1,1402
1361,2022,1,Jazan Region Office,أنشطة الخدمات الشخصية الأخرى,1254,92,0,0,1346
1362,2022,1,Jazan Region Office,أنشطة الخدمات المالية ، فيما عدا تمويل التأمين وصناديق المعاشات,32,3,0,0,35
1363,2022,1,Jazan Region Office,أنشطة العمل الاجتماعي، دون إقامة، لكبار السن وذوي الإعاقة,26,28,2,0,56
1364,2022,1,Jazan Region Office,أنشطة المعالجة وخدمات إدارة النفايات الأخرى,1,0,0,0,1
1365,2022,1,Jazan Region Office,أنشطة المعمارية والهندسية ، والاختبارات الفنية والتحليل,69,18,2,0,89
1366,2022,1,Jazan Region Office,أنشطة المكاتب الرئيسية ، وألأنشطة الاستشارية في مجال الإدارة,28,2,0,0,30
1367,2022,1,Jazan Region Office,أنشطة المكتبات ودور المحفوظات، والمتاحف والأنشطة الثقافية الأخرى,24,9,1,0,34
1368,2022,1,Jazan Region Office,أنشطة المنظمات ذات العضوية,26,5,0,0,31
1369,2022,1,Jazan Region Office,أنشطة النشر,16,2,0,0,18
1370,2022,1,Jazan Region Office,أنشطة تقديم الخدمات للمباني وتجميل المواقع,393,85,2,0,480
1371,2022,1,Jazan Region Office,أنشطة جمع النفايات ومعالجتها وتصريفها ، واسترجاع المواد,1,0,0,0,1
1372,2022,1,Jazan Region Office,أنشطة خدمات الأطعمة والمشروبات,3010,558,15,0,3583
1373,2022,1,Jazan Region Office,أنشطة خدمات المعلومات,12,4,0,0,16
1374,2022,1,Jazan Region Office,أنشطة خدمات دعم التعدين,11,7,0,0,18
1375,2022,1,Jazan Region Office,أنشطة زراعة المحاصيل والإنتاج الحيواني والصيد والخدمات المتصلة,402,33,1,0,436
1376,2022,1,Jazan Region Office,الإدارة العامة والدفاع ؛ والضمان الاجتماعي الإلزامي,18,8,0,0,26
1377,2022,1,Jazan Region Office,الإقامة,175,39,7,0,221
1378,2022,1,Jazan Region Office,الأنشطة الإبداعية والفنون وأنشطة الترفيه,3,0,0,0,3
1379,2022,1,Jazan Region Office,الأنشطة الأخرى للتعدين واستغلال المحاجر,10,4,0,0,14
1380,2022,1,Jazan Region Office,الأنشطة الإدارية للمكاتب ، وأنشطة الدعم للمكاتب وغير ذلك من أنشطة الدعم للأعمال,40,1,0,0,41
1381,2022,1,Jazan Region Office,الأنشطة الإيجارية,1172,32,1,0,1205
1382,2022,1,Jazan Region Office,الأنشطة البيطرية,6,6,0,0,12
1383,2022,1,Jazan Region Office,الأنشطة الرياضية وأنشطة التسلية والترفيه,41,6,1,0,48
1384,2022,1,Jazan Region Office,الأنشطة العقارية,62,10,0,1,73
1385,2022,1,Jazan Region Office,الأنشطة القانونية وأنشطة المحاسبة,14,2,0,0,16
1386,2022,1,Jazan Region Office,الأنشطة المساعدة لأنشطة الخدمات المالية وأنشطة التأمين,1,0,0,0,1
1387,2022,1,Jazan Region Office,الأنشطة المهنية والعلمية والتقنية الأخرى,21,3,0,0,24
1388,2022,1,Jazan Region Office,الأنشطة غير المتميزة لإنتاج السلع والخدمات التي تقوم بها الأسر المعيشية الخاصة لإستعمالها الخاص,1,0,0,0,1
1389,2022,1,Jazan Region Office,الاتصالات,23,4,0,0,27
1390,2022,1,Jazan Region Office,البحث والتطوير في المجال العلمي,1,0,0,0,1
1391,2022,1,Jazan Region Office,التخزين وأنشطة الدعم للنقل,76,19,1,1,97
1392,2022,1,Jazan Region Office,التعليم,43,31,3,0,77
1393,2022,1,Jazan Region Office,الحراجة وقطع الأخشاب,0,1,0,0,1
1394,2022,1,Jazan Region Office,الرعاية مع الإقامة,10,4,0,0,14
1395,2022,1,Jazan Region Office,الصحة البشرية,37,65,12,2,116
1396,2022,1,Jazan Region Office,الصرف الصحي,2,2,0,0,4
1397,2022,1,Jazan Region Office,الصناعة التحويلية الأخرى,16,8,0,0,24
1398,2022,1,Jazan Region Office,الطباعة واستنساخ وسائط الأعلام المسجّلة,16,5,0,0,21
1399,2022,1,Jazan Region Office,النقل البري و النقل عبر الأنابيب,316,32,2,0,350
1400,2022,1,Jazan Region Office,النقل الجوي,10,1,0,0,11
1401,2022,1,Jazan Region Office,النقل المائي,4,2,1,0,7
1402,2022,1,Jazan Region Office,الهندسة المدنية,21,2,1,0,24
1403,2022,1,Jazan Region Office,تجارة التجزئة، باستثناء المركبات ذات المحركات والدراجات النارية,3558,496,18,1,4073
1404,2022,1,Jazan Region Office,تجارة الجملة ، باستثناء المركبات ذات المحركات والدراجات النارية,1342,305,23,0,1670
1405,2022,1,Jazan Region Office,تجارة الجملة والتجزئة ، وإصلاح المركبات ذات المحركات والدراجات النارية,1432,154,5,1,1592
1406,2022,1,Jazan Region Office,تجميع المياه ومعالجتها وتوصيلها,46,7,1,1,55
1407,2022,1,Jazan Region Office,تشييد المباني,2565,433,38,1,3037
1408,2022,1,Jazan Region Office,تعدين ركازات الفلزات,22,7,0,0,29
1409,2022,1,Jazan Region Office,تمويل التأمين وإعادة التأمين وصناديق المعاشات التقاعدية باستثناء الضمان الاجتماعي الإلزامي,1,1,0,0,2
1410,2022,1,Jazan Region Office,توصيل الكهرباء والغاز والبخار وتكييف الهواء,11,9,1,0,21
1411,2022,1,Jazan Region Office,صناعة الآلات والمعدات غير المصنفة في موضع أخر,36,2,0,0,38
1412,2022,1,Jazan Region Office,صناعة المركبات ذات المحركات والمركبات المقطورة ونصف المقطورة,85,4,0,0,89
1413,2022,1,Jazan Region Office,صناعة معدات النقل الأخرى,13,3,0,0,16
1414,2022,1,Jazan Region Office,صنع الأثاث,175,12,0,0,187
1415,2022,1,Jazan Region Office,صنع الحواسيب والمنتجات الإلكترونية والبصرية,40,11,0,0,51
1416,2022,1,Jazan Region Office,صُنع الخشب ومنتجات الخشب والفلين ، باستثناء الأثاث ، صُنع أصناف من القش ومواد الضفر,148,15,0,0,163
1417,2022,1,Jazan Region Office,صنع الفلزات القاعدية,59,13,1,1,74
1418,2022,1,Jazan Region Office,صُنع المشروبات,14,4,3,1,22
1419,2022,1,Jazan Region Office,صنع المعدات الكهربائية,71,8,0,0,79
1420,2022,1,Jazan Region Office,صُنع الملبوسات,410,45,0,0,455
1421,2022,1,Jazan Region Office,صُنع المنتجات الجلدية والمنتجات ذات الصلة,47,2,0,0,49
1422,2022,1,Jazan Region Office,صنع المنتجات الصيدلانية الأساسية والمستحضرات الصيدلانية,5,1,0,0,6
1423,2022,1,Jazan Region Office,صُنع المنتجات الغذائية,271,74,5,0,350
1424,2022,1,Jazan Region Office,صُنع المنسوجات,14,4,0,0,18
1425,2022,1,Jazan Region Office,صُنع المواد الكيميائية والمنتجات الكيميائية,34,10,2,1,47
1426,2022,1,Jazan Region Office,صُنع الورق ومنتجات الورق,2,1,1,0,4
1427,2022,1,Jazan Region Office,صنع فحم الكوك والمنتجات النفطية المكررة,1,0,0,0,1
1428,2022,1,Jazan Region Office,صُنع منتجات التبغ,0,1,0,0,1
1429,2022,1,Jazan Region Office,صنع منتجات المطاط واللدائن,8,8,1,0,17
1430,2022,1,Jazan Region Office,صنع منتجات المعادن اللافلزية الأخرى,95,38,10,2,145
1431,2022,1,Jazan Region Office,صنع منتجات المعادن المشكلة ( باستثناء الآلات والمعدات ),390,20,1,0,411
1432,2022,1,Jazan Region Office,صيد الأسماك وتربية المائيات,111,67,4,0,182
1433,2022,1,Jazan Region Office,وكالات السفر ومشغّلو الجولات السياحية وخدمات الحجز والأنشطة المتصلة بها,17,2,0,0,19
1434,2022,1,Hail Region Office,أبحاث الإعلان والسوق,14,7,0,0,21
1435,2022,1,Hail Region Office,إصلاح أجهزة الحاسوب والسلع الشخصية والمنزلية,127,10,1,0,138
1436,2022,1,Hail Region Office,إصلاح وتركيب الآلات والمعدات,24,2,0,0,26
1437,2022,1,Hail Region Office,أنشطة أنتاج الأفلام والبرامج التلفزيونية والتسجيلات الصوتية و نشرالموسيقى,7,1,0,0,8
1438,2022,1,Hail Region Office,أنشطة الأمن والتحقيقات,3,1,0,0,4
1439,2022,1,Hail Region Office,أنشطة الاستخدام,9,3,0,0,12
1440,2022,1,Hail Region Office,أنشطة الاسر المعيشية التي تستخدم أفراداً للعمل المنزلي,1,0,0,0,1
1441,2022,1,Hail Region Office,أنشطة البرمجة الحاسوبية والخبرة الاستشارية وما يتصل بها من أنشطة,7,4,0,0,11
1442,2022,1,Hail Region Office,أنشطة البريد ونقل الرسائل والطرود بواسطة مندوبين,2,1,0,0,3
1443,2022,1,Hail Region Office,أنشطة التشييد المتخصصة,1190,182,3,0,1375
1444,2022,1,Hail Region Office,أنشطة الخدمات الشخصية الأخرى,768,70,1,0,839
1445,2022,1,Hail Region Office,أنشطة الخدمات المالية ، فيما عدا تمويل التأمين وصناديق المعاشات,27,1,0,0,28
1446,2022,1,Hail Region Office,أنشطة العمل الاجتماعي، دون إقامة، لكبار السن وذوي الإعاقة,42,19,0,0,61
1447,2022,1,Hail Region Office,أنشطة المعمارية والهندسية ، والاختبارات الفنية والتحليل,64,15,1,0,80
1448,2022,1,Hail Region Office,أنشطة المكاتب الرئيسية ، وألأنشطة الاستشارية في مجال الإدارة,21,1,0,0,22
1449,2022,1,Hail Region Office,أنشطة المكتبات ودور المحفوظات، والمتاحف والأنشطة الثقافية الأخرى,6,2,0,0,8
1450,2022,1,Hail Region Office,أنشطة المنظمات ذات العضوية,26,4,0,0,30
1451,2022,1,Hail Region Office,أنشطة النشر,39,0,0,0,39
1452,2022,1,Hail Region Office,أنشطة تقديم الخدمات للمباني وتجميل المواقع,360,53,7,1,421
1453,2022,1,Hail Region Office,أنشطة جمع النفايات ومعالجتها وتصريفها ، واسترجاع المواد,2,0,0,0,2
1454,2022,1,Hail Region Office,أنشطة خدمات الأطعمة والمشروبات,1503,281,17,1,1802
1455,2022,1,Hail Region Office,أنشطة خدمات المعلومات,9,0,0,0,9
1456,2022,1,Hail Region Office,أنشطة خدمات دعم التعدين,8,3,0,0,11
1457,2022,1,Hail Region Office,أنشطة زراعة المحاصيل والإنتاج الحيواني والصيد والخدمات المتصلة,1160,51,6,1,1218
1458,2022,1,Hail Region Office,الإدارة العامة والدفاع ؛ والضمان الاجتماعي الإلزامي,16,8,0,0,24
1459,2022,1,Hail Region Office,الإقامة,61,19,1,0,81
1460,2022,1,Hail Region Office,الأنشطة الإبداعية والفنون وأنشطة الترفيه,2,1,0,0,3
1461,2022,1,Hail Region Office,الأنشطة الأخرى للتعدين واستغلال المحاجر,29,4,0,0,33
1462,2022,1,Hail Region Office,الأنشطة الإدارية للمكاتب ، وأنشطة الدعم للمكاتب وغير ذلك من أنشطة الدعم للأعمال,46,3,0,0,49
1463,2022,1,Hail Region Office,الأنشطة الإيجارية,829,38,1,0,868
1464,2022,1,Hail Region Office,الأنشطة البيطرية,4,0,1,0,5
1465,2022,1,Hail Region Office,الأنشطة الرياضية وأنشطة التسلية والترفيه,44,20,0,0,64
1466,2022,1,Hail Region Office,الأنشطة العقارية,63,10,0,0,73
1467,2022,1,Hail Region Office,الأنشطة القانونية وأنشطة المحاسبة,7,2,0,0,9
1468,2022,1,Hail Region Office,الأنشطة المهنية والعلمية والتقنية الأخرى,12,0,1,0,13
1469,2022,1,Hail Region Office,الاتصالات,29,2,0,0,31
1470,2022,1,Hail Region Office,التخزين وأنشطة الدعم للنقل,63,13,0,0,76
1471,2022,1,Hail Region Office,التعليم,33,24,4,0,61
1472,2022,1,Hail Region Office,الحراجة وقطع الأخشاب,2,0,0,0,2
1473,2022,1,Hail Region Office,الرعاية مع الإقامة,11,3,0,0,14
1474,2022,1,Hail Region Office,الصحة البشرية,40,52,17,2,111
1475,2022,1,Hail Region Office,الصرف الصحي,2,0,0,0,2
1476,2022,1,Hail Region Office,الصناعة التحويلية الأخرى,12,1,0,0,13
1477,2022,1,Hail Region Office,الطباعة واستنساخ وسائط الأعلام المسجّلة,44,7,0,0,51
1478,2022,1,Hail Region Office,النقل البري و النقل عبر الأنابيب,488,36,3,0,527
1479,2022,1,Hail Region Office,النقل الجوي,26,5,0,0,31
1480,2022,1,Hail Region Office,النقل المائي,3,0,0,0,3
1481,2022,1,Hail Region Office,الهندسة المدنية,15,5,1,0,21
1482,2022,1,Hail Region Office,تجارة التجزئة، باستثناء المركبات ذات المحركات والدراجات النارية,1476,278,14,0,1768
1483,2022,1,Hail Region Office,تجارة الجملة ، باستثناء المركبات ذات المحركات والدراجات النارية,474,94,7,2,577
1484,2022,1,Hail Region Office,تجارة الجملة والتجزئة ، وإصلاح المركبات ذات المحركات والدراجات النارية,734,141,2,0,877
1485,2022,1,Hail Region Office,تجميع المياه ومعالجتها وتوصيلها,15,3,1,0,19
1486,2022,1,Hail Region Office,تشييد المباني,2806,595,61,8,3470
1487,2022,1,Hail Region Office,تعدين الفحم والليغنيت,1,0,0,0,1
1488,2022,1,Hail Region Office,تعدين ركازات الفلزات,5,0,0,0,5
1489,2022,1,Hail Region Office,توصيل الكهرباء والغاز والبخار وتكييف الهواء,15,5,2,0,22
1490,2022,1,Hail Region Office,صناعة الآلات والمعدات غير المصنفة في موضع أخر,22,4,0,0,26
1491,2022,1,Hail Region Office,صناعة المركبات ذات المحركات والمركبات المقطورة ونصف المقطورة,38,3,0,0,41
1492,2022,1,Hail Region Office,صناعة معدات النقل الأخرى,4,0,0,0,4
1493,2022,1,Hail Region Office,صنع الأثاث,120,24,0,0,144
1494,2022,1,Hail Region Office,صنع الحواسيب والمنتجات الإلكترونية والبصرية,35,5,0,0,40
1495,2022,1,Hail Region Office,صُنع الخشب ومنتجات الخشب والفلين ، باستثناء الأثاث ، صُنع أصناف من القش ومواد الضفر,58,10,1,0,69
1496,2022,1,Hail Region Office,صنع الفلزات القاعدية,89,26,3,0,118
1497,2022,1,Hail Region Office,صُنع المشروبات,8,6,0,0,14
1498,2022,1,Hail Region Office,صنع المعدات الكهربائية,42,3,0,0,45
1499,2022,1,Hail Region Office,صُنع الملبوسات,316,40,0,0,356
1500,2022,1,Hail Region Office,صُنع المنتجات الجلدية والمنتجات ذات الصلة,6,2,0,0,8
1501,2022,1,Hail Region Office,صنع المنتجات الصيدلانية الأساسية والمستحضرات الصيدلانية,3,0,0,0,3
1502,2022,1,Hail Region Office,صُنع المنتجات الغذائية,179,40,5,0,224
1503,2022,1,Hail Region Office,صُنع المنسوجات,50,21,0,0,71
1504,2022,1,Hail Region Office,صُنع المواد الكيميائية والمنتجات الكيميائية,85,31,0,0,116
1505,2022,1,Hail Region Office,صُنع الورق ومنتجات الورق,4,3,0,0,7
1506,2022,1,Hail Region Office,صنع منتجات المطاط واللدائن,13,7,2,0,22
1507,2022,1,Hail Region Office,صنع منتجات المعادن اللافلزية الأخرى,96,36,8,1,141
1508,2022,1,Hail Region Office,صنع منتجات المعادن المشكلة ( باستثناء الآلات والمعدات ),105,34,0,0,139
1509,2022,1,Hail Region Office,صيد الأسماك وتربية المائيات,1,0,0,0,1
1510,2022,1,Hail Region Office,وكالات السفر ومشغّلو الجولات السياحية وخدمات الحجز والأنشطة المتصلة بها,8,1,0,0,9
1511,2022,1,Asir Region Office,أبحاث الإعلان والسوق,29,1,0,0,30
1512,2022,1,Asir Region Office,إصلاح أجهزة الحاسوب والسلع الشخصية والمنزلية,209,29,1,0,239
1513,2022,1,Asir Region Office,إصلاح وتركيب الآلات والمعدات,63,2,1,0,66
1514,2022,1,Asir Region Office,أنشطة أنتاج الأفلام والبرامج التلفزيونية والتسجيلات الصوتية و نشرالموسيقى,12,0,0,0,12
1515,2022,1,Asir Region Office,أنشطة الأمن والتحقيقات,10,4,2,1,17
1516,2022,1,Asir Region Office,أنشطة الاستخدام,34,5,0,1,40
1517,2022,1,Asir Region Office,أنشطة البرمجة الحاسوبية والخبرة الاستشارية وما يتصل بها من أنشطة,15,6,0,0,21
1518,2022,1,Asir Region Office,أنشطة البرمجة والإذاعة,6,3,0,0,9
1519,2022,1,Asir Region Office,أنشطة البريد ونقل الرسائل والطرود بواسطة مندوبين,7,1,0,0,8
1520,2022,1,Asir Region Office,أنشطة التشييد المتخصصة,1798,266,9,1,2074
1521,2022,1,Asir Region Office,أنشطة الخدمات الشخصية الأخرى,1193,127,2,0,1322
1522,2022,1,Asir Region Office,أنشطة الخدمات المالية ، فيما عدا تمويل التأمين وصناديق المعاشات,18,1,0,0,19
1523,2022,1,Asir Region Office,أنشطة العمل الاجتماعي، دون إقامة، لكبار السن وذوي الإعاقة,49,40,4,0,93
1524,2022,1,Asir Region Office,أنشطة المعمارية والهندسية ، والاختبارات الفنية والتحليل,104,46,3,1,154
1525,2022,1,Asir Region Office,أنشطة المكاتب الرئيسية ، وألأنشطة الاستشارية في مجال الإدارة,27,2,1,0,30
1526,2022,1,Asir Region Office,أنشطة المكتبات ودور المحفوظات، والمتاحف والأنشطة الثقافية الأخرى,27,21,1,0,49
1527,2022,1,Asir Region Office,أنشطة المنظمات ذات العضوية,24,6,0,0,30
1528,2022,1,Asir Region Office,أنشطة النشر,16,2,1,0,19
1529,2022,1,Asir Region Office,أنشطة تقديم الخدمات للمباني وتجميل المواقع,433,75,5,2,515
1530,2022,1,Asir Region Office,أنشطة جمع النفايات ومعالجتها وتصريفها ، واسترجاع المواد,6,1,0,0,7
1531,2022,1,Asir Region Office,أنشطة خدمات الأطعمة والمشروبات,3366,906,63,4,4339
1532,2022,1,Asir Region Office,أنشطة خدمات المعلومات,20,3,0,0,23
1533,2022,1,Asir Region Office,أنشطة خدمات دعم التعدين,23,5,1,0,29
1534,2022,1,Asir Region Office,أنشطة زراعة المحاصيل والإنتاج الحيواني والصيد والخدمات المتصلة,836,38,4,0,878
1535,2022,1,Asir Region Office,الإدارة العامة والدفاع ؛ والضمان الاجتماعي الإلزامي,12,13,1,0,26
1536,2022,1,Asir Region Office,الإقامة,208,76,5,1,290
1537,2022,1,Asir Region Office,الأنشطة الإبداعية والفنون وأنشطة الترفيه,3,0,0,0,3
1538,2022,1,Asir Region Office,الأنشطة الأخرى للتعدين واستغلال المحاجر,14,5,0,0,19
1539,2022,1,Asir Region Office,الأنشطة الإدارية للمكاتب ، وأنشطة الدعم للمكاتب وغير ذلك من أنشطة الدعم للأعمال,79,6,1,1,87
1540,2022,1,Asir Region Office,الأنشطة الإيجارية,1031,67,2,1,1101
1541,2022,1,Asir Region Office,الأنشطة البيطرية,11,5,3,0,19
1542,2022,1,Asir Region Office,الأنشطة الرياضية وأنشطة التسلية والترفيه,76,26,0,0,102
1543,2022,1,Asir Region Office,الأنشطة العقارية,108,20,2,0,130
1544,2022,1,Asir Region Office,الأنشطة القانونية وأنشطة المحاسبة,23,4,0,0,27
1545,2022,1,Asir Region Office,الأنشطة المساعدة لأنشطة الخدمات المالية وأنشطة التأمين,3,2,0,0,5
1546,2022,1,Asir Region Office,الأنشطة المهنية والعلمية والتقنية الأخرى,26,4,2,0,32
1547,2022,1,Asir Region Office,الأنشطة غير المتميزة لإنتاج السلع والخدمات التي تقوم بها الأسر المعيشية الخاصة لإستعمالها الخاص,1,0,0,0,1
1548,2022,1,Asir Region Office,الاتصالات,27,2,0,0,29
1549,2022,1,Asir Region Office,التخزين وأنشطة الدعم للنقل,87,24,4,0,115
1550,2022,1,Asir Region Office,التعليم,37,37,12,1,87
1551,2022,1,Asir Region Office,الرعاية مع الإقامة,14,3,0,0,17
1552,2022,1,Asir Region Office,الصحة البشرية,63,94,38,6,201
1553,2022,1,Asir Region Office,الصرف الصحي,2,1,1,0,4
1554,2022,1,Asir Region Office,الصناعة التحويلية الأخرى,20,13,1,0,34
1555,2022,1,Asir Region Office,الطباعة واستنساخ وسائط الأعلام المسجّلة,24,17,2,0,43
1556,2022,1,Asir Region Office,النقل البري و النقل عبر الأنابيب,1248,157,4,3,1412
1557,2022,1,Asir Region Office,النقل الجوي,13,1,0,0,14
1558,2022,1,Asir Region Office,النقل المائي,9,0,0,0,9
1559,2022,1,Asir Region Office,الهندسة المدنية,33,7,1,0,41
1560,2022,1,Asir Region Office,تجارة التجزئة، باستثناء المركبات ذات المحركات والدراجات النارية,3542,701,48,5,4296
1561,2022,1,Asir Region Office,تجارة الجملة ، باستثناء المركبات ذات المحركات والدراجات النارية,1006,260,18,2,1286
1562,2022,1,Asir Region Office,تجارة الجملة والتجزئة ، وإصلاح المركبات ذات المحركات والدراجات النارية,1607,366,11,0,1984
1563,2022,1,Asir Region Office,تجميع المياه ومعالجتها وتوصيلها,101,30,0,0,131
1564,2022,1,Asir Region Office,تشييد المباني,5893,1421,118,16,7448
1565,2022,1,Asir Region Office,تعدين ركازات الفلزات,87,18,0,0,105
1566,2022,1,Asir Region Office,تمويل التأمين وإعادة التأمين وصناديق المعاشات التقاعدية باستثناء الضمان الاجتماعي الإلزامي,2,2,1,0,5
1567,2022,1,Asir Region Office,توصيل الكهرباء والغاز والبخار وتكييف الهواء,10,8,1,1,20
1568,2022,1,Asir Region Office,صناعة الآلات والمعدات غير المصنفة في موضع أخر,35,5,0,0,40
1569,2022,1,Asir Region Office,صناعة المركبات ذات المحركات والمركبات المقطورة ونصف المقطورة,38,4,1,0,43
1570,2022,1,Asir Region Office,صناعة معدات النقل الأخرى,8,2,0,0,10
1571,2022,1,Asir Region Office,صنع الأثاث,210,27,0,0,237
1572,2022,1,Asir Region Office,صنع الحواسيب والمنتجات الإلكترونية والبصرية,67,19,0,0,86
1573,2022,1,Asir Region Office,صُنع الخشب ومنتجات الخشب والفلين ، باستثناء الأثاث ، صُنع أصناف من القش ومواد الضفر,235,60,1,0,296
1574,2022,1,Asir Region Office,صنع الفلزات القاعدية,110,33,0,0,143
1575,2022,1,Asir Region Office,صُنع المشروبات,21,9,1,0,31
1576,2022,1,Asir Region Office,صنع المعدات الكهربائية,48,10,0,0,58
1577,2022,1,Asir Region Office,صُنع الملبوسات,530,61,1,0,592
1578,2022,1,Asir Region Office,صُنع المنتجات الجلدية والمنتجات ذات الصلة,8,4,0,0,12
1579,2022,1,Asir Region Office,صنع المنتجات الصيدلانية الأساسية والمستحضرات الصيدلانية,2,1,0,0,3
1580,2022,1,Asir Region Office,صُنع المنتجات الغذائية,317,109,9,1,436
1581,2022,1,Asir Region Office,صُنع المنسوجات,38,11,2,0,51
1582,2022,1,Asir Region Office,صُنع المواد الكيميائية والمنتجات الكيميائية,48,21,5,0,74
1583,2022,1,Asir Region Office,صُنع الورق ومنتجات الورق,7,4,1,0,12
1584,2022,1,Asir Region Office,صنع فحم الكوك والمنتجات النفطية المكررة,2,0,0,0,2
1585,2022,1,Asir Region Office,صُنع منتجات التبغ,1,0,0,0,1
1586,2022,1,Asir Region Office,صنع منتجات المطاط واللدائن,32,13,2,1,48
1587,2022,1,Asir Region Office,صنع منتجات المعادن اللافلزية الأخرى,130,81,18,2,231
1588,2022,1,Asir Region Office,صنع منتجات المعادن المشكلة ( باستثناء الآلات والمعدات ),325,26,4,0,355
1589,2022,1,Asir Region Office,صيد الأسماك وتربية المائيات,68,17,0,0,85
1590,2022,1,Asir Region Office,وكالات السفر ومشغّلو الجولات السياحية وخدمات الحجز والأنشطة المتصلة بها,19,5,0,0,24
1591,2022,1,Makkah / Jeddah Region Office,أبحاث الإعلان والسوق,227,33,1,0,261
1592,2022,1,Makkah / Jeddah Region Office,إصلاح أجهزة الحاسوب والسلع الشخصية والمنزلية,495,88,7,1,591
1593,2022,1,Makkah / Jeddah Region Office,إصلاح وتركيب الآلات والمعدات,228,46,11,1,286
1594,2022,1,Makkah / Jeddah Region Office,أنشطة أنتاج الأفلام والبرامج التلفزيونية والتسجيلات الصوتية و نشرالموسيقى,99,20,0,0,119
1595,2022,1,Makkah / Jeddah Region Office,أنشطة الأمن والتحقيقات,38,18,8,3,67
1596,2022,1,Makkah / Jeddah Region Office,أنشطة الاستخدام,136,27,5,3,171
1597,2022,1,Makkah / Jeddah Region Office,أنشطة الاسر المعيشية التي تستخدم أفراداً للعمل المنزلي,8,0,0,0,8
1598,2022,1,Makkah / Jeddah Region Office,أنشطة البرمجة الحاسوبية والخبرة الاستشارية وما يتصل بها من أنشطة,321,122,14,3,460
1599,2022,1,Makkah / Jeddah Region Office,أنشطة البرمجة والإذاعة,3,2,0,0,5
1600,2022,1,Makkah / Jeddah Region Office,أنشطة البريد ونقل الرسائل والطرود بواسطة مندوبين,27,3,0,0,30
1601,2022,1,Makkah / Jeddah Region Office,أنشطة التشييد المتخصصة,5317,1750,130,20,7217
1602,2022,1,Makkah / Jeddah Region Office,أنشطة الخدمات الشخصية الأخرى,3156,524,29,5,3714
1603,2022,1,Makkah / Jeddah Region Office,أنشطة الخدمات المالية ، فيما عدا تمويل التأمين وصناديق المعاشات,94,30,6,2,132
1604,2022,1,Makkah / Jeddah Region Office,أنشطة العمل الاجتماعي، دون إقامة، لكبار السن وذوي الإعاقة,136,132,13,0,281
1605,2022,1,Makkah / Jeddah Region Office,أنشطة المعالجة وخدمات إدارة النفايات الأخرى,3,0,0,0,3
1606,2022,1,Makkah / Jeddah Region Office,أنشطة المعمارية والهندسية ، والاختبارات الفنية والتحليل,380,238,23,4,645
1607,2022,1,Makkah / Jeddah Region Office,أنشطة المكاتب الرئيسية ، وألأنشطة الاستشارية في مجال الإدارة,360,173,3,0,536
1608,2022,1,Makkah / Jeddah Region Office,أنشطة المكتبات ودور المحفوظات، والمتاحف والأنشطة الثقافية الأخرى,61,47,3,1,112
1609,2022,1,Makkah / Jeddah Region Office,أنشطة المنظمات الدولية,1,1,1,0,3
1610,2022,1,Makkah / Jeddah Region Office,أنشطة المنظمات ذات العضوية,31,14,0,0,45
1611,2022,1,Makkah / Jeddah Region Office,أنشطة النشر,86,17,2,0,105
1612,2022,1,Makkah / Jeddah Region Office,أنشطة تقديم الخدمات للمباني وتجميل المواقع,1869,862,89,34,2854
1613,2022,1,Makkah / Jeddah Region Office,أنشطة جمع النفايات ومعالجتها وتصريفها ، واسترجاع المواد,26,6,2,0,34
1614,2022,1,Makkah / Jeddah Region Office,أنشطة خدمات الأطعمة والمشروبات,5766,1953,238,32,7989
1615,2022,1,Makkah / Jeddah Region Office,أنشطة خدمات المعلومات,116,38,5,0,159
1616,2022,1,Makkah / Jeddah Region Office,أنشطة خدمات دعم التعدين,40,22,5,5,72
1617,2022,1,Makkah / Jeddah Region Office,أنشطة زراعة المحاصيل والإنتاج الحيواني والصيد والخدمات المتصلة,493,89,8,2,592
1618,2022,1,Makkah / Jeddah Region Office,استخراج النفط الخام والغاز الطبيعي,2,0,0,0,2
1619,2022,1,Makkah / Jeddah Region Office,الإدارة العامة والدفاع ؛ والضمان الاجتماعي الإلزامي,294,159,17,1,471
1620,2022,1,Makkah / Jeddah Region Office,الإقامة,362,293,37,6,698
1621,2022,1,Makkah / Jeddah Region Office,الأنشطة الإبداعية والفنون وأنشطة الترفيه,62,13,1,0,76
1622,2022,1,Makkah / Jeddah Region Office,الأنشطة الأخرى للتعدين واستغلال المحاجر,51,16,5,2,74
1623,2022,1,Makkah / Jeddah Region Office,الأنشطة الإدارية للمكاتب ، وأنشطة الدعم للمكاتب وغير ذلك من أنشطة الدعم للأعمال,496,59,7,0,562
1624,2022,1,Makkah / Jeddah Region Office,الأنشطة الإيجارية,1110,147,14,3,1274
1625,2022,1,Makkah / Jeddah Region Office,الأنشطة البيطرية,25,19,3,0,47
1626,2022,1,Makkah / Jeddah Region Office,الأنشطة الرياضية وأنشطة التسلية والترفيه,280,93,11,1,385
1627,2022,1,Makkah / Jeddah Region Office,الأنشطة العقارية,655,218,33,1,907
1628,2022,1,Makkah / Jeddah Region Office,الأنشطة القانونية وأنشطة المحاسبة,236,93,5,1,335
1629,2022,1,Makkah / Jeddah Region Office,الأنشطة المساعدة لأنشطة الخدمات المالية وأنشطة التأمين,25,17,7,0,49
1630,2022,1,Makkah / Jeddah Region Office,الأنشطة المهنية والعلمية والتقنية الأخرى,191,26,1,0,218
1631,2022,1,Makkah / Jeddah Region Office,الأنشطة غير المتميزة لإنتاج السلع والخدمات التي تقوم بها الأسر المعيشية الخاصة لإستعمالها الخاص,2,0,0,0,2
1632,2022,1,Makkah / Jeddah Region Office,الاتصالات,145,50,4,0,199
1633,2022,1,Makkah / Jeddah Region Office,البحث والتطوير في المجال العلمي,13,4,2,0,19
1634,2022,1,Makkah / Jeddah Region Office,التخزين وأنشطة الدعم للنقل,393,180,49,12,634
1635,2022,1,Makkah / Jeddah Region Office,التعليم,233,261,90,12,596
1636,2022,1,Makkah / Jeddah Region Office,الحراجة وقطع الأخشاب,5,0,0,1,6
1637,2022,1,Makkah / Jeddah Region Office,الرعاية مع الإقامة,12,11,0,0,23
1638,2022,1,Makkah / Jeddah Region Office,الصحة البشرية,248,356,124,35,763
1639,2022,1,Makkah / Jeddah Region Office,الصرف الصحي,11,13,1,1,26
1640,2022,1,Makkah / Jeddah Region Office,الصناعة التحويلية الأخرى,94,81,8,3,186
1641,2022,1,Makkah / Jeddah Region Office,الطباعة واستنساخ وسائط الأعلام المسجّلة,202,134,28,2,366
1642,2022,1,Makkah / Jeddah Region Office,النقل البري و النقل عبر الأنابيب,1223,370,53,13,1659
1643,2022,1,Makkah / Jeddah Region Office,النقل الجوي,47,53,18,10,128
1644,2022,1,Makkah / Jeddah Region Office,النقل المائي,67,37,9,5,118
1645,2022,1,Makkah / Jeddah Region Office,الهندسة المدنية,96,35,11,1,143
1646,2022,1,Makkah / Jeddah Region Office,تجارة التجزئة، باستثناء المركبات ذات المحركات والدراجات النارية,10540,3051,287,65,13943
1647,2022,1,Makkah / Jeddah Region Office,تجارة الجملة ، باستثناء المركبات ذات المحركات والدراجات النارية,8739,4501,480,92,13812
1648,2022,1,Makkah / Jeddah Region Office,تجارة الجملة والتجزئة ، وإصلاح المركبات ذات المحركات والدراجات النارية,3091,793,60,19,3963
1649,2022,1,Makkah / Jeddah Region Office,تجميع المياه ومعالجتها وتوصيلها,57,24,2,3,86
1650,2022,1,Makkah / Jeddah Region Office,تشييد المباني,8150,3300,406,110,11966
1651,2022,1,Makkah / Jeddah Region Office,تعدين الفحم والليغنيت,4,3,0,0,7
1652,2022,1,Makkah / Jeddah Region Office,تعدين ركازات الفلزات,30,16,6,3,55
1653,2022,1,Makkah / Jeddah Region Office,تمويل التأمين وإعادة التأمين وصناديق المعاشات التقاعدية باستثناء الضمان الاجتماعي الإلزامي,8,26,10,4,48
1654,2022,1,Makkah / Jeddah Region Office,توصيل الكهرباء والغاز والبخار وتكييف الهواء,47,31,12,7,97
1655,2022,1,Makkah / Jeddah Region Office,صناعة الآلات والمعدات غير المصنفة في موضع أخر,66,21,6,1,94
1656,2022,1,Makkah / Jeddah Region Office,صناعة المركبات ذات المحركات والمركبات المقطورة ونصف المقطورة,72,27,6,0,105
1657,2022,1,Makkah / Jeddah Region Office,صناعة معدات النقل الأخرى,55,21,4,2,82
1658,2022,1,Makkah / Jeddah Region Office,صنع الأثاث,218,109,21,2,350
1659,2022,1,Makkah / Jeddah Region Office,صنع الحواسيب والمنتجات الإلكترونية والبصرية,132,70,17,1,220
1660,2022,1,Makkah / Jeddah Region Office,صُنع الخشب ومنتجات الخشب والفلين ، باستثناء الأثاث ، صُنع أصناف من القش ومواد الضفر,238,64,17,3,322
1661,2022,1,Makkah / Jeddah Region Office,صنع الفلزات القاعدية,99,110,34,8,251
1662,2022,1,Makkah / Jeddah Region Office,صُنع المشروبات,57,38,12,5,112
1663,2022,1,Makkah / Jeddah Region Office,صنع المعدات الكهربائية,147,70,14,2,233
1664,2022,1,Makkah / Jeddah Region Office,صُنع الملبوسات,1018,190,13,2,1223
1665,2022,1,Makkah / Jeddah Region Office,صُنع المنتجات الجلدية والمنتجات ذات الصلة,14,10,2,0,26
1666,2022,1,Makkah / Jeddah Region Office,صنع المنتجات الصيدلانية الأساسية والمستحضرات الصيدلانية,12,12,6,1,31
1667,2022,1,Makkah / Jeddah Region Office,صُنع المنتجات الغذائية,695,392,64,25,1176
1668,2022,1,Makkah / Jeddah Region Office,صُنع المنسوجات,77,40,15,3,135
1669,2022,1,Makkah / Jeddah Region Office,صُنع المواد الكيميائية والمنتجات الكيميائية,209,131,38,5,383
1670,2022,1,Makkah / Jeddah Region Office,صُنع الورق ومنتجات الورق,38,42,12,5,97
1671,2022,1,Makkah / Jeddah Region Office,صنع فحم الكوك والمنتجات النفطية المكررة,11,14,1,0,26
1672,2022,1,Makkah / Jeddah Region Office,صُنع منتجات التبغ,4,4,0,0,8
1673,2022,1,Makkah / Jeddah Region Office,صنع منتجات المطاط واللدائن,76,106,48,8,238
1674,2022,1,Makkah / Jeddah Region Office,صنع منتجات المعادن اللافلزية الأخرى,137,95,30,13,275
1675,2022,1,Makkah / Jeddah Region Office,صنع منتجات المعادن المشكلة ( باستثناء الآلات والمعدات ),277,109,43,8,437
1676,2022,1,Makkah / Jeddah Region Office,صيد الأسماك وتربية المائيات,154,58,0,0,212
1677,2022,1,Makkah / Jeddah Region Office,وكالات السفر ومشغّلو الجولات السياحية وخدمات الحجز والأنشطة المتصلة بها,160,87,7,0,254
1678,2022,1,Najran Region Office,أبحاث الإعلان والسوق,8,2,0,0,10
1679,2022,1,Najran Region Office,إصلاح أجهزة الحاسوب والسلع الشخصية والمنزلية,66,6,0,0,72
1680,2022,1,Najran Region Office,إصلاح وتركيب الآلات والمعدات,38,5,0,1,44
1681,2022,1,Najran Region Office,أنشطة أنتاج الأفلام والبرامج التلفزيونية والتسجيلات الصوتية و نشرالموسيقى,2,0,0,0,2
1682,2022,1,Najran Region Office,أنشطة الأمن والتحقيقات,1,0,0,1,2
1683,2022,1,Najran Region Office,أنشطة الاستخدام,15,2,0,0,17
1684,2022,1,Najran Region Office,أنشطة الاسر المعيشية التي تستخدم أفراداً للعمل المنزلي,5,0,0,0,5
1685,2022,1,Najran Region Office,أنشطة البرمجة الحاسوبية والخبرة الاستشارية وما يتصل بها من أنشطة,5,1,0,0,6
1686,2022,1,Najran Region Office,أنشطة البريد ونقل الرسائل والطرود بواسطة مندوبين,1,0,0,0,1
1687,2022,1,Najran Region Office,أنشطة التشييد المتخصصة,1409,244,16,6,1675
1688,2022,1,Najran Region Office,أنشطة الخدمات الشخصية الأخرى,513,37,0,0,550
1689,2022,1,Najran Region Office,أنشطة الخدمات المالية ، فيما عدا تمويل التأمين وصناديق المعاشات,21,1,0,0,22
1690,2022,1,Najran Region Office,أنشطة العمل الاجتماعي، دون إقامة، لكبار السن وذوي الإعاقة,22,5,0,0,27
1691,2022,1,Najran Region Office,أنشطة المعالجة وخدمات إدارة النفايات الأخرى,0,1,0,0,1
1692,2022,1,Najran Region Office,أنشطة المعمارية والهندسية ، والاختبارات الفنية والتحليل,46,19,2,0,67
1693,2022,1,Najran Region Office,أنشطة المكاتب الرئيسية ، وألأنشطة الاستشارية في مجال الإدارة,12,2,0,0,14
1694,2022,1,Najran Region Office,أنشطة المكتبات ودور المحفوظات، والمتاحف والأنشطة الثقافية الأخرى,23,2,0,0,25
1695,2022,1,Najran Region Office,أنشطة المنظمات الدولية,2,0,0,0,2
1696,2022,1,Najran Region Office,أنشطة المنظمات ذات العضوية,17,0,0,0,17
1697,2022,1,Najran Region Office,أنشطة النشر,14,5,0,0,19
1698,2022,1,Najran Region Office,أنشطة تقديم الخدمات للمباني وتجميل المواقع,186,29,4,4,223
1699,2022,1,Najran Region Office,أنشطة جمع النفايات ومعالجتها وتصريفها ، واسترجاع المواد,4,0,0,0,4
1700,2022,1,Najran Region Office,أنشطة خدمات الأطعمة والمشروبات,1139,230,14,2,1385
1701,2022,1,Najran Region Office,أنشطة خدمات المعلومات,1,1,0,0,2
1702,2022,1,Najran Region Office,أنشطة خدمات دعم التعدين,4,3,0,0,7
1703,2022,1,Najran Region Office,أنشطة زراعة المحاصيل والإنتاج الحيواني والصيد والخدمات المتصلة,518,18,4,0,540
1704,2022,1,Najran Region Office,استخراج النفط الخام والغاز الطبيعي,1,0,0,0,1
1705,2022,1,Najran Region Office,الإدارة العامة والدفاع ؛ والضمان الاجتماعي الإلزامي,50,18,1,0,69
1706,2022,1,Najran Region Office,الإقامة,68,24,1,1,94
1707,2022,1,Najran Region Office,الأنشطة الإبداعية والفنون وأنشطة الترفيه,3,0,0,0,3
1708,2022,1,Najran Region Office,الأنشطة الأخرى للتعدين واستغلال المحاجر,7,0,0,1,8
1709,2022,1,Najran Region Office,الأنشطة الإدارية للمكاتب ، وأنشطة الدعم للمكاتب وغير ذلك من أنشطة الدعم للأعمال,30,1,0,0,31
1710,2022,1,Najran Region Office,الأنشطة الإيجارية,1198,79,2,2,1281
1711,2022,1,Najran Region Office,الأنشطة البيطرية,2,3,0,0,5
1712,2022,1,Najran Region Office,الأنشطة الرياضية وأنشطة التسلية والترفيه,26,9,0,1,36
1713,2022,1,Najran Region Office,الأنشطة العقارية,32,4,0,0,36
1714,2022,1,Najran Region Office,الأنشطة القانونية وأنشطة المحاسبة,4,0,0,0,4
1715,2022,1,Najran Region Office,الأنشطة المساعدة لأنشطة الخدمات المالية وأنشطة التأمين,0,1,0,0,1
1716,2022,1,Najran Region Office,الأنشطة المهنية والعلمية والتقنية الأخرى,20,0,0,0,20
1717,2022,1,Najran Region Office,الاتصالات,18,1,0,0,19
1718,2022,1,Najran Region Office,التخزين وأنشطة الدعم للنقل,225,72,2,0,299
1719,2022,1,Najran Region Office,التعليم,16,14,6,0,36
1720,2022,1,Najran Region Office,الحراجة وقطع الأخشاب,1,0,0,0,1
1721,2022,1,Najran Region Office,الرعاية مع الإقامة,4,1,0,0,5
1722,2022,1,Najran Region Office,الصحة البشرية,14,47,12,1,74
1723,2022,1,Najran Region Office,الصناعة التحويلية الأخرى,6,1,1,0,8
1724,2022,1,Najran Region Office,الطباعة واستنساخ وسائط الأعلام المسجّلة,10,2,0,0,12
1725,2022,1,Najran Region Office,النقل البري و النقل عبر الأنابيب,787,83,0,1,871
1726,2022,1,Najran Region Office,النقل الجوي,7,3,0,0,10
1727,2022,1,Najran Region Office,النقل المائي,12,0,0,0,12
1728,2022,1,Najran Region Office,الهندسة المدنية,13,3,2,3,21
1729,2022,1,Najran Region Office,تجارة التجزئة، باستثناء المركبات ذات المحركات والدراجات النارية,1479,356,23,3,1861
1730,2022,1,Najran Region Office,تجارة الجملة ، باستثناء المركبات ذات المحركات والدراجات النارية,459,96,11,1,567
1731,2022,1,Najran Region Office,تجارة الجملة والتجزئة ، وإصلاح المركبات ذات المحركات والدراجات النارية,533,96,3,0,632
1732,2022,1,Najran Region Office,تجميع المياه ومعالجتها وتوصيلها,19,4,0,0,23
1733,2022,1,Najran Region Office,تشييد المباني,2329,546,71,15,2961
1734,2022,1,Najran Region Office,تعدين الفحم والليغنيت,1,0,0,0,1
1735,2022,1,Najran Region Office,تعدين ركازات الفلزات,10,1,1,0,12
1736,2022,1,Najran Region Office,توصيل الكهرباء والغاز والبخار وتكييف الهواء,3,1,1,0,5
1737,2022,1,Najran Region Office,صناعة الآلات والمعدات غير المصنفة في موضع أخر,11,2,0,0,13
1738,2022,1,Najran Region Office,صناعة المركبات ذات المحركات والمركبات المقطورة ونصف المقطورة,15,2,0,0,17
1739,2022,1,Najran Region Office,صناعة معدات النقل الأخرى,8,3,0,0,11
1740,2022,1,Najran Region Office,صنع الأثاث,83,22,1,0,106
1741,2022,1,Najran Region Office,صنع الحواسيب والمنتجات الإلكترونية والبصرية,17,2,0,0,19
1742,2022,1,Najran Region Office,صُنع الخشب ومنتجات الخشب والفلين ، باستثناء الأثاث ، صُنع أصناف من القش ومواد الضفر,68,9,0,0,77
1743,2022,1,Najran Region Office,صنع الفلزات القاعدية,80,16,2,0,98
1744,2022,1,Najran Region Office,صُنع المشروبات,5,0,1,0,6
1745,2022,1,Najran Region Office,صنع المعدات الكهربائية,16,2,0,0,18
1746,2022,1,Najran Region Office,صُنع الملبوسات,295,29,0,0,324
1747,2022,1,Najran Region Office,صُنع المنتجات الجلدية والمنتجات ذات الصلة,4,0,0,0,4
1748,2022,1,Najran Region Office,صنع المنتجات الصيدلانية الأساسية والمستحضرات الصيدلانية,3,0,0,0,3
1749,2022,1,Najran Region Office,صُنع المنتجات الغذائية,122,29,1,0,152
1750,2022,1,Najran Region Office,صُنع المنسوجات,36,4,0,0,40
1751,2022,1,Najran Region Office,صُنع المواد الكيميائية والمنتجات الكيميائية,17,5,1,0,23
1752,2022,1,Najran Region Office,صُنع الورق ومنتجات الورق,12,4,1,0,17
1753,2022,1,Najran Region Office,صنع منتجات المطاط واللدائن,16,3,0,0,19
1754,2022,1,Najran Region Office,صنع منتجات المعادن اللافلزية الأخرى,59,17,8,1,85
1755,2022,1,Najran Region Office,صنع منتجات المعادن المشكلة ( باستثناء الآلات والمعدات ),148,23,4,0,175
1756,2022,1,Najran Region Office,صيد الأسماك وتربية المائيات,3,1,0,0,4
1757,2022,1,Najran Region Office,وكالات السفر ومشغّلو الجولات السياحية وخدمات الحجز والأنشطة المتصلة بها,6,2,0,0,8
1758,2022,1,Head Office,أنشطة التشييد المتخصصة,0,1,0,0,1
1759,2022,1,Head Office,أنشطة الخدمات الشخصية الأخرى,1,0,0,0,1
1760,2022,1,Head Office,أنشطة خدمات الأطعمة والمشروبات,4,2,0,0,6
1761,2022,1,Head Office,أنشطة زراعة المحاصيل والإنتاج الحيواني والصيد والخدمات المتصلة,1,2,0,0,3
1762,2022,1,Head Office,الأنشطة الإيجارية,2,0,0,0,2
1763,2022,1,Head Office,الأنشطة الرياضية وأنشطة التسلية والترفيه,1,0,0,0,1
1764,2022,1,Head Office,الأنشطة القانونية وأنشطة المحاسبة,1,0,0,0,1
1765,2022,1,Head Office,تجارة التجزئة، باستثناء المركبات ذات المحركات والدراجات النارية,2,1,0,0,3
1766,2022,1,Head Office,تجارة الجملة والتجزئة ، وإصلاح المركبات ذات المحركات والدراجات النارية,4,0,0,0,4
1767,2022,1,Head Office,تشييد المباني,2,0,0,0,2
1768,2022,1,Head Office,صُنع الملبوسات,1,0,0,0,1
1769,2022,1,Head Office,صُنع المنتجات الغذائية,0,1,0,0,1
1770,2022,1,Head Office,صُنع المنسوجات,1,0,0,0,1
1771,2022,1,Head Office,صيد الأسماك وتربية المائيات,0,1,0,0,1
1772,2022,1,Eastern Region Office,أبحاث الإعلان والسوق,143,34,1,0,178
1773,2022,1,Eastern Region Office,إصلاح أجهزة الحاسوب والسلع الشخصية والمنزلية,316,72,9,1,398
1774,2022,1,Eastern Region Office,إصلاح وتركيب الآلات والمعدات,230,85,8,2,325
1776,2022,1,Eastern Region Office,أنشطة الأمن والتحقيقات,24,18,11,4,57
1777,2022,1,Eastern Region Office,أنشطة الاستخدام,89,26,3,6,124
1779,2022,1,Eastern Region Office,أنشطة البرمجة الحاسوبية والخبرة الاستشارية وما يتصل بها من أنشطة,143,54,10,1,208
1781,2022,1,Eastern Region Office,أنشطة البريد ونقل الرسائل والطرود بواسطة مندوبين,17,3,0,0,20
1782,2022,1,Eastern Region Office,أنشطة التشييد المتخصصة,2647,996,117,19,3779
1783,2022,1,Eastern Region Office,أنشطة الخدمات الشخصية الأخرى,2230,411,29,3,2673
1784,2022,1,Eastern Region Office,أنشطة الخدمات المالية ، فيما عدا تمويل التأمين وصناديق المعاشات,45,14,6,1,66
1785,2022,1,Eastern Region Office,أنشطة العمل الاجتماعي، دون إقامة، لكبار السن وذوي الإعاقة,66,82,3,0,151
1786,2022,1,Eastern Region Office,أنشطة المعالجة وخدمات إدارة النفايات الأخرى,3,2,1,0,6
1787,2022,1,Eastern Region Office,أنشطة المعمارية والهندسية ، والاختبارات الفنية والتحليل,201,168,43,17,429
1788,2022,1,Eastern Region Office,أنشطة المكاتب الرئيسية ، وألأنشطة الاستشارية في مجال الإدارة,155,57,8,1,221
1789,2022,1,Eastern Region Office,أنشطة المكتبات ودور المحفوظات، والمتاحف والأنشطة الثقافية الأخرى,53,24,0,0,77
1791,2022,1,Eastern Region Office,أنشطة المنظمات ذات العضوية,22,4,1,0,27
1792,2022,1,Eastern Region Office,أنشطة النشر,34,11,0,0,45
1793,2022,1,Eastern Region Office,أنشطة تقديم الخدمات للمباني وتجميل المواقع,1412,770,127,40,2349
1794,2022,1,Eastern Region Office,أنشطة جمع النفايات ومعالجتها وتصريفها ، واسترجاع المواد,13,12,1,2,28
1795,2022,1,Eastern Region Office,أنشطة خدمات الأطعمة والمشروبات,3710,1581,183,23,5497
1796,2022,1,Eastern Region Office,أنشطة خدمات المعلومات,51,19,1,0,71
1797,2022,1,Eastern Region Office,أنشطة خدمات دعم التعدين,131,126,65,40,362
1798,2022,1,Eastern Region Office,أنشطة زراعة المحاصيل والإنتاج الحيواني والصيد والخدمات المتصلة,427,67,8,0,502
1800,2022,1,Eastern Region Office,الإدارة العامة والدفاع ؛ والضمان الاجتماعي الإلزامي,190,120,30,3,343
1801,2022,1,Eastern Region Office,الإقامة,169,157,23,1,350
1802,2022,1,Eastern Region Office,الأنشطة الإبداعية والفنون وأنشطة الترفيه,18,1,0,0,19
1803,2022,1,Eastern Region Office,الأنشطة الأخرى للتعدين واستغلال المحاجر,44,25,10,1,80
1804,2022,1,Eastern Region Office,الأنشطة الإدارية للمكاتب ، وأنشطة الدعم للمكاتب وغير ذلك من أنشطة الدعم للأعمال,203,34,2,1,240
1805,2022,1,Eastern Region Office,الأنشطة الإيجارية,668,142,23,7,840
1806,2022,1,Eastern Region Office,الأنشطة البيطرية,7,9,2,0,18
1807,2022,1,Eastern Region Office,الأنشطة الرياضية وأنشطة التسلية والترفيه,166,69,4,1,240
1808,2022,1,Eastern Region Office,الأنشطة العقارية,280,131,12,2,425
1809,2022,1,Eastern Region Office,الأنشطة القانونية وأنشطة المحاسبة,102,47,2,0,151
1810,2022,1,Eastern Region Office,الأنشطة المساعدة لأنشطة الخدمات المالية وأنشطة التأمين,11,14,2,1,28
1811,2022,1,Eastern Region Office,الأنشطة المهنية والعلمية والتقنية الأخرى,90,18,0,0,108
1815,2022,1,Eastern Region Office,التخزين وأنشطة الدعم للنقل,282,124,32,5,443
1816,2022,1,Eastern Region Office,التعليم,154,171,55,13,393
1817,2022,1,Eastern Region Office,الحراجة وقطع الأخشاب,2,1,0,0,3
1818,2022,1,Eastern Region Office,الرعاية مع الإقامة,8,6,1,0,15
1819,2022,1,Eastern Region Office,الصحة البشرية,91,151,63,25,330
1820,2022,1,Eastern Region Office,الصرف الصحي,11,7,1,1,20
1821,2022,1,Eastern Region Office,الصناعة التحويلية الأخرى,66,35,4,0,105
1822,2022,1,Eastern Region Office,الطباعة واستنساخ وسائط الأعلام المسجّلة,111,71,8,0,190
1823,2022,1,Eastern Region Office,النقل البري و النقل عبر الأنابيب,1003,317,68,23,1411
1824,2022,1,Eastern Region Office,النقل الجوي,75,72,34,6,187
1825,2022,1,Eastern Region Office,النقل المائي,29,18,6,0,53
1826,2022,1,Eastern Region Office,الهندسة المدنية,123,61,16,2,202
1827,2022,1,Eastern Region Office,تجارة التجزئة، باستثناء المركبات ذات المحركات والدراجات النارية,5614,1995,215,38,7862
1828,2022,1,Eastern Region Office,تجارة الجملة ، باستثناء المركبات ذات المحركات والدراجات النارية,2634,1410,223,49,4316
1829,2022,1,Eastern Region Office,تجارة الجملة والتجزئة ، وإصلاح المركبات ذات المحركات والدراجات النارية,2280,752,30,5,3067
1830,2022,1,Eastern Region Office,تجميع المياه ومعالجتها وتوصيلها,26,15,1,1,43
1831,2022,1,Eastern Region Office,تشييد المباني,4379,2635,537,204,7755
1832,2022,1,Eastern Region Office,تعدين الفحم والليغنيت,6,0,0,0,6
1833,2022,1,Eastern Region Office,تعدين ركازات الفلزات,85,80,12,2,179
1834,2022,1,Eastern Region Office,تمويل التأمين وإعادة التأمين وصناديق المعاشات التقاعدية باستثناء الضمان الاجتماعي الإلزامي,5,12,3,4,24
1835,2022,1,Eastern Region Office,توصيل الكهرباء والغاز والبخار وتكييف الهواء,36,54,15,4,109
1836,2022,1,Eastern Region Office,صناعة الآلات والمعدات غير المصنفة في موضع أخر,50,35,10,2,97
1837,2022,1,Eastern Region Office,صناعة المركبات ذات المحركات والمركبات المقطورة ونصف المقطورة,22,11,0,0,33
1838,2022,1,Eastern Region Office,صناعة معدات النقل الأخرى,22,12,6,1,41
1839,2022,1,Eastern Region Office,صنع الأثاث,302,117,8,1,428
1840,2022,1,Eastern Region Office,صنع الحواسيب والمنتجات الإلكترونية والبصرية,98,53,10,3,164
1841,2022,1,Eastern Region Office,صُنع الخشب ومنتجات الخشب والفلين ، باستثناء الأثاث ، صُنع أصناف من القش ومواد الضفر,256,160,21,8,445
1842,2022,1,Eastern Region Office,صنع الفلزات القاعدية,115,116,50,9,290
1843,2022,1,Eastern Region Office,صُنع المشروبات,19,15,3,1,38
1844,2022,1,Eastern Region Office,صنع المعدات الكهربائية,174,78,16,3,271
1845,2022,1,Eastern Region Office,صُنع الملبوسات,767,175,7,0,949
1846,2022,1,Eastern Region Office,صُنع المنتجات الجلدية والمنتجات ذات الصلة,5,1,0,0,6
1847,2022,1,Eastern Region Office,صنع المنتجات الصيدلانية الأساسية والمستحضرات الصيدلانية,3,4,3,0,10
1848,2022,1,Eastern Region Office,صُنع المنتجات الغذائية,445,213,50,9,717
1849,2022,1,Eastern Region Office,صُنع المنسوجات,146,87,8,0,241
1850,2022,1,Eastern Region Office,صُنع المواد الكيميائية والمنتجات الكيميائية,123,73,16,0,212
1851,2022,1,Eastern Region Office,صُنع الورق ومنتجات الورق,25,20,10,0,55
1852,2022,1,Eastern Region Office,صنع فحم الكوك والمنتجات النفطية المكررة,11,16,3,2,32
1854,2022,1,Eastern Region Office,صنع منتجات المطاط واللدائن,54,79,63,10,206
1855,2022,1,Eastern Region Office,صنع منتجات المعادن اللافلزية الأخرى,163,107,34,8,312
1856,2022,1,Eastern Region Office,صنع منتجات المعادن المشكلة ( باستثناء الآلات والمعدات ),393,243,69,17,722
1857,2022,1,Eastern Region Office,صيد الأسماك وتربية المائيات,247,168,5,0,420
1858,2022,1,Eastern Region Office,وكالات السفر ومشغّلو الجولات السياحية وخدمات الحجز والأنشطة المتصلة بها,80,36,6,0,122
1859,2022,1,Al-Ahsa Governorate Office,أبحاث الإعلان والسوق,21,3,0,0,24
1860,2022,1,Al-Ahsa Governorate Office,إصلاح أجهزة الحاسوب والسلع الشخصية والمنزلية,124,21,2,0,147
1861,2022,1,Al-Ahsa Governorate Office,إصلاح وتركيب الآلات والمعدات,61,5,0,0,66
1863,2022,1,Al-Ahsa Governorate Office,أنشطة الأمن والتحقيقات,3,3,2,0,8
1864,2022,1,Al-Ahsa Governorate Office,أنشطة الاستخدام,30,4,0,0,34
1866,2022,1,Al-Ahsa Governorate Office,أنشطة البرمجة الحاسوبية والخبرة الاستشارية وما يتصل بها من أنشطة,9,4,0,0,13
1869,2022,1,Al-Ahsa Governorate Office,أنشطة التشييد المتخصصة,908,209,10,3,1130
1870,2022,1,Al-Ahsa Governorate Office,أنشطة الخدمات الشخصية الأخرى,937,132,3,1,1073
1872,2022,1,Al-Ahsa Governorate Office,أنشطة العمل الاجتماعي، دون إقامة، لكبار السن وذوي الإعاقة,18,25,2,0,45
1874,2022,1,Al-Ahsa Governorate Office,أنشطة المعمارية والهندسية ، والاختبارات الفنية والتحليل,34,31,4,0,69
1875,2022,1,Al-Ahsa Governorate Office,أنشطة المكاتب الرئيسية ، وألأنشطة الاستشارية في مجال الإدارة,27,4,0,0,31
1876,2022,1,Al-Ahsa Governorate Office,أنشطة المكتبات ودور المحفوظات، والمتاحف والأنشطة الثقافية الأخرى,33,9,0,0,42
1877,2022,1,Al-Ahsa Governorate Office,أنشطة المنظمات ذات العضوية,6,1,1,0,8
1878,2022,1,Al-Ahsa Governorate Office,أنشطة النشر,4,1,0,0,5
1879,2022,1,Al-Ahsa Governorate Office,أنشطة تقديم الخدمات للمباني وتجميل المواقع,191,50,4,0,245
1881,2022,1,Al-Ahsa Governorate Office,أنشطة خدمات الأطعمة والمشروبات,1347,572,31,2,1952
1883,2022,1,Al-Ahsa Governorate Office,أنشطة خدمات دعم التعدين,8,13,0,0,21
1884,2022,1,Al-Ahsa Governorate Office,أنشطة زراعة المحاصيل والإنتاج الحيواني والصيد والخدمات المتصلة,331,49,6,0,386
1885,2022,1,Al-Ahsa Governorate Office,الإدارة العامة والدفاع ؛ والضمان الاجتماعي الإلزامي,27,14,1,0,42
1886,2022,1,Al-Ahsa Governorate Office,الإقامة,49,27,4,0,80
1887,2022,1,Al-Ahsa Governorate Office,الأنشطة الإبداعية والفنون وأنشطة الترفيه,6,1,0,0,7
1888,2022,1,Al-Ahsa Governorate Office,الأنشطة الأخرى للتعدين واستغلال المحاجر,17,3,0,0,20
1889,2022,1,Al-Ahsa Governorate Office,الأنشطة الإدارية للمكاتب ، وأنشطة الدعم للمكاتب وغير ذلك من أنشطة الدعم للأعمال,42,9,0,0,51
1890,2022,1,Al-Ahsa Governorate Office,الأنشطة الإيجارية,299,46,6,2,353
1892,2022,1,Al-Ahsa Governorate Office,الأنشطة الرياضية وأنشطة التسلية والترفيه,34,15,1,0,50
1893,2022,1,Al-Ahsa Governorate Office,الأنشطة العقارية,41,8,2,0,51
1894,2022,1,Al-Ahsa Governorate Office,الأنشطة القانونية وأنشطة المحاسبة,14,2,1,0,17
1898,2022,1,Al-Ahsa Governorate Office,التخزين وأنشطة الدعم للنقل,66,15,1,1,83
1899,2022,1,Al-Ahsa Governorate Office,التعليم,37,32,11,1,81
1903,2022,1,Al-Ahsa Governorate Office,الصناعة التحويلية الأخرى,20,3,0,0,23
1904,2022,1,Al-Ahsa Governorate Office,الطباعة واستنساخ وسائط الأعلام المسجّلة,35,7,1,1,44
1905,2022,1,Al-Ahsa Governorate Office,النقل البري و النقل عبر الأنابيب,242,44,7,2,295
1906,2022,1,Al-Ahsa Governorate Office,النقل الجوي,9,5,1,0,15
1908,2022,1,Al-Ahsa Governorate Office,الهندسة المدنية,19,7,1,0,27
1909,2022,1,Al-Ahsa Governorate Office,تجارة التجزئة، باستثناء المركبات ذات المحركات والدراجات النارية,1977,478,36,3,2494
1910,2022,1,Al-Ahsa Governorate Office,تجارة الجملة ، باستثناء المركبات ذات المحركات والدراجات النارية,550,144,10,3,707
1911,2022,1,Al-Ahsa Governorate Office,تجارة الجملة والتجزئة ، وإصلاح المركبات ذات المحركات والدراجات النارية,798,192,5,0,995
1912,2022,1,Al-Ahsa Governorate Office,تجميع المياه ومعالجتها وتوصيلها,10,9,0,0,19
1913,2022,1,Al-Ahsa Governorate Office,تشييد المباني,1583,665,58,17,2323
1915,2022,1,Al-Ahsa Governorate Office,تعدين ركازات الفلزات,26,8,1,1,36
1917,2022,1,Al-Ahsa Governorate Office,توصيل الكهرباء والغاز والبخار وتكييف الهواء,10,4,0,0,14
1918,2022,1,Al-Ahsa Governorate Office,صناعة الآلات والمعدات غير المصنفة في موضع أخر,16,6,1,0,23
1919,2022,1,Al-Ahsa Governorate Office,صناعة المركبات ذات المحركات والمركبات المقطورة ونصف المقطورة,9,1,0,0,10
1920,2022,1,Al-Ahsa Governorate Office,صناعة معدات النقل الأخرى,15,1,0,0,16
1921,2022,1,Al-Ahsa Governorate Office,صنع الأثاث,139,43,1,0,183
1922,2022,1,Al-Ahsa Governorate Office,صنع الحواسيب والمنتجات الإلكترونية والبصرية,87,21,1,0,109
1923,2022,1,Al-Ahsa Governorate Office,صُنع الخشب ومنتجات الخشب والفلين ، باستثناء الأثاث ، صُنع أصناف من القش ومواد الضفر,57,20,1,1,79
1924,2022,1,Al-Ahsa Governorate Office,صنع الفلزات القاعدية,54,15,0,0,69
1925,2022,1,Al-Ahsa Governorate Office,صُنع المشروبات,5,9,0,0,14
1926,2022,1,Al-Ahsa Governorate Office,صنع المعدات الكهربائية,47,24,2,0,73
1927,2022,1,Al-Ahsa Governorate Office,صُنع الملبوسات,503,68,2,0,573
1929,2022,1,Al-Ahsa Governorate Office,صنع المنتجات الصيدلانية الأساسية والمستحضرات الصيدلانية,3,3,0,0,6
1930,2022,1,Al-Ahsa Governorate Office,صُنع المنتجات الغذائية,240,87,14,4,345
1931,2022,1,Al-Ahsa Governorate Office,صُنع المنسوجات,36,9,1,0,46
1932,2022,1,Al-Ahsa Governorate Office,صُنع المواد الكيميائية والمنتجات الكيميائية,29,7,3,0,39
1933,2022,1,Al-Ahsa Governorate Office,صُنع الورق ومنتجات الورق,2,2,1,0,5
1934,2022,1,Al-Ahsa Governorate Office,صنع فحم الكوك والمنتجات النفطية المكررة,0,1,1,0,2
1935,2022,1,Al-Ahsa Governorate Office,صُنع منتجات التبغ,2,1,0,0,3
1936,2022,1,Al-Ahsa Governorate Office,صنع منتجات المطاط واللدائن,8,6,4,1,19
1937,2022,1,Al-Ahsa Governorate Office,صنع منتجات المعادن اللافلزية الأخرى,57,41,11,0,109
1938,2022,1,Al-Ahsa Governorate Office,صنع منتجات المعادن المشكلة ( باستثناء الآلات والمعدات ),102,60,7,1,170
1939,2022,1,Al-Ahsa Governorate Office,صيد الأسماك وتربية المائيات,10,4,1,0,15
1940,2022,1,Al-Ahsa Governorate Office,وكالات السفر ومشغّلو الجولات السياحية وخدمات الحجز والأنشطة المتصلة بها,18,4,0,0,22
1941,2022,1,Jubail Governorate Office,أبحاث الإعلان والسوق,19,7,0,0,26
1942,2022,1,Jubail Governorate Office,إصلاح أجهزة الحاسوب والسلع الشخصية والمنزلية,43,14,3,0,60
1943,2022,1,Jubail Governorate Office,إصلاح وتركيب الآلات والمعدات,48,30,6,0,84
1944,2022,1,Jubail Governorate Office,أنشطة أنتاج الأفلام والبرامج التلفزيونية والتسجيلات الصوتية و نشرالموسيقى,2,0,0,0,2
1946,2022,1,Jubail Governorate Office,أنشطة الاستخدام,11,2,0,1,14
1948,2022,1,Jubail Governorate Office,أنشطة البرمجة الحاسوبية والخبرة الاستشارية وما يتصل بها من أنشطة,10,6,0,0,16
1950,2022,1,Jubail Governorate Office,أنشطة التشييد المتخصصة,763,304,34,19,1120
1951,2022,1,Jubail Governorate Office,أنشطة الخدمات الشخصية الأخرى,481,86,6,0,573
1953,2022,1,Jubail Governorate Office,أنشطة العمل الاجتماعي، دون إقامة، لكبار السن وذوي الإعاقة,8,8,1,0,17
1955,2022,1,Jubail Governorate Office,أنشطة المعمارية والهندسية ، والاختبارات الفنية والتحليل,45,17,1,3,66
1956,2022,1,Jubail Governorate Office,أنشطة المكاتب الرئيسية ، وألأنشطة الاستشارية في مجال الإدارة,15,4,0,0,19
1957,2022,1,Jubail Governorate Office,أنشطة المكتبات ودور المحفوظات، والمتاحف والأنشطة الثقافية الأخرى,11,2,1,0,14
1959,2022,1,Jubail Governorate Office,أنشطة المنظمات ذات العضوية,2,3,1,0,6
1960,2022,1,Jubail Governorate Office,أنشطة النشر,31,4,1,0,36
1961,2022,1,Jubail Governorate Office,أنشطة تقديم الخدمات للمباني وتجميل المواقع,254,117,27,6,404
1963,2022,1,Jubail Governorate Office,أنشطة خدمات الأطعمة والمشروبات,952,328,17,2,1299
1965,2022,1,Jubail Governorate Office,أنشطة خدمات دعم التعدين,23,20,12,10,65
1966,2022,1,Jubail Governorate Office,أنشطة زراعة المحاصيل والإنتاج الحيواني والصيد والخدمات المتصلة,345,22,2,0,369
1967,2022,1,Jubail Governorate Office,الإدارة العامة والدفاع ؛ والضمان الاجتماعي الإلزامي,16,6,3,0,25
1968,2022,1,Jubail Governorate Office,الإقامة,44,27,6,0,77
1969,2022,1,Jubail Governorate Office,الأنشطة الأخرى للتعدين واستغلال المحاجر,4,6,3,2,15
1970,2022,1,Jubail Governorate Office,الأنشطة الإدارية للمكاتب ، وأنشطة الدعم للمكاتب وغير ذلك من أنشطة الدعم للأعمال,26,2,0,0,28
1971,2022,1,Jubail Governorate Office,الأنشطة الإيجارية,396,43,6,0,445
1973,2022,1,Jubail Governorate Office,الأنشطة الرياضية وأنشطة التسلية والترفيه,32,7,0,0,39
1974,2022,1,Jubail Governorate Office,الأنشطة العقارية,31,10,0,0,41
1977,2022,1,Jubail Governorate Office,الأنشطة المهنية والعلمية والتقنية الأخرى,20,3,0,0,23
1979,2022,1,Jubail Governorate Office,البحث والتطوير في المجال العلمي,2,0,0,0,2
1980,2022,1,Jubail Governorate Office,التخزين وأنشطة الدعم للنقل,59,17,3,1,80
1981,2022,1,Jubail Governorate Office,التعليم,28,17,12,0,57
1983,2022,1,Jubail Governorate Office,الرعاية مع الإقامة,3,3,0,0,6
1984,2022,1,Jubail Governorate Office,الصحة البشرية,20,18,14,6,58
1985,2022,1,Jubail Governorate Office,الصرف الصحي,2,2,1,1,6
1987,2022,1,Jubail Governorate Office,الطباعة واستنساخ وسائط الأعلام المسجّلة,15,10,1,0,26
1988,2022,1,Jubail Governorate Office,النقل البري و النقل عبر الأنابيب,237,69,4,0,310
1989,2022,1,Jubail Governorate Office,النقل الجوي,11,7,0,2,20
1990,2022,1,Jubail Governorate Office,النقل المائي,8,1,0,0,9
1991,2022,1,Jubail Governorate Office,الهندسة المدنية,34,24,6,0,64
1992,2022,1,Jubail Governorate Office,تجارة التجزئة، باستثناء المركبات ذات المحركات والدراجات النارية,1158,258,20,2,1438
1993,2022,1,Jubail Governorate Office,تجارة الجملة ، باستثناء المركبات ذات المحركات والدراجات النارية,551,178,20,7,756
1994,2022,1,Jubail Governorate Office,تجارة الجملة والتجزئة ، وإصلاح المركبات ذات المحركات والدراجات النارية,606,115,4,0,725
1995,2022,1,Jubail Governorate Office,تجميع المياه ومعالجتها وتوصيلها,1,7,0,0,8
1996,2022,1,Jubail Governorate Office,تشييد المباني,1257,707,137,41,2142
1998,2022,1,Jubail Governorate Office,تعدين ركازات الفلزات,46,12,1,1,60
2000,2022,1,Jubail Governorate Office,توصيل الكهرباء والغاز والبخار وتكييف الهواء,12,12,3,1,28
2001,2022,1,Jubail Governorate Office,صناعة الآلات والمعدات غير المصنفة في موضع أخر,14,17,4,0,35
2002,2022,1,Jubail Governorate Office,صناعة المركبات ذات المحركات والمركبات المقطورة ونصف المقطورة,11,2,0,0,13
2003,2022,1,Jubail Governorate Office,صناعة معدات النقل الأخرى,14,4,1,0,19
2004,2022,1,Jubail Governorate Office,صنع الأثاث,39,5,0,0,44
2006,2022,1,Jubail Governorate Office,صُنع الخشب ومنتجات الخشب والفلين ، باستثناء الأثاث ، صُنع أصناف من القش ومواد الضفر,68,14,4,0,86
2007,2022,1,Jubail Governorate Office,صنع الفلزات القاعدية,68,29,14,5,116
2008,2022,1,Jubail Governorate Office,صُنع المشروبات,2,1,0,0,3
2009,2022,1,Jubail Governorate Office,صنع المعدات الكهربائية,60,21,4,1,86
2010,2022,1,Jubail Governorate Office,صُنع الملبوسات,178,25,1,0,204
2013,2022,1,Jubail Governorate Office,صُنع المنتجات الغذائية,124,39,3,1,167
2014,2022,1,Jubail Governorate Office,صُنع المنسوجات,45,13,1,0,59
2015,2022,1,Jubail Governorate Office,صُنع المواد الكيميائية والمنتجات الكيميائية,26,21,18,3,68
2017,2022,1,Jubail Governorate Office,صنع فحم الكوك والمنتجات النفطية المكررة,1,5,0,1,7
2019,2022,1,Jubail Governorate Office,صنع منتجات المطاط واللدائن,13,23,10,10,56
2020,2022,1,Jubail Governorate Office,صنع منتجات المعادن اللافلزية الأخرى,50,28,11,2,91
2021,2022,1,Jubail Governorate Office,صنع منتجات المعادن المشكلة ( باستثناء الآلات والمعدات ),156,51,21,6,234
2022,2022,1,Jubail Governorate Office,صيد الأسماك وتربية المائيات,73,86,1,0,160
2024,2022,1,Al-Kharj Office,أبحاث الإعلان والسوق,14,5,0,0,19
2025,2022,1,Al-Kharj Office,إصلاح أجهزة الحاسوب والسلع الشخصية والمنزلية,88,9,0,0,97
2026,2022,1,Al-Kharj Office,إصلاح وتركيب الآلات والمعدات,42,3,1,0,46
2028,2022,1,Al-Kharj Office,أنشطة الأمن والتحقيقات,4,1,0,0,5
2029,2022,1,Al-Kharj Office,أنشطة الاستخدام,19,6,0,1,26
2030,2022,1,Al-Kharj Office,أنشطة البرمجة الحاسوبية والخبرة الاستشارية وما يتصل بها من أنشطة,4,1,0,0,5
2032,2022,1,Al-Kharj Office,أنشطة البريد ونقل الرسائل والطرود بواسطة مندوبين,3,0,0,0,3
2033,2022,1,Al-Kharj Office,أنشطة التشييد المتخصصة,1054,196,9,1,1260
2034,2022,1,Al-Kharj Office,أنشطة الخدمات الشخصية الأخرى,599,64,1,0,664
2035,2022,1,Al-Kharj Office,أنشطة الخدمات المالية ، فيما عدا تمويل التأمين وصناديق المعاشات,29,7,0,0,36
2036,2022,1,Al-Kharj Office,أنشطة العمل الاجتماعي، دون إقامة، لكبار السن وذوي الإعاقة,18,19,0,0,37
2037,2022,1,Al-Kharj Office,أنشطة المعمارية والهندسية ، والاختبارات الفنية والتحليل,29,7,1,1,38
2039,2022,1,Al-Kharj Office,أنشطة المكتبات ودور المحفوظات، والمتاحف والأنشطة الثقافية الأخرى,22,1,0,0,23
2042,2022,1,Al-Kharj Office,أنشطة تقديم الخدمات للمباني وتجميل المواقع,209,54,7,0,270
2044,2022,1,Al-Kharj Office,أنشطة خدمات الأطعمة والمشروبات,1091,261,10,0,1362
2047,2022,1,Al-Kharj Office,أنشطة زراعة المحاصيل والإنتاج الحيواني والصيد والخدمات المتصلة,1560,113,16,1,1690
2048,2022,1,Al-Kharj Office,الإدارة العامة والدفاع ؛ والضمان الاجتماعي الإلزامي,14,9,0,0,23
2049,2022,1,Al-Kharj Office,الإقامة,57,12,0,0,69
2050,2022,1,Al-Kharj Office,الأنشطة الإبداعية والفنون وأنشطة الترفيه,6,0,1,0,7
2051,2022,1,Al-Kharj Office,الأنشطة الأخرى للتعدين واستغلال المحاجر,18,3,0,0,21
2052,2022,1,Al-Kharj Office,الأنشطة الإدارية للمكاتب ، وأنشطة الدعم للمكاتب وغير ذلك من أنشطة الدعم للأعمال,45,6,0,0,51
2053,2022,1,Al-Kharj Office,الأنشطة الإيجارية,624,30,1,0,655
2055,2022,1,Al-Kharj Office,الأنشطة الرياضية وأنشطة التسلية والترفيه,31,11,0,0,42
2056,2022,1,Al-Kharj Office,الأنشطة العقارية,87,21,0,1,109
2059,2022,1,Al-Kharj Office,الأنشطة المهنية والعلمية والتقنية الأخرى,9,2,0,0,11
2060,2022,1,Al-Kharj Office,الاتصالات,15,1,1,0,17
2061,2022,1,Al-Kharj Office,التخزين وأنشطة الدعم للنقل,79,11,0,0,90
2062,2022,1,Al-Kharj Office,التعليم,29,15,7,0,51
2063,2022,1,Al-Kharj Office,الحراجة وقطع الأخشاب,1,0,0,0,1
2064,2022,1,Al-Kharj Office,الرعاية مع الإقامة,1,1,0,0,2
2065,2022,1,Al-Kharj Office,الصحة البشرية,19,23,8,2,52
2067,2022,1,Al-Kharj Office,الصناعة التحويلية الأخرى,10,6,1,0,17
2068,2022,1,Al-Kharj Office,الطباعة واستنساخ وسائط الأعلام المسجّلة,14,5,0,0,19
2069,2022,1,Al-Kharj Office,النقل البري و النقل عبر الأنابيب,912,109,6,0,1027
2070,2022,1,Al-Kharj Office,النقل الجوي,15,5,0,0,20
2071,2022,1,Al-Kharj Office,النقل المائي,13,0,0,0,13
2072,2022,1,Al-Kharj Office,الهندسة المدنية,8,6,0,2,16
2073,2022,1,Al-Kharj Office,تجارة التجزئة، باستثناء المركبات ذات المحركات والدراجات النارية,1692,299,14,1,2006
2074,2022,1,Al-Kharj Office,تجارة الجملة ، باستثناء المركبات ذات المحركات والدراجات النارية,752,216,17,0,985
2075,2022,1,Al-Kharj Office,تجارة الجملة والتجزئة ، وإصلاح المركبات ذات المحركات والدراجات النارية,823,127,3,0,953
2076,2022,1,Al-Kharj Office,تجميع المياه ومعالجتها وتوصيلها,10,2,0,1,13
2077,2022,1,Al-Kharj Office,تشييد المباني,1697,461,41,5,2204
2078,2022,1,Al-Kharj Office,تعدين ركازات الفلزات,16,1,0,0,17
2080,2022,1,Al-Kharj Office,صناعة الآلات والمعدات غير المصنفة في موضع أخر,20,7,1,0,28
2081,2022,1,Al-Kharj Office,صناعة المركبات ذات المحركات والمركبات المقطورة ونصف المقطورة,21,4,0,0,25
2082,2022,1,Al-Kharj Office,صناعة معدات النقل الأخرى,8,3,1,0,12
2083,2022,1,Al-Kharj Office,صنع الأثاث,65,20,1,1,87
2084,2022,1,Al-Kharj Office,صنع الحواسيب والمنتجات الإلكترونية والبصرية,34,5,0,0,39
2085,2022,1,Al-Kharj Office,صُنع الخشب ومنتجات الخشب والفلين ، باستثناء الأثاث ، صُنع أصناف من القش ومواد الضفر,74,17,1,0,92
2086,2022,1,Al-Kharj Office,صنع الفلزات القاعدية,109,26,4,0,139
2087,2022,1,Al-Kharj Office,صُنع المشروبات,9,7,5,7,28
2088,2022,1,Al-Kharj Office,صنع المعدات الكهربائية,46,10,1,0,57
2089,2022,1,Al-Kharj Office,صُنع الملبوسات,330,33,1,0,364
2090,2022,1,Al-Kharj Office,صُنع المنتجات الجلدية والمنتجات ذات الصلة,5,0,0,0,5
2092,2022,1,Al-Kharj Office,صُنع المنتجات الغذائية,177,64,8,0,249
2093,2022,1,Al-Kharj Office,صُنع المنسوجات,31,9,0,0,40
2094,2022,1,Al-Kharj Office,صُنع المواد الكيميائية والمنتجات الكيميائية,51,17,3,0,71
2095,2022,1,Al-Kharj Office,صُنع الورق ومنتجات الورق,9,3,5,0,17
2096,2022,1,Al-Kharj Office,صنع فحم الكوك والمنتجات النفطية المكررة,1,2,0,0,3
2097,2022,1,Al-Kharj Office,صُنع منتجات التبغ,1,0,0,0,1
2098,2022,1,Al-Kharj Office,صنع منتجات المطاط واللدائن,18,16,6,1,41
2099,2022,1,Al-Kharj Office,صنع منتجات المعادن اللافلزية الأخرى,57,37,12,0,106
2100,2022,1,Al-Kharj Office,صنع منتجات المعادن المشكلة ( باستثناء الآلات والمعدات ),116,31,4,1,152
2101,2022,1,Al-Kharj Office,صيد الأسماك وتربية المائيات,17,0,0,0,17
2103,2022,1,Dawadmi Governorate Office,أبحاث الإعلان والسوق,4,1,0,0,5
2104,2022,1,Dawadmi Governorate Office,إصلاح أجهزة الحاسوب والسلع الشخصية والمنزلية,32,12,0,0,44
2105,2022,1,Dawadmi Governorate Office,إصلاح وتركيب الآلات والمعدات,12,3,0,0,15
2108,2022,1,Dawadmi Governorate Office,أنشطة الاستخدام,9,1,0,0,10
2110,2022,1,Dawadmi Governorate Office,أنشطة البرمجة الحاسوبية والخبرة الاستشارية وما يتصل بها من أنشطة,5,0,0,0,5
2112,2022,1,Dawadmi Governorate Office,أنشطة البريد ونقل الرسائل والطرود بواسطة مندوبين,2,2,0,0,4
2113,2022,1,Dawadmi Governorate Office,أنشطة التشييد المتخصصة,721,111,7,1,840
2114,2022,1,Dawadmi Governorate Office,أنشطة الخدمات الشخصية الأخرى,368,30,2,0,400
2117,2022,1,Dawadmi Governorate Office,أنشطة المعمارية والهندسية ، والاختبارات الفنية والتحليل,24,6,0,0,30
2118,2022,1,Dawadmi Governorate Office,أنشطة المكاتب الرئيسية ، وألأنشطة الاستشارية في مجال الإدارة,6,0,0,0,6
2122,2022,1,Dawadmi Governorate Office,أنشطة تقديم الخدمات للمباني وتجميل المواقع,743,151,11,1,906
2124,2022,1,Dawadmi Governorate Office,أنشطة خدمات الأطعمة والمشروبات,624,78,4,0,706
2127,2022,1,Dawadmi Governorate Office,أنشطة زراعة المحاصيل والإنتاج الحيواني والصيد والخدمات المتصلة,1497,36,0,0,1533
2129,2022,1,Dawadmi Governorate Office,الإقامة,36,7,1,0,44
2131,2022,1,Dawadmi Governorate Office,الأنشطة الأخرى للتعدين واستغلال المحاجر,3,2,0,0,5
2132,2022,1,Dawadmi Governorate Office,الأنشطة الإدارية للمكاتب ، وأنشطة الدعم للمكاتب وغير ذلك من أنشطة الدعم للأعمال,14,0,0,0,14
2133,2022,1,Dawadmi Governorate Office,الأنشطة الإيجارية,1034,18,1,1,1054
2135,2022,1,Dawadmi Governorate Office,الأنشطة الرياضية وأنشطة التسلية والترفيه,23,4,0,0,27
2136,2022,1,Dawadmi Governorate Office,الأنشطة العقارية,31,6,0,0,37
2141,2022,1,Dawadmi Governorate Office,التخزين وأنشطة الدعم للنقل,58,4,0,0,62
2142,2022,1,Dawadmi Governorate Office,التعليم,16,13,2,0,31
2144,2022,1,Dawadmi Governorate Office,الصحة البشرية,18,8,2,0,28
2148,2022,1,Dawadmi Governorate Office,النقل البري و النقل عبر الأنابيب,738,66,4,0,808
2149,2022,1,Dawadmi Governorate Office,النقل الجوي,13,3,0,0,16
2150,2022,1,Dawadmi Governorate Office,النقل المائي,3,0,0,0,3
2151,2022,1,Dawadmi Governorate Office,الهندسة المدنية,3,1,2,0,6
2152,2022,1,Dawadmi Governorate Office,تجارة التجزئة، باستثناء المركبات ذات المحركات والدراجات النارية,664,88,2,0,754
2153,2022,1,Dawadmi Governorate Office,تجارة الجملة ، باستثناء المركبات ذات المحركات والدراجات النارية,299,70,4,0,373
2154,2022,1,Dawadmi Governorate Office,تجارة الجملة والتجزئة ، وإصلاح المركبات ذات المحركات والدراجات النارية,580,63,5,1,649
2156,2022,1,Dawadmi Governorate Office,تشييد المباني,818,169,19,3,1009
2157,2022,1,Dawadmi Governorate Office,تعدين ركازات الفلزات,6,0,0,0,6
2159,2022,1,Dawadmi Governorate Office,صناعة الآلات والمعدات غير المصنفة في موضع أخر,6,1,0,0,7
2160,2022,1,Dawadmi Governorate Office,صناعة المركبات ذات المحركات والمركبات المقطورة ونصف المقطورة,11,0,0,0,11
2162,2022,1,Dawadmi Governorate Office,صنع الأثاث,47,7,0,0,54
2164,2022,1,Dawadmi Governorate Office,صُنع الخشب ومنتجات الخشب والفلين ، باستثناء الأثاث ، صُنع أصناف من القش ومواد الضفر,55,8,2,0,65
2165,2022,1,Dawadmi Governorate Office,صنع الفلزات القاعدية,57,8,0,0,65
2166,2022,1,Dawadmi Governorate Office,صُنع المشروبات,6,1,0,0,7
2167,2022,1,Dawadmi Governorate Office,صنع المعدات الكهربائية,27,2,0,0,29
2168,2022,1,Dawadmi Governorate Office,صُنع الملبوسات,178,20,1,0,199
2171,2022,1,Dawadmi Governorate Office,صُنع المنتجات الغذائية,91,12,0,0,103
2172,2022,1,Dawadmi Governorate Office,صُنع المنسوجات,22,5,1,0,28
2173,2022,1,Dawadmi Governorate Office,صُنع المواد الكيميائية والمنتجات الكيميائية,14,2,0,0,16
2176,2022,1,Dawadmi Governorate Office,صنع منتجات المعادن اللافلزية الأخرى,53,21,1,0,75
2178,2022,1,Dawadmi Governorate Office,صيد الأسماك وتربية المائيات,16,0,0,0,16
2180,2022,1,Taif Governorate Office,أبحاث الإعلان والسوق,24,3,0,0,27
2181,2022,1,Taif Governorate Office,إصلاح أجهزة الحاسوب والسلع الشخصية والمنزلية,164,16,0,0,180
2182,2022,1,Taif Governorate Office,إصلاح وتركيب الآلات والمعدات,67,4,0,0,71
2183,2022,1,Taif Governorate Office,أنشطة أنتاج الأفلام والبرامج التلفزيونية والتسجيلات الصوتية و نشرالموسيقى,18,3,0,0,21
2185,2022,1,Taif Governorate Office,أنشطة الاستخدام,24,2,0,0,26
2186,2022,1,Taif Governorate Office,أنشطة الاسر المعيشية التي تستخدم أفراداً للعمل المنزلي,3,0,0,0,3
2190,2022,1,Taif Governorate Office,أنشطة التشييد المتخصصة,1197,176,1,0,1374
2191,2022,1,Taif Governorate Office,أنشطة الخدمات الشخصية الأخرى,1207,73,0,0,1280
2195,2022,1,Taif Governorate Office,أنشطة المعمارية والهندسية ، والاختبارات الفنية والتحليل,180,79,3,0,262
2196,2022,1,Taif Governorate Office,أنشطة المكاتب الرئيسية ، وألأنشطة الاستشارية في مجال الإدارة,12,4,0,0,16
2197,2022,1,Taif Governorate Office,أنشطة المكتبات ودور المحفوظات، والمتاحف والأنشطة الثقافية الأخرى,36,8,2,0,46
2201,2022,1,Taif Governorate Office,أنشطة تقديم الخدمات للمباني وتجميل المواقع,279,48,8,2,337
2203,2022,1,Taif Governorate Office,أنشطة خدمات الأطعمة والمشروبات,2500,557,33,0,3090
2204,2022,1,Taif Governorate Office,أنشطة خدمات المعلومات,8,2,0,0,10
2206,2022,1,Taif Governorate Office,أنشطة زراعة المحاصيل والإنتاج الحيواني والصيد والخدمات المتصلة,746,23,2,0,771
2207,2022,1,Taif Governorate Office,الإدارة العامة والدفاع ؛ والضمان الاجتماعي الإلزامي,18,7,4,0,29
2208,2022,1,Taif Governorate Office,الإقامة,182,51,7,0,240
2210,2022,1,Taif Governorate Office,الأنشطة الأخرى للتعدين واستغلال المحاجر,9,1,0,0,10
2211,2022,1,Taif Governorate Office,الأنشطة الإدارية للمكاتب ، وأنشطة الدعم للمكاتب وغير ذلك من أنشطة الدعم للأعمال,66,4,0,0,70
2212,2022,1,Taif Governorate Office,الأنشطة الإيجارية,1069,50,2,0,1121
2213,2022,1,Taif Governorate Office,الأنشطة البيطرية,21,4,0,0,25
2214,2022,1,Taif Governorate Office,الأنشطة الرياضية وأنشطة التسلية والترفيه,62,24,1,0,87
2215,2022,1,Taif Governorate Office,الأنشطة العقارية,74,12,2,0,88
2217,2022,1,Taif Governorate Office,الأنشطة المهنية والعلمية والتقنية الأخرى,43,6,0,0,49
2218,2022,1,Taif Governorate Office,الاتصالات,32,0,0,0,32
2220,2022,1,Taif Governorate Office,التخزين وأنشطة الدعم للنقل,84,6,2,0,92
2221,2022,1,Taif Governorate Office,التعليم,36,30,19,0,85
2223,2022,1,Taif Governorate Office,الصحة البشرية,29,101,14,2,146
2224,2022,1,Taif Governorate Office,الصناعة التحويلية الأخرى,31,14,1,1,47
2225,2022,1,Taif Governorate Office,الطباعة واستنساخ وسائط الأعلام المسجّلة,29,11,0,0,40
2226,2022,1,Taif Governorate Office,النقل البري و النقل عبر الأنابيب,713,85,1,0,799
2228,2022,1,Taif Governorate Office,النقل المائي,5,2,0,0,7
2229,2022,1,Taif Governorate Office,الهندسة المدنية,17,3,1,0,21
2230,2022,1,Taif Governorate Office,تجارة التجزئة، باستثناء المركبات ذات المحركات والدراجات النارية,3002,461,22,0,3485
2231,2022,1,Taif Governorate Office,تجارة الجملة ، باستثناء المركبات ذات المحركات والدراجات النارية,937,168,18,0,1123
2232,2022,1,Taif Governorate Office,تجارة الجملة والتجزئة ، وإصلاح المركبات ذات المحركات والدراجات النارية,1483,178,5,0,1666
2233,2022,1,Taif Governorate Office,تجميع المياه ومعالجتها وتوصيلها,143,19,2,0,164
2234,2022,1,Taif Governorate Office,تشييد المباني,2348,498,40,2,2888
2235,2022,1,Taif Governorate Office,تعدين الفحم والليغنيت,3,0,0,0,3
2236,2022,1,Taif Governorate Office,تعدين ركازات الفلزات,21,2,0,0,23
2239,2022,1,Taif Governorate Office,صناعة الآلات والمعدات غير المصنفة في موضع أخر,18,1,0,0,19
2240,2022,1,Taif Governorate Office,صناعة المركبات ذات المحركات والمركبات المقطورة ونصف المقطورة,32,2,0,0,34
2241,2022,1,Taif Governorate Office,صناعة معدات النقل الأخرى,5,2,0,0,7
2242,2022,1,Taif Governorate Office,صنع الأثاث,182,28,3,0,213
2243,2022,1,Taif Governorate Office,صنع الحواسيب والمنتجات الإلكترونية والبصرية,107,13,0,0,120
2244,2022,1,Taif Governorate Office,صُنع الخشب ومنتجات الخشب والفلين ، باستثناء الأثاث ، صُنع أصناف من القش ومواد الضفر,188,26,0,0,214
2245,2022,1,Taif Governorate Office,صنع الفلزات القاعدية,109,25,2,0,136
2247,2022,1,Taif Governorate Office,صنع المعدات الكهربائية,76,16,0,1,93
2248,2022,1,Taif Governorate Office,صُنع الملبوسات,523,50,2,0,575
2251,2022,1,Taif Governorate Office,صُنع المنتجات الغذائية,356,95,4,1,456
2252,2022,1,Taif Governorate Office,صُنع المنسوجات,63,22,0,0,85
2253,2022,1,Taif Governorate Office,صُنع المواد الكيميائية والمنتجات الكيميائية,60,11,3,0,74
2254,2022,1,Taif Governorate Office,صُنع الورق ومنتجات الورق,7,5,0,0,12
2256,2022,1,Taif Governorate Office,صنع منتجات المطاط واللدائن,19,7,0,0,26
2257,2022,1,Taif Governorate Office,صنع منتجات المعادن اللافلزية الأخرى,87,24,1,1,113
2258,2022,1,Taif Governorate Office,صنع منتجات المعادن المشكلة ( باستثناء الآلات والمعدات ),516,60,0,0,576
2259,2022,1,Taif Governorate Office,صيد الأسماك وتربية المائيات,12,1,0,0,13
2261,2022,1,Bishah Governorate Office,أبحاث الإعلان والسوق,3,0,0,0,3
2262,2022,1,Bishah Governorate Office,إصلاح أجهزة الحاسوب والسلع الشخصية والمنزلية,43,5,0,0,48
2264,2022,1,Bishah Governorate Office,أنشطة الاستخدام,8,1,0,0,9
2266,2022,1,Bishah Governorate Office,أنشطة البرمجة الحاسوبية والخبرة الاستشارية وما يتصل بها من أنشطة,2,0,0,0,2
2267,2022,1,Bishah Governorate Office,أنشطة التشييد المتخصصة,572,67,1,0,640
2268,2022,1,Bishah Governorate Office,أنشطة الخدمات الشخصية الأخرى,226,20,0,0,246
2270,2022,1,Bishah Governorate Office,أنشطة العمل الاجتماعي، دون إقامة، لكبار السن وذوي الإعاقة,27,9,0,0,36
2271,2022,1,Bishah Governorate Office,أنشطة المعمارية والهندسية ، والاختبارات الفنية والتحليل,22,4,2,0,28
2273,2022,1,Bishah Governorate Office,أنشطة المكتبات ودور المحفوظات، والمتاحف والأنشطة الثقافية الأخرى,9,3,0,0,12
2276,2022,1,Bishah Governorate Office,أنشطة تقديم الخدمات للمباني وتجميل المواقع,48,13,0,0,61
2277,2022,1,Bishah Governorate Office,أنشطة جمع النفايات ومعالجتها وتصريفها ، واسترجاع المواد,1,0,0,0,1
2278,2022,1,Bishah Governorate Office,أنشطة خدمات الأطعمة والمشروبات,566,93,2,0,661
2280,2022,1,Bishah Governorate Office,أنشطة خدمات دعم التعدين,8,0,0,0,8
2281,2022,1,Bishah Governorate Office,أنشطة زراعة المحاصيل والإنتاج الحيواني والصيد والخدمات المتصلة,467,15,0,0,482
2282,2022,1,Bishah Governorate Office,الإدارة العامة والدفاع ؛ والضمان الاجتماعي الإلزامي,4,4,0,0,8
2283,2022,1,Bishah Governorate Office,الإقامة,31,12,1,0,44
2284,2022,1,Bishah Governorate Office,الأنشطة الأخرى للتعدين واستغلال المحاجر,7,4,1,0,12
2285,2022,1,Bishah Governorate Office,الأنشطة الإدارية للمكاتب ، وأنشطة الدعم للمكاتب وغير ذلك من أنشطة الدعم للأعمال,15,3,0,0,18
2286,2022,1,Bishah Governorate Office,الأنشطة الإيجارية,257,7,1,0,265
2289,2022,1,Bishah Governorate Office,الأنشطة العقارية,6,3,1,0,10
2291,2022,1,Bishah Governorate Office,الأنشطة المهنية والعلمية والتقنية الأخرى,4,0,0,0,4
2292,2022,1,Bishah Governorate Office,الاتصالات,7,2,0,0,9
2294,2022,1,Bishah Governorate Office,التخزين وأنشطة الدعم للنقل,35,4,0,0,39
2295,2022,1,Bishah Governorate Office,التعليم,15,7,1,0,23
2297,2022,1,Bishah Governorate Office,الصحة البشرية,8,13,2,0,23
2298,2022,1,Bishah Governorate Office,الصناعة التحويلية الأخرى,2,1,0,0,3
2300,2022,1,Bishah Governorate Office,النقل البري و النقل عبر الأنابيب,309,28,1,0,338
2303,2022,1,Bishah Governorate Office,الهندسة المدنية,5,2,0,0,7
2304,2022,1,Bishah Governorate Office,تجارة التجزئة، باستثناء المركبات ذات المحركات والدراجات النارية,926,163,6,0,1095
2305,2022,1,Bishah Governorate Office,تجارة الجملة ، باستثناء المركبات ذات المحركات والدراجات النارية,211,70,1,1,283
2306,2022,1,Bishah Governorate Office,تجارة الجملة والتجزئة ، وإصلاح المركبات ذات المحركات والدراجات النارية,423,35,3,0,461
2308,2022,1,Bishah Governorate Office,تشييد المباني,806,169,7,3,985
2310,2022,1,Bishah Governorate Office,توصيل الكهرباء والغاز والبخار وتكييف الهواء,6,2,0,0,8
2312,2022,1,Bishah Governorate Office,صناعة المركبات ذات المحركات والمركبات المقطورة ونصف المقطورة,8,0,0,0,8
2313,2022,1,Bishah Governorate Office,صناعة معدات النقل الأخرى,2,0,0,0,2
2314,2022,1,Bishah Governorate Office,صنع الأثاث,48,13,0,0,61
2315,2022,1,Bishah Governorate Office,صنع الحواسيب والمنتجات الإلكترونية والبصرية,36,4,0,0,40
2317,2022,1,Bishah Governorate Office,صنع الفلزات القاعدية,34,5,0,0,39
2319,2022,1,Bishah Governorate Office,صنع المعدات الكهربائية,20,0,0,0,20
2320,2022,1,Bishah Governorate Office,صُنع الملبوسات,125,17,1,0,143
2321,2022,1,Bishah Governorate Office,صُنع المنتجات الجلدية والمنتجات ذات الصلة,4,1,0,0,5
2322,2022,1,Bishah Governorate Office,صنع المنتجات الصيدلانية الأساسية والمستحضرات الصيدلانية,1,1,0,0,2
2323,2022,1,Bishah Governorate Office,صُنع المنتجات الغذائية,88,13,0,0,101
2325,2022,1,Bishah Governorate Office,صُنع المواد الكيميائية والمنتجات الكيميائية,20,2,0,0,22
2328,2022,1,Bishah Governorate Office,صنع منتجات المعادن اللافلزية الأخرى,28,10,3,1,42
2329,2022,1,Bishah Governorate Office,صنع منتجات المعادن المشكلة ( باستثناء الآلات والمعدات ),94,10,1,0,105
2330,2022,1,Bishah Governorate Office,صيد الأسماك وتربية المائيات,11,0,0,0,11
2332,2022,1,Hafr Al-Batin Governorate Office,أبحاث الإعلان والسوق,12,4,0,0,16
2333,2022,1,Hafr Al-Batin Governorate Office,إصلاح أجهزة الحاسوب والسلع الشخصية والمنزلية,55,4,0,0,59
2334,2022,1,Hafr Al-Batin Governorate Office,إصلاح وتركيب الآلات والمعدات,27,0,0,0,27
2336,2022,1,Hafr Al-Batin Governorate Office,أنشطة الأمن والتحقيقات,1,2,1,0,4
2337,2022,1,Hafr Al-Batin Governorate Office,أنشطة الاستخدام,16,8,1,1,26
2341,2022,1,Hafr Al-Batin Governorate Office,أنشطة التشييد المتخصصة,679,134,10,2,825
2342,2022,1,Hafr Al-Batin Governorate Office,أنشطة الخدمات الشخصية الأخرى,541,49,1,0,591
2345,2022,1,Hafr Al-Batin Governorate Office,أنشطة المعمارية والهندسية ، والاختبارات الفنية والتحليل,36,12,2,0,50
2346,2022,1,Hafr Al-Batin Governorate Office,أنشطة المكاتب الرئيسية ، وألأنشطة الاستشارية في مجال الإدارة,14,2,0,0,16
2347,2022,1,Hafr Al-Batin Governorate Office,أنشطة المكتبات ودور المحفوظات، والمتاحف والأنشطة الثقافية الأخرى,9,4,0,0,13
2350,2022,1,Hafr Al-Batin Governorate Office,أنشطة تقديم الخدمات للمباني وتجميل المواقع,119,24,2,0,145
2352,2022,1,Hafr Al-Batin Governorate Office,أنشطة خدمات الأطعمة والمشروبات,1438,298,18,1,1755
2355,2022,1,Hafr Al-Batin Governorate Office,أنشطة زراعة المحاصيل والإنتاج الحيواني والصيد والخدمات المتصلة,193,3,0,0,196
2356,2022,1,Hafr Al-Batin Governorate Office,الإدارة العامة والدفاع ؛ والضمان الاجتماعي الإلزامي,7,6,0,0,13
2357,2022,1,Hafr Al-Batin Governorate Office,الإقامة,43,15,1,0,59
2358,2022,1,Hafr Al-Batin Governorate Office,الأنشطة الأخرى للتعدين واستغلال المحاجر,10,2,0,0,12
2359,2022,1,Hafr Al-Batin Governorate Office,الأنشطة الإدارية للمكاتب ، وأنشطة الدعم للمكاتب وغير ذلك من أنشطة الدعم للأعمال,27,4,0,0,31
2360,2022,1,Hafr Al-Batin Governorate Office,الأنشطة الإيجارية,483,25,0,0,508
2361,2022,1,Hafr Al-Batin Governorate Office,الأنشطة البيطرية,7,1,0,0,8
2362,2022,1,Hafr Al-Batin Governorate Office,الأنشطة الرياضية وأنشطة التسلية والترفيه,18,6,0,0,24
2364,2022,1,Hafr Al-Batin Governorate Office,الأنشطة القانونية وأنشطة المحاسبة,4,0,0,0,4
2366,2022,1,Hafr Al-Batin Governorate Office,الأنشطة المهنية والعلمية والتقنية الأخرى,8,3,1,0,12
2367,2022,1,Hafr Al-Batin Governorate Office,الاتصالات,9,0,0,0,9
2368,2022,1,Hafr Al-Batin Governorate Office,التخزين وأنشطة الدعم للنقل,83,26,1,0,110
2369,2022,1,Hafr Al-Batin Governorate Office,التعليم,17,24,7,1,49
2370,2022,1,Hafr Al-Batin Governorate Office,الصحة البشرية,19,23,9,1,52
2371,2022,1,Hafr Al-Batin Governorate Office,الصناعة التحويلية الأخرى,5,1,0,0,6
2373,2022,1,Hafr Al-Batin Governorate Office,النقل البري و النقل عبر الأنابيب,414,69,5,2,490
2374,2022,1,Hafr Al-Batin Governorate Office,النقل الجوي,7,5,0,0,12
2376,2022,1,Hafr Al-Batin Governorate Office,الهندسة المدنية,2,1,0,0,3
2377,2022,1,Hafr Al-Batin Governorate Office,تجارة التجزئة، باستثناء المركبات ذات المحركات والدراجات النارية,1206,209,9,2,1426
2378,2022,1,Hafr Al-Batin Governorate Office,تجارة الجملة ، باستثناء المركبات ذات المحركات والدراجات النارية,365,76,7,1,449
2379,2022,1,Hafr Al-Batin Governorate Office,تجارة الجملة والتجزئة ، وإصلاح المركبات ذات المحركات والدراجات النارية,696,121,6,0,823
2380,2022,1,Hafr Al-Batin Governorate Office,تجميع المياه ومعالجتها وتوصيلها,4,2,0,0,6
2381,2022,1,Hafr Al-Batin Governorate Office,تشييد المباني,1304,308,36,2,1650
2382,2022,1,Hafr Al-Batin Governorate Office,تعدين الفحم والليغنيت,1,0,0,0,1
2383,2022,1,Hafr Al-Batin Governorate Office,تعدين ركازات الفلزات,46,7,0,0,53
2385,2022,1,Hafr Al-Batin Governorate Office,صناعة الآلات والمعدات غير المصنفة في موضع أخر,14,1,0,0,15
2386,2022,1,Hafr Al-Batin Governorate Office,صناعة المركبات ذات المحركات والمركبات المقطورة ونصف المقطورة,16,1,0,0,17
2387,2022,1,Hafr Al-Batin Governorate Office,صناعة معدات النقل الأخرى,8,0,0,0,8
2388,2022,1,Hafr Al-Batin Governorate Office,صنع الأثاث,100,21,0,0,121
2389,2022,1,Hafr Al-Batin Governorate Office,صنع الحواسيب والمنتجات الإلكترونية والبصرية,16,3,0,0,19
2390,2022,1,Hafr Al-Batin Governorate Office,صُنع الخشب ومنتجات الخشب والفلين ، باستثناء الأثاث ، صُنع أصناف من القش ومواد الضفر,59,10,0,0,69
2391,2022,1,Hafr Al-Batin Governorate Office,صنع الفلزات القاعدية,25,10,0,0,35
2392,2022,1,Hafr Al-Batin Governorate Office,صُنع المشروبات,9,3,3,0,15
2393,2022,1,Hafr Al-Batin Governorate Office,صنع المعدات الكهربائية,70,11,0,0,81
2394,2022,1,Hafr Al-Batin Governorate Office,صُنع الملبوسات,298,38,0,0,336
2397,2022,1,Hafr Al-Batin Governorate Office,صُنع المنتجات الغذائية,120,37,7,1,165
2398,2022,1,Hafr Al-Batin Governorate Office,صُنع المنسوجات,59,13,1,0,73
2399,2022,1,Hafr Al-Batin Governorate Office,صُنع المواد الكيميائية والمنتجات الكيميائية,24,7,0,0,31
2400,2022,1,Hafr Al-Batin Governorate Office,صُنع الورق ومنتجات الورق,4,4,0,0,8
2403,2022,1,Hafr Al-Batin Governorate Office,صنع منتجات المطاط واللدائن,10,5,1,0,16
2404,2022,1,Hafr Al-Batin Governorate Office,صنع منتجات المعادن اللافلزية الأخرى,98,31,8,0,137
2405,2022,1,Hafr Al-Batin Governorate Office,صنع منتجات المعادن المشكلة ( باستثناء الآلات والمعدات ),121,32,2,0,155
2406,2022,1,Hafr Al-Batin Governorate Office,صيد الأسماك وتربية المائيات,8,0,0,0,8
2408,2022,1,Yanbu Governorate Office,أبحاث الإعلان والسوق,12,0,0,0,12
2409,2022,1,Yanbu Governorate Office,إصلاح أجهزة الحاسوب والسلع الشخصية والمنزلية,65,7,0,0,72
2410,2022,1,Yanbu Governorate Office,إصلاح وتركيب الآلات والمعدات,22,5,0,0,27
2411,2022,1,Yanbu Governorate Office,أنشطة أنتاج الأفلام والبرامج التلفزيونية والتسجيلات الصوتية و نشرالموسيقى,6,0,0,0,6
2412,2022,1,Yanbu Governorate Office,أنشطة الاستخدام,11,1,0,0,12
2416,2022,1,Yanbu Governorate Office,أنشطة التشييد المتخصصة,558,120,9,0,687
2417,2022,1,Yanbu Governorate Office,أنشطة الخدمات الشخصية الأخرى,346,45,4,0,395
2419,2022,1,Yanbu Governorate Office,أنشطة العمل الاجتماعي، دون إقامة، لكبار السن وذوي الإعاقة,24,8,0,0,32
2420,2022,1,Yanbu Governorate Office,أنشطة المعمارية والهندسية ، والاختبارات الفنية والتحليل,28,5,0,1,34
2421,2022,1,Yanbu Governorate Office,أنشطة المكاتب الرئيسية ، وألأنشطة الاستشارية في مجال الإدارة,7,1,0,0,8
2426,2022,1,Yanbu Governorate Office,أنشطة تقديم الخدمات للمباني وتجميل المواقع,114,48,0,1,163
2427,2022,1,Yanbu Governorate Office,أنشطة خدمات الأطعمة والمشروبات,884,243,10,0,1137
2428,2022,1,Yanbu Governorate Office,أنشطة خدمات المعلومات,3,2,0,0,5
2429,2022,1,Yanbu Governorate Office,أنشطة خدمات دعم التعدين,3,4,0,2,9
2430,2022,1,Yanbu Governorate Office,أنشطة زراعة المحاصيل والإنتاج الحيواني والصيد والخدمات المتصلة,151,9,0,0,160
2431,2022,1,Yanbu Governorate Office,الإدارة العامة والدفاع ؛ والضمان الاجتماعي الإلزامي,5,13,0,0,18
2432,2022,1,Yanbu Governorate Office,الإقامة,50,19,4,0,73
2435,2022,1,Yanbu Governorate Office,الأنشطة الإدارية للمكاتب ، وأنشطة الدعم للمكاتب وغير ذلك من أنشطة الدعم للأعمال,16,0,0,0,16
2436,2022,1,Yanbu Governorate Office,الأنشطة الإيجارية,178,14,1,0,193
2437,2022,1,Yanbu Governorate Office,الأنشطة الرياضية وأنشطة التسلية والترفيه,22,7,1,0,30
2438,2022,1,Yanbu Governorate Office,الأنشطة العقارية,16,1,0,0,17
2440,2022,1,Yanbu Governorate Office,الأنشطة المهنية والعلمية والتقنية الأخرى,10,1,0,0,11
2443,2022,1,Yanbu Governorate Office,التخزين وأنشطة الدعم للنقل,43,12,2,1,58
2444,2022,1,Yanbu Governorate Office,التعليم,22,15,9,0,46
2446,2022,1,Yanbu Governorate Office,الصحة البشرية,16,21,4,2,43
2450,2022,1,Yanbu Governorate Office,النقل البري و النقل عبر الأنابيب,295,45,10,0,350
2451,2022,1,Yanbu Governorate Office,النقل الجوي,7,2,0,0,9
2452,2022,1,Yanbu Governorate Office,النقل المائي,9,1,1,0,11
2453,2022,1,Yanbu Governorate Office,الهندسة المدنية,6,6,0,0,12
2454,2022,1,Yanbu Governorate Office,تجارة التجزئة، باستثناء المركبات ذات المحركات والدراجات النارية,990,201,11,2,1204
2455,2022,1,Yanbu Governorate Office,تجارة الجملة ، باستثناء المركبات ذات المحركات والدراجات النارية,303,91,9,0,403
2456,2022,1,Yanbu Governorate Office,تجارة الجملة والتجزئة ، وإصلاح المركبات ذات المحركات والدراجات النارية,506,75,1,0,582
2458,2022,1,Yanbu Governorate Office,تشييد المباني,929,373,51,3,1356
2462,2022,1,Yanbu Governorate Office,توصيل الكهرباء والغاز والبخار وتكييف الهواء,5,3,0,0,8
2465,2022,1,Yanbu Governorate Office,صناعة معدات النقل الأخرى,5,0,0,0,5
2466,2022,1,Yanbu Governorate Office,صنع الأثاث,40,3,0,0,43
2467,2022,1,Yanbu Governorate Office,صنع الحواسيب والمنتجات الإلكترونية والبصرية,9,4,0,0,13
2468,2022,1,Yanbu Governorate Office,صُنع الخشب ومنتجات الخشب والفلين ، باستثناء الأثاث ، صُنع أصناف من القش ومواد الضفر,35,5,1,0,41
2469,2022,1,Yanbu Governorate Office,صنع الفلزات القاعدية,21,4,2,0,27
2471,2022,1,Yanbu Governorate Office,صنع المعدات الكهربائية,16,4,1,1,22
2472,2022,1,Yanbu Governorate Office,صُنع الملبوسات,162,17,0,0,179
2474,2022,1,Yanbu Governorate Office,صُنع المنتجات الغذائية,84,20,7,0,111
2476,2022,1,Yanbu Governorate Office,صُنع المواد الكيميائية والمنتجات الكيميائية,9,10,7,2,28
2477,2022,1,Yanbu Governorate Office,صُنع الورق ومنتجات الورق,4,2,1,0,7
2481,2022,1,Yanbu Governorate Office,صنع منتجات المعادن اللافلزية الأخرى,30,17,15,4,66
2482,2022,1,Yanbu Governorate Office,صنع منتجات المعادن المشكلة ( باستثناء الآلات والمعدات ),66,12,3,0,81
2483,2022,1,Yanbu Governorate Office,صيد الأسماك وتربية المائيات,39,16,0,0,55
2485,2022,1,Makkah Al-Mukarramah Office,أبحاث الإعلان والسوق,52,4,0,0,56
2486,2022,1,Makkah Al-Mukarramah Office,إصلاح أجهزة الحاسوب والسلع الشخصية والمنزلية,278,37,0,0,315
2487,2022,1,Makkah Al-Mukarramah Office,إصلاح وتركيب الآلات والمعدات,157,10,0,0,167
2488,2022,1,Makkah Al-Mukarramah Office,أنشطة أنتاج الأفلام والبرامج التلفزيونية والتسجيلات الصوتية و نشرالموسيقى,23,3,0,0,26
2489,2022,1,Makkah Al-Mukarramah Office,أنشطة الأمن والتحقيقات,18,6,4,2,30
2490,2022,1,Makkah Al-Mukarramah Office,أنشطة الاستخدام,36,3,0,1,40
2492,2022,1,Makkah Al-Mukarramah Office,أنشطة البرمجة الحاسوبية والخبرة الاستشارية وما يتصل بها من أنشطة,39,11,0,0,50
2494,2022,1,Makkah Al-Mukarramah Office,أنشطة البريد ونقل الرسائل والطرود بواسطة مندوبين,7,1,0,0,8
2495,2022,1,Makkah Al-Mukarramah Office,أنشطة التشييد المتخصصة,2406,540,37,2,2985
2496,2022,1,Makkah Al-Mukarramah Office,أنشطة الخدمات الشخصية الأخرى,1913,259,9,0,2181
2497,2022,1,Makkah Al-Mukarramah Office,أنشطة الخدمات المالية ، فيما عدا تمويل التأمين وصناديق المعاشات,60,12,0,0,72
2498,2022,1,Makkah Al-Mukarramah Office,أنشطة العمل الاجتماعي، دون إقامة، لكبار السن وذوي الإعاقة,205,109,8,2,324
2500,2022,1,Makkah Al-Mukarramah Office,أنشطة المعمارية والهندسية ، والاختبارات الفنية والتحليل,256,170,6,2,434
2501,2022,1,Makkah Al-Mukarramah Office,أنشطة المكاتب الرئيسية ، وألأنشطة الاستشارية في مجال الإدارة,67,11,0,0,78
2502,2022,1,Makkah Al-Mukarramah Office,أنشطة المكتبات ودور المحفوظات، والمتاحف والأنشطة الثقافية الأخرى,54,14,1,0,69
2504,2022,1,Makkah Al-Mukarramah Office,أنشطة المنظمات ذات العضوية,42,9,0,0,51
2505,2022,1,Makkah Al-Mukarramah Office,أنشطة النشر,21,1,0,0,22
2506,2022,1,Makkah Al-Mukarramah Office,أنشطة تقديم الخدمات للمباني وتجميل المواقع,780,207,23,2,1012
2507,2022,1,Makkah Al-Mukarramah Office,أنشطة جمع النفايات ومعالجتها وتصريفها ، واسترجاع المواد,3,0,0,0,3
2508,2022,1,Makkah Al-Mukarramah Office,أنشطة خدمات الأطعمة والمشروبات,4262,986,68,4,5320
2510,2022,1,Makkah Al-Mukarramah Office,أنشطة خدمات دعم التعدين,10,6,1,0,17
2511,2022,1,Makkah Al-Mukarramah Office,أنشطة زراعة المحاصيل والإنتاج الحيواني والصيد والخدمات المتصلة,596,33,1,1,631
2512,2022,1,Makkah Al-Mukarramah Office,الإدارة العامة والدفاع ؛ والضمان الاجتماعي الإلزامي,63,42,3,0,108
2513,2022,1,Makkah Al-Mukarramah Office,الإقامة,356,164,41,7,568
2514,2022,1,Makkah Al-Mukarramah Office,الأنشطة الإبداعية والفنون وأنشطة الترفيه,9,0,0,0,9
2515,2022,1,Makkah Al-Mukarramah Office,الأنشطة الأخرى للتعدين واستغلال المحاجر,11,3,0,0,14
2516,2022,1,Makkah Al-Mukarramah Office,الأنشطة الإدارية للمكاتب ، وأنشطة الدعم للمكاتب وغير ذلك من أنشطة الدعم للأعمال,151,11,0,0,162
2517,2022,1,Makkah Al-Mukarramah Office,الأنشطة الإيجارية,877,39,1,1,918
2518,2022,1,Makkah Al-Mukarramah Office,الأنشطة البيطرية,10,4,0,0,14
2519,2022,1,Makkah Al-Mukarramah Office,الأنشطة الرياضية وأنشطة التسلية والترفيه,69,29,1,0,99
2520,2022,1,Makkah Al-Mukarramah Office,الأنشطة العقارية,200,30,3,0,233
2521,2022,1,Makkah Al-Mukarramah Office,الأنشطة القانونية وأنشطة المحاسبة,42,5,0,0,47
2522,2022,1,Makkah Al-Mukarramah Office,الأنشطة المساعدة لأنشطة الخدمات المالية وأنشطة التأمين,11,10,1,0,22
2523,2022,1,Makkah Al-Mukarramah Office,الأنشطة المهنية والعلمية والتقنية الأخرى,60,12,0,0,72
2524,2022,1,Makkah Al-Mukarramah Office,الاتصالات,46,2,0,0,48
2525,2022,1,Makkah Al-Mukarramah Office,البحث والتطوير في المجال العلمي,2,0,0,0,2
2526,2022,1,Makkah Al-Mukarramah Office,التخزين وأنشطة الدعم للنقل,89,13,2,0,104
2527,2022,1,Makkah Al-Mukarramah Office,التعليم,68,49,22,2,141
2529,2022,1,Makkah Al-Mukarramah Office,الرعاية مع الإقامة,13,3,1,0,17
2530,2022,1,Makkah Al-Mukarramah Office,الصحة البشرية,82,125,32,3,242
2532,2022,1,Makkah Al-Mukarramah Office,الصناعة التحويلية الأخرى,38,12,2,0,52
2533,2022,1,Makkah Al-Mukarramah Office,الطباعة واستنساخ وسائط الأعلام المسجّلة,61,23,3,0,87
2534,2022,1,Makkah Al-Mukarramah Office,النقل البري و النقل عبر الأنابيب,964,145,14,2,1125
2535,2022,1,Makkah Al-Mukarramah Office,النقل الجوي,21,4,1,0,26
2537,2022,1,Makkah Al-Mukarramah Office,الهندسة المدنية,51,8,0,1,60
2538,2022,1,Makkah Al-Mukarramah Office,تجارة التجزئة، باستثناء المركبات ذات المحركات والدراجات النارية,5447,1114,52,5,6618
2539,2022,1,Makkah Al-Mukarramah Office,تجارة الجملة ، باستثناء المركبات ذات المحركات والدراجات النارية,1676,445,32,2,2155
2540,2022,1,Makkah Al-Mukarramah Office,تجارة الجملة والتجزئة ، وإصلاح المركبات ذات المحركات والدراجات النارية,2011,318,6,0,2335
2541,2022,1,Makkah Al-Mukarramah Office,تجميع المياه ومعالجتها وتوصيلها,63,24,0,1,88
2542,2022,1,Makkah Al-Mukarramah Office,تشييد المباني,5148,1711,156,12,7027
2543,2022,1,Makkah Al-Mukarramah Office,تعدين ركازات الفلزات,22,3,0,0,25
2544,2022,1,Makkah Al-Mukarramah Office,تمويل التأمين وإعادة التأمين وصناديق المعاشات التقاعدية باستثناء الضمان الاجتماعي الإلزامي,2,2,0,0,4
2545,2022,1,Makkah Al-Mukarramah Office,توصيل الكهرباء والغاز والبخار وتكييف الهواء,9,9,2,0,20
2546,2022,1,Makkah Al-Mukarramah Office,صناعة الآلات والمعدات غير المصنفة في موضع أخر,29,2,0,0,31
2547,2022,1,Makkah Al-Mukarramah Office,صناعة المركبات ذات المحركات والمركبات المقطورة ونصف المقطورة,44,5,1,0,50
2548,2022,1,Makkah Al-Mukarramah Office,صناعة معدات النقل الأخرى,17,0,0,1,18
2549,2022,1,Makkah Al-Mukarramah Office,صنع الأثاث,140,38,1,0,179
2550,2022,1,Makkah Al-Mukarramah Office,صنع الحواسيب والمنتجات الإلكترونية والبصرية,65,18,0,0,83
2551,2022,1,Makkah Al-Mukarramah Office,صُنع الخشب ومنتجات الخشب والفلين ، باستثناء الأثاث ، صُنع أصناف من القش ومواد الضفر,210,38,2,0,250
2552,2022,1,Makkah Al-Mukarramah Office,صنع الفلزات القاعدية,60,25,2,0,87
2553,2022,1,Makkah Al-Mukarramah Office,صُنع المشروبات,20,6,3,0,29
2554,2022,1,Makkah Al-Mukarramah Office,صنع المعدات الكهربائية,89,15,1,0,105
2555,2022,1,Makkah Al-Mukarramah Office,صُنع الملبوسات,697,89,0,0,786
2556,2022,1,Makkah Al-Mukarramah Office,صُنع المنتجات الجلدية والمنتجات ذات الصلة,15,2,0,0,17
2558,2022,1,Makkah Al-Mukarramah Office,صُنع المنتجات الغذائية,535,151,17,2,705
2559,2022,1,Makkah Al-Mukarramah Office,صُنع المنسوجات,117,23,0,0,140
2560,2022,1,Makkah Al-Mukarramah Office,صُنع المواد الكيميائية والمنتجات الكيميائية,72,28,0,0,100
2563,2022,1,Makkah Al-Mukarramah Office,صنع منتجات المطاط واللدائن,15,11,2,1,29
2564,2022,1,Makkah Al-Mukarramah Office,صنع منتجات المعادن اللافلزية الأخرى,101,34,9,0,144
2565,2022,1,Makkah Al-Mukarramah Office,صنع منتجات المعادن المشكلة ( باستثناء الآلات والمعدات ),467,88,10,0,565
2566,2022,1,Makkah Al-Mukarramah Office,صيد الأسماك وتربية المائيات,86,15,1,0,102
2567,2022,1,Makkah Al-Mukarramah Office,وكالات السفر ومشغّلو الجولات السياحية وخدمات الحجز والأنشطة المتصلة بها,114,39,3,0,156
2569,2022,1,Al-Baha District Office,إصلاح أجهزة الحاسوب والسلع الشخصية والمنزلية,41,4,0,0,45
2570,2022,1,Al-Baha District Office,إصلاح وتركيب الآلات والمعدات,14,2,0,0,16
2573,2022,1,Al-Baha District Office,أنشطة الاستخدام,7,1,0,0,8
2575,2022,1,Al-Baha District Office,أنشطة التشييد المتخصصة,461,69,0,1,531
2576,2022,1,Al-Baha District Office,أنشطة الخدمات الشخصية الأخرى,264,18,0,0,282
2577,2022,1,Al-Baha District Office,أنشطة الخدمات المالية ، فيما عدا تمويل التأمين وصناديق المعاشات,7,0,0,0,7
2578,2022,1,Al-Baha District Office,أنشطة العمل الاجتماعي، دون إقامة، لكبار السن وذوي الإعاقة,29,15,0,0,44
2579,2022,1,Al-Baha District Office,أنشطة المعمارية والهندسية ، والاختبارات الفنية والتحليل,83,36,5,0,124
2583,2022,1,Al-Baha District Office,أنشطة المنظمات ذات العضوية,12,6,0,0,18
2584,2022,1,Al-Baha District Office,أنشطة النشر,5,2,0,0,7
2585,2022,1,Al-Baha District Office,أنشطة تقديم الخدمات للمباني وتجميل المواقع,57,7,1,0,65
2587,2022,1,Al-Baha District Office,أنشطة خدمات الأطعمة والمشروبات,618,169,7,0,794
2590,2022,1,Al-Baha District Office,أنشطة زراعة المحاصيل والإنتاج الحيواني والصيد والخدمات المتصلة,258,5,0,0,263
2591,2022,1,Al-Baha District Office,الإدارة العامة والدفاع ؛ والضمان الاجتماعي الإلزامي,6,9,1,0,16
2592,2022,1,Al-Baha District Office,الإقامة,45,21,1,0,67
2594,2022,1,Al-Baha District Office,الأنشطة الأخرى للتعدين واستغلال المحاجر,2,3,0,0,5
2595,2022,1,Al-Baha District Office,الأنشطة الإدارية للمكاتب ، وأنشطة الدعم للمكاتب وغير ذلك من أنشطة الدعم للأعمال,20,0,0,0,20
2596,2022,1,Al-Baha District Office,الأنشطة الإيجارية,136,4,0,0,140
2597,2022,1,Al-Baha District Office,الأنشطة البيطرية,2,0,0,0,2
2599,2022,1,Al-Baha District Office,الأنشطة العقارية,8,2,0,0,10
2601,2022,1,Al-Baha District Office,الأنشطة المهنية والعلمية والتقنية الأخرى,5,1,0,0,6
2603,2022,1,Al-Baha District Office,التخزين وأنشطة الدعم للنقل,26,1,0,0,27
2604,2022,1,Al-Baha District Office,التعليم,12,7,0,0,19
2606,2022,1,Al-Baha District Office,الصحة البشرية,15,20,1,0,36
2608,2022,1,Al-Baha District Office,الصناعة التحويلية الأخرى,8,0,0,0,8
2609,2022,1,Al-Baha District Office,الطباعة واستنساخ وسائط الأعلام المسجّلة,11,5,0,0,16
2610,2022,1,Al-Baha District Office,النقل البري و النقل عبر الأنابيب,144,17,0,0,161
2613,2022,1,Al-Baha District Office,تجارة التجزئة، باستثناء المركبات ذات المحركات والدراجات النارية,1014,230,13,0,1257
2614,2022,1,Al-Baha District Office,تجارة الجملة ، باستثناء المركبات ذات المحركات والدراجات النارية,373,191,6,0,570
2615,2022,1,Al-Baha District Office,تجارة الجملة والتجزئة ، وإصلاح المركبات ذات المحركات والدراجات النارية,383,48,1,0,432
2616,2022,1,Al-Baha District Office,تجميع المياه ومعالجتها وتوصيلها,17,2,0,0,19
2617,2022,1,Al-Baha District Office,تشييد المباني,703,162,12,1,878
2618,2022,1,Al-Baha District Office,تعدين ركازات الفلزات,11,2,0,0,13
2620,2022,1,Al-Baha District Office,صناعة الآلات والمعدات غير المصنفة في موضع أخر,5,0,0,0,5
2622,2022,1,Al-Baha District Office,صناعة معدات النقل الأخرى,3,0,0,0,3
2623,2022,1,Al-Baha District Office,صنع الأثاث,47,8,0,0,55
2624,2022,1,Al-Baha District Office,صنع الحواسيب والمنتجات الإلكترونية والبصرية,15,4,0,0,19
2625,2022,1,Al-Baha District Office,صُنع الخشب ومنتجات الخشب والفلين ، باستثناء الأثاث ، صُنع أصناف من القش ومواد الضفر,50,13,0,0,63
2626,2022,1,Al-Baha District Office,صنع الفلزات القاعدية,22,3,0,0,25
2627,2022,1,Al-Baha District Office,صُنع المشروبات,4,2,0,0,6
2632,2022,1,Al-Baha District Office,صُنع المنتجات الغذائية,102,11,0,0,113
2633,2022,1,Al-Baha District Office,صُنع المنسوجات,12,2,0,0,14
2634,2022,1,Al-Baha District Office,صُنع المواد الكيميائية والمنتجات الكيميائية,9,1,0,0,10
2636,2022,1,Al-Baha District Office,صنع منتجات المطاط واللدائن,5,1,0,0,6
2637,2022,1,Al-Baha District Office,صنع منتجات المعادن اللافلزية الأخرى,43,19,4,0,66
2638,2022,1,Al-Baha District Office,صنع منتجات المعادن المشكلة ( باستثناء الآلات والمعدات ),122,19,0,0,141
2639,2022,1,Al-Baha District Office,صيد الأسماك وتربية المائيات,4,0,0,0,4
2641,2022,1,Al-Jouf Region Office,أبحاث الإعلان والسوق,32,4,0,0,36
2642,2022,1,Al-Jouf Region Office,إصلاح أجهزة الحاسوب والسلع الشخصية والمنزلية,80,9,1,0,90
2643,2022,1,Al-Jouf Region Office,إصلاح وتركيب الآلات والمعدات,23,3,0,0,26
2645,2022,1,Al-Jouf Region Office,أنشطة الأمن والتحقيقات,1,2,0,0,3
2646,2022,1,Al-Jouf Region Office,أنشطة الاستخدام,13,3,0,0,16
2650,2022,1,Al-Jouf Region Office,أنشطة التشييد المتخصصة,696,175,10,0,881
2651,2022,1,Al-Jouf Region Office,أنشطة الخدمات الشخصية الأخرى,489,55,1,0,545
2652,2022,1,Al-Jouf Region Office,أنشطة الخدمات المالية ، فيما عدا تمويل التأمين وصناديق المعاشات,13,0,0,0,13
2653,2022,1,Al-Jouf Region Office,أنشطة العمل الاجتماعي، دون إقامة، لكبار السن وذوي الإعاقة,17,16,0,0,33
2654,2022,1,Al-Jouf Region Office,أنشطة المعمارية والهندسية ، والاختبارات الفنية والتحليل,99,40,2,0,141
2656,2022,1,Al-Jouf Region Office,أنشطة المكتبات ودور المحفوظات، والمتاحف والأنشطة الثقافية الأخرى,10,6,0,0,16
2657,2022,1,Al-Jouf Region Office,أنشطة المنظمات ذات العضوية,12,5,0,0,17
2658,2022,1,Al-Jouf Region Office,أنشطة النشر,4,1,0,0,5
2659,2022,1,Al-Jouf Region Office,أنشطة تقديم الخدمات للمباني وتجميل المواقع,303,85,8,1,397
2660,2022,1,Al-Jouf Region Office,أنشطة جمع النفايات ومعالجتها وتصريفها ، واسترجاع المواد,2,1,0,0,3
2661,2022,1,Al-Jouf Region Office,أنشطة خدمات الأطعمة والمشروبات,958,199,6,0,1163
2664,2022,1,Al-Jouf Region Office,أنشطة زراعة المحاصيل والإنتاج الحيواني والصيد والخدمات المتصلة,598,27,0,2,627
2666,2022,1,Al-Jouf Region Office,الإقامة,60,10,1,0,71
2669,2022,1,Al-Jouf Region Office,الأنشطة الإدارية للمكاتب ، وأنشطة الدعم للمكاتب وغير ذلك من أنشطة الدعم للأعمال,31,1,0,0,32
2670,2022,1,Al-Jouf Region Office,الأنشطة الإيجارية,558,23,0,0,581
2671,2022,1,Al-Jouf Region Office,الأنشطة البيطرية,4,3,0,0,7
2672,2022,1,Al-Jouf Region Office,الأنشطة الرياضية وأنشطة التسلية والترفيه,39,6,0,0,45
2673,2022,1,Al-Jouf Region Office,الأنشطة العقارية,28,2,1,0,31
2674,2022,1,Al-Jouf Region Office,الأنشطة القانونية وأنشطة المحاسبة,10,1,0,0,11
2675,2022,1,Al-Jouf Region Office,الأنشطة المهنية والعلمية والتقنية الأخرى,14,1,0,0,15
2676,2022,1,Al-Jouf Region Office,الاتصالات,22,1,0,0,23
2677,2022,1,Al-Jouf Region Office,التخزين وأنشطة الدعم للنقل,115,16,3,0,134
2678,2022,1,Al-Jouf Region Office,التعليم,19,26,12,0,57
2681,2022,1,Al-Jouf Region Office,الصحة البشرية,16,31,7,0,54
2682,2022,1,Al-Jouf Region Office,الصرف الصحي,4,0,0,0,4
2684,2022,1,Al-Jouf Region Office,الطباعة واستنساخ وسائط الأعلام المسجّلة,15,5,0,0,20
2685,2022,1,Al-Jouf Region Office,النقل البري و النقل عبر الأنابيب,457,66,1,0,524
2686,2022,1,Al-Jouf Region Office,النقل الجوي,13,1,0,0,14
2687,2022,1,Al-Jouf Region Office,الهندسة المدنية,10,4,0,0,14
2688,2022,1,Al-Jouf Region Office,تجارة التجزئة، باستثناء المركبات ذات المحركات والدراجات النارية,1267,235,10,1,1513
2689,2022,1,Al-Jouf Region Office,تجارة الجملة ، باستثناء المركبات ذات المحركات والدراجات النارية,378,87,3,1,469
2690,2022,1,Al-Jouf Region Office,تجارة الجملة والتجزئة ، وإصلاح المركبات ذات المحركات والدراجات النارية,553,108,0,0,661
2691,2022,1,Al-Jouf Region Office,تجميع المياه ومعالجتها وتوصيلها,9,1,0,0,10
2692,2022,1,Al-Jouf Region Office,تشييد المباني,938,187,15,1,1141
2693,2022,1,Al-Jouf Region Office,تعدين الفحم والليغنيت,2,0,0,0,2
2699,2022,1,Al-Jouf Region Office,صنع الأثاث,92,8,0,0,100
2700,2022,1,Al-Jouf Region Office,صنع الحواسيب والمنتجات الإلكترونية والبصرية,11,2,0,0,13
2701,2022,1,Al-Jouf Region Office,صُنع الخشب ومنتجات الخشب والفلين ، باستثناء الأثاث ، صُنع أصناف من القش ومواد الضفر,48,5,0,0,53
2702,2022,1,Al-Jouf Region Office,صنع الفلزات القاعدية,37,9,0,0,46
2704,2022,1,Al-Jouf Region Office,صنع المعدات الكهربائية,27,3,0,0,30
2705,2022,1,Al-Jouf Region Office,صُنع الملبوسات,215,19,0,0,234
2708,2022,1,Al-Jouf Region Office,صُنع المنتجات الغذائية,149,48,1,0,198
2709,2022,1,Al-Jouf Region Office,صُنع المنسوجات,29,9,0,0,38
2710,2022,1,Al-Jouf Region Office,صُنع المواد الكيميائية والمنتجات الكيميائية,23,3,0,0,26
2712,2022,1,Al-Jouf Region Office,صنع منتجات المطاط واللدائن,6,4,0,0,10
2713,2022,1,Al-Jouf Region Office,صنع منتجات المعادن اللافلزية الأخرى,51,23,3,0,77
2714,2022,1,Al-Jouf Region Office,صنع منتجات المعادن المشكلة ( باستثناء الآلات والمعدات ),123,19,1,0,143
2715,2022,1,Al-Jouf Region Office,صيد الأسماك وتربية المائيات,8,2,0,0,10
2717,2022,1,Northern Border Region Office,أبحاث الإعلان والسوق,7,1,0,0,8
2718,2022,1,Northern Border Region Office,إصلاح أجهزة الحاسوب والسلع الشخصية والمنزلية,47,1,0,0,48
2719,2022,1,Northern Border Region Office,إصلاح وتركيب الآلات والمعدات,19,1,0,0,20
2721,2022,1,Northern Border Region Office,أنشطة الاستخدام,9,1,0,0,10
2723,2022,1,Northern Border Region Office,أنشطة البرمجة الحاسوبية والخبرة الاستشارية وما يتصل بها من أنشطة,4,0,0,0,4
2725,2022,1,Northern Border Region Office,أنشطة التشييد المتخصصة,334,46,2,0,382
2726,2022,1,Northern Border Region Office,أنشطة الخدمات الشخصية الأخرى,416,29,0,0,445
2729,2022,1,Northern Border Region Office,أنشطة المعمارية والهندسية ، والاختبارات الفنية والتحليل,112,30,1,0,143
2730,2022,1,Northern Border Region Office,أنشطة المكاتب الرئيسية ، وألأنشطة الاستشارية في مجال الإدارة,7,3,0,0,10
2732,2022,1,Northern Border Region Office,أنشطة المنظمات ذات العضوية,10,1,0,0,11
2733,2022,1,Northern Border Region Office,أنشطة تقديم الخدمات للمباني وتجميل المواقع,110,16,1,0,127
2734,2022,1,Northern Border Region Office,أنشطة خدمات الأطعمة والمشروبات,860,139,3,0,1002
2737,2022,1,Northern Border Region Office,أنشطة زراعة المحاصيل والإنتاج الحيواني والصيد والخدمات المتصلة,193,4,0,0,197
2739,2022,1,Northern Border Region Office,الإقامة,26,12,1,0,39
2741,2022,1,Northern Border Region Office,الأنشطة الأخرى للتعدين واستغلال المحاجر,4,2,0,1,7
2742,2022,1,Northern Border Region Office,الأنشطة الإدارية للمكاتب ، وأنشطة الدعم للمكاتب وغير ذلك من أنشطة الدعم للأعمال,34,0,0,0,34
2743,2022,1,Northern Border Region Office,الأنشطة الإيجارية,211,7,0,0,218
2744,2022,1,Northern Border Region Office,الأنشطة البيطرية,5,2,0,0,7
2745,2022,1,Northern Border Region Office,الأنشطة الرياضية وأنشطة التسلية والترفيه,31,7,0,0,38
2747,2022,1,Northern Border Region Office,الأنشطة القانونية وأنشطة المحاسبة,6,0,0,0,6
2748,2022,1,Northern Border Region Office,الأنشطة المهنية والعلمية والتقنية الأخرى,5,0,0,0,5
2749,2022,1,Northern Border Region Office,الاتصالات,5,1,0,0,6
2750,2022,1,Northern Border Region Office,التخزين وأنشطة الدعم للنقل,27,5,1,0,33
2753,2022,1,Northern Border Region Office,الصحة البشرية,18,23,2,0,43
2754,2022,1,Northern Border Region Office,الصناعة التحويلية الأخرى,7,1,0,0,8
2755,2022,1,Northern Border Region Office,الطباعة واستنساخ وسائط الأعلام المسجّلة,9,3,0,0,12
2756,2022,1,Northern Border Region Office,النقل البري و النقل عبر الأنابيب,314,41,1,0,356
2759,2022,1,Northern Border Region Office,الهندسة المدنية,7,0,0,0,7
2760,2022,1,Northern Border Region Office,تجارة التجزئة، باستثناء المركبات ذات المحركات والدراجات النارية,904,117,8,0,1029
2761,2022,1,Northern Border Region Office,تجارة الجملة ، باستثناء المركبات ذات المحركات والدراجات النارية,218,33,1,0,252
2762,2022,1,Northern Border Region Office,تجارة الجملة والتجزئة ، وإصلاح المركبات ذات المحركات والدراجات النارية,446,66,1,0,513
2763,2022,1,Northern Border Region Office,تجميع المياه ومعالجتها وتوصيلها,11,3,0,0,14
2764,2022,1,Northern Border Region Office,تشييد المباني,1243,226,21,4,1494
2765,2022,1,Northern Border Region Office,تعدين ركازات الفلزات,7,0,0,0,7
2766,2022,1,Northern Border Region Office,توصيل الكهرباء والغاز والبخار وتكييف الهواء,2,2,0,0,4
2768,2022,1,Northern Border Region Office,صناعة المركبات ذات المحركات والمركبات المقطورة ونصف المقطورة,10,1,0,0,11
2769,2022,1,Northern Border Region Office,صناعة معدات النقل الأخرى,2,1,0,0,3
2770,2022,1,Northern Border Region Office,صنع الأثاث,51,8,0,0,59
2771,2022,1,Northern Border Region Office,صنع الحواسيب والمنتجات الإلكترونية والبصرية,15,3,0,0,18
2772,2022,1,Northern Border Region Office,صُنع الخشب ومنتجات الخشب والفلين ، باستثناء الأثاث ، صُنع أصناف من القش ومواد الضفر,43,6,0,0,49
2773,2022,1,Northern Border Region Office,صنع الفلزات القاعدية,22,5,0,0,27
2775,2022,1,Northern Border Region Office,صنع المعدات الكهربائية,41,6,0,0,47
2776,2022,1,Northern Border Region Office,صُنع الملبوسات,216,11,0,0,227
2777,2022,1,Northern Border Region Office,صُنع المنتجات الجلدية والمنتجات ذات الصلة,5,2,0,0,7
2779,2022,1,Northern Border Region Office,صُنع المنتجات الغذائية,115,31,0,0,146
2781,2022,1,Northern Border Region Office,صُنع المواد الكيميائية والمنتجات الكيميائية,13,0,0,0,13
2782,2022,1,Northern Border Region Office,صُنع الورق ومنتجات الورق,2,1,0,0,3
2785,2022,1,Northern Border Region Office,صنع منتجات المعادن اللافلزية الأخرى,42,14,0,1,57
2786,2022,1,Northern Border Region Office,صنع منتجات المعادن المشكلة ( باستثناء الآلات والمعدات ),58,3,0,0,61
2787,2022,1,Northern Border Region Office,صيد الأسماك وتربية المائيات,4,0,0,0,4
2789,2022,1,Riyadh Region Office,أبحاث الإعلان والسوق,512,130,0,0,642
2790,2022,1,Riyadh Region Office,إصلاح أجهزة الحاسوب والسلع الشخصية والمنزلية,884,190,27,7,1108
2791,2022,1,Riyadh Region Office,إصلاح وتركيب الآلات والمعدات,541,99,9,5,654
2792,2022,1,Riyadh Region Office,أنشطة أنتاج الأفلام والبرامج التلفزيونية والتسجيلات الصوتية و نشرالموسيقى,200,84,4,3,291
2793,2022,1,Riyadh Region Office,أنشطة الأمن والتحقيقات,101,41,21,10,173
2794,2022,1,Riyadh Region Office,أنشطة الاستخدام,418,101,17,25,561
2795,2022,1,Riyadh Region Office,أنشطة الاسر المعيشية التي تستخدم أفراداً للعمل المنزلي,15,1,0,0,16
2796,2022,1,Riyadh Region Office,أنشطة البرمجة الحاسوبية والخبرة الاستشارية وما يتصل بها من أنشطة,836,403,50,9,1298
2797,2022,1,Riyadh Region Office,أنشطة البرمجة والإذاعة,10,3,0,0,13
2798,2022,1,Riyadh Region Office,أنشطة البريد ونقل الرسائل والطرود بواسطة مندوبين,136,35,5,0,176
2799,2022,1,Riyadh Region Office,أنشطة التشييد المتخصصة,9973,3183,326,50,13532
2800,2022,1,Riyadh Region Office,أنشطة الخدمات الشخصية الأخرى,6029,1496,130,42,7697
2801,2022,1,Riyadh Region Office,أنشطة الخدمات المالية ، فيما عدا تمويل التأمين وصناديق المعاشات,262,115,21,13,411
2802,2022,1,Riyadh Region Office,أنشطة العمل الاجتماعي، دون إقامة، لكبار السن وذوي الإعاقة,173,168,26,2,369
2803,2022,1,Riyadh Region Office,أنشطة المعالجة وخدمات إدارة النفايات الأخرى,7,1,1,0,9
2804,2022,1,Riyadh Region Office,أنشطة المعمارية والهندسية ، والاختبارات الفنية والتحليل,692,418,92,23,1225
2805,2022,1,Riyadh Region Office,أنشطة المكاتب الرئيسية ، وألأنشطة الاستشارية في مجال الإدارة,895,322,35,6,1258
2806,2022,1,Riyadh Region Office,أنشطة المكتبات ودور المحفوظات، والمتاحف والأنشطة الثقافية الأخرى,100,42,2,0,144
2808,2022,1,Riyadh Region Office,أنشطة المنظمات ذات العضوية,189,49,4,0,242
2809,2022,1,Riyadh Region Office,أنشطة النشر,188,72,5,1,266
2810,2022,1,Riyadh Region Office,أنشطة تقديم الخدمات للمباني وتجميل المواقع,5632,3105,583,117,9437
2811,2022,1,Riyadh Region Office,أنشطة جمع النفايات ومعالجتها وتصريفها ، واسترجاع المواد,33,8,4,5,50
2812,2022,1,Riyadh Region Office,أنشطة خدمات الأطعمة والمشروبات,9920,3484,420,78,13902
2813,2022,1,Riyadh Region Office,أنشطة خدمات المعلومات,230,87,10,2,329
2814,2022,1,Riyadh Region Office,أنشطة خدمات دعم التعدين,77,35,6,3,121
2815,2022,1,Riyadh Region Office,أنشطة زراعة المحاصيل والإنتاج الحيواني والصيد والخدمات المتصلة,2860,291,87,17,3255
2816,2022,1,Riyadh Region Office,استخراج النفط الخام والغاز الطبيعي,5,0,0,0,5
2817,2022,1,Riyadh Region Office,الإدارة العامة والدفاع ؛ والضمان الاجتماعي الإلزامي,335,213,45,16,609
2818,2022,1,Riyadh Region Office,الإقامة,608,330,79,9,1026
2819,2022,1,Riyadh Region Office,الأنشطة الإبداعية والفنون وأنشطة الترفيه,104,22,3,1,130
2820,2022,1,Riyadh Region Office,الأنشطة الأخرى للتعدين واستغلال المحاجر,126,58,14,4,202
2821,2022,1,Riyadh Region Office,الأنشطة الإدارية للمكاتب ، وأنشطة الدعم للمكاتب وغير ذلك من أنشطة الدعم للأعمال,781,130,15,3,929
2822,2022,1,Riyadh Region Office,الأنشطة الإيجارية,51839,1106,37,3,52985
2823,2022,1,Riyadh Region Office,الأنشطة البيطرية,49,47,5,0,101
2824,2022,1,Riyadh Region Office,الأنشطة الرياضية وأنشطة التسلية والترفيه,499,173,19,5,696
2825,2022,1,Riyadh Region Office,الأنشطة العقارية,1150,454,62,9,1675
2826,2022,1,Riyadh Region Office,الأنشطة القانونية وأنشطة المحاسبة,537,207,14,2,760
2827,2022,1,Riyadh Region Office,الأنشطة المساعدة لأنشطة الخدمات المالية وأنشطة التأمين,78,77,14,2,171
2828,2022,1,Riyadh Region Office,الأنشطة المهنية والعلمية والتقنية الأخرى,373,62,2,0,437
2830,2022,1,Riyadh Region Office,الاتصالات,373,165,24,13,575
2831,2022,1,Riyadh Region Office,البحث والتطوير في المجال العلمي,27,11,1,1,40
2832,2022,1,Riyadh Region Office,التخزين وأنشطة الدعم للنقل,899,246,53,21,1219
2833,2022,1,Riyadh Region Office,التعليم,702,425,165,49,1341
2835,2022,1,Riyadh Region Office,الرعاية مع الإقامة,33,18,1,0,52
2836,2022,1,Riyadh Region Office,الصحة البشرية,491,611,193,61,1356
2837,2022,1,Riyadh Region Office,الصرف الصحي,33,16,3,2,54
2838,2022,1,Riyadh Region Office,الصناعة التحويلية الأخرى,186,92,18,4,300
2839,2022,1,Riyadh Region Office,الطباعة واستنساخ وسائط الأعلام المسجّلة,346,205,25,5,581
2840,2022,1,Riyadh Region Office,النقل البري و النقل عبر الأنابيب,9241,711,79,20,10051
2841,2022,1,Riyadh Region Office,النقل الجوي,294,73,34,15,416
2842,2022,1,Riyadh Region Office,النقل المائي,90,17,2,0,109
2843,2022,1,Riyadh Region Office,الهندسة المدنية,290,99,29,12,430
2844,2022,1,Riyadh Region Office,تجارة التجزئة، باستثناء المركبات ذات المحركات والدراجات النارية,19368,5940,768,145,26221
2845,2022,1,Riyadh Region Office,تجارة الجملة ، باستثناء المركبات ذات المحركات والدراجات النارية,11412,5371,743,183,17709
2846,2022,1,Riyadh Region Office,تجارة الجملة والتجزئة ، وإصلاح المركبات ذات المحركات والدراجات النارية,6777,1631,73,8,8489
2847,2022,1,Riyadh Region Office,تجميع المياه ومعالجتها وتوصيلها,110,31,8,0,149
2848,2022,1,Riyadh Region Office,تشييد المباني,10996,4763,1032,346,17137
2849,2022,1,Riyadh Region Office,تعدين الفحم والليغنيت,8,2,1,0,11
2850,2022,1,Riyadh Region Office,تعدين ركازات الفلزات,53,40,0,1,94
2851,2022,1,Riyadh Region Office,تمويل التأمين وإعادة التأمين وصناديق المعاشات التقاعدية باستثناء الضمان الاجتماعي الإلزامي,52,53,15,8,128
2852,2022,1,Riyadh Region Office,توصيل الكهرباء والغاز والبخار وتكييف الهواء,96,69,23,15,203
2853,2022,1,Riyadh Region Office,صناعة الآلات والمعدات غير المصنفة في موضع أخر,168,53,10,2,233
2854,2022,1,Riyadh Region Office,صناعة المركبات ذات المحركات والمركبات المقطورة ونصف المقطورة,97,56,3,1,157
2855,2022,1,Riyadh Region Office,صناعة معدات النقل الأخرى,110,45,8,2,165
2856,2022,1,Riyadh Region Office,صنع الأثاث,893,391,41,2,1327
2857,2022,1,Riyadh Region Office,صنع الحواسيب والمنتجات الإلكترونية والبصرية,253,128,29,7,417
2858,2022,1,Riyadh Region Office,صُنع الخشب ومنتجات الخشب والفلين ، باستثناء الأثاث ، صُنع أصناف من القش ومواد الضفر,743,237,35,9,1024
2859,2022,1,Riyadh Region Office,صنع الفلزات القاعدية,501,274,71,18,864
2860,2022,1,Riyadh Region Office,صُنع المشروبات,72,35,16,6,129
2861,2022,1,Riyadh Region Office,صنع المعدات الكهربائية,236,114,27,5,382
2862,2022,1,Riyadh Region Office,صُنع الملبوسات,2156,431,26,1,2614
2863,2022,1,Riyadh Region Office,صُنع المنتجات الجلدية والمنتجات ذات الصلة,72,15,1,0,88
2864,2022,1,Riyadh Region Office,صنع المنتجات الصيدلانية الأساسية والمستحضرات الصيدلانية,53,24,6,1,84
2865,2022,1,Riyadh Region Office,صُنع المنتجات الغذائية,1318,533,79,26,1956
2866,2022,1,Riyadh Region Office,صُنع المنسوجات,193,82,12,9,296
2867,2022,1,Riyadh Region Office,صُنع المواد الكيميائية والمنتجات الكيميائية,410,213,35,2,660
2868,2022,1,Riyadh Region Office,صُنع الورق ومنتجات الورق,80,56,8,0,144
2869,2022,1,Riyadh Region Office,صنع فحم الكوك والمنتجات النفطية المكررة,30,12,1,0,43
2871,2022,1,Riyadh Region Office,صنع منتجات المطاط واللدائن,290,192,85,12,579
2872,2022,1,Riyadh Region Office,صنع منتجات المعادن اللافلزية الأخرى,1080,547,97,20,1744
2873,2022,1,Riyadh Region Office,صنع منتجات المعادن المشكلة ( باستثناء الآلات والمعدات ),995,467,102,22,1586
2874,2022,1,Riyadh Region Office,صيد الأسماك وتربية المائيات,1033,7,1,1,1042
2875,2022,1,Riyadh Region Office,وكالات السفر ومشغّلو الجولات السياحية وخدمات الحجز والأنشطة المتصلة بها,233,102,14,5,354
2876,2022,1,Qassim Region Office,أبحاث الإعلان والسوق,36,9,0,0,45
2877,2022,1,Qassim Region Office,إصلاح أجهزة الحاسوب والسلع الشخصية والمنزلية,287,38,3,0,328
2878,2022,1,Qassim Region Office,إصلاح وتركيب الآلات والمعدات,97,10,0,0,107
2880,2022,1,Qassim Region Office,أنشطة الأمن والتحقيقات,7,5,0,0,12
2881,2022,1,Qassim Region Office,أنشطة الاستخدام,24,11,1,0,36
2882,2022,1,Qassim Region Office,أنشطة الاسر المعيشية التي تستخدم أفراداً للعمل المنزلي,5,2,0,0,7
2883,2022,1,Qassim Region Office,أنشطة البرمجة الحاسوبية والخبرة الاستشارية وما يتصل بها من أنشطة,42,7,0,0,49
2885,2022,1,Qassim Region Office,أنشطة البريد ونقل الرسائل والطرود بواسطة مندوبين,5,0,0,0,5
2886,2022,1,Qassim Region Office,أنشطة التشييد المتخصصة,3467,585,85,2,4139
2887,2022,1,Qassim Region Office,أنشطة الخدمات الشخصية الأخرى,1319,131,8,1,1459
2888,2022,1,Qassim Region Office,أنشطة الخدمات المالية ، فيما عدا تمويل التأمين وصناديق المعاشات,29,2,1,0,32
2889,2022,1,Qassim Region Office,أنشطة العمل الاجتماعي، دون إقامة، لكبار السن وذوي الإعاقة,58,51,3,0,112
2890,2022,1,Qassim Region Office,أنشطة المعمارية والهندسية ، والاختبارات الفنية والتحليل,220,72,9,0,301
2891,2022,1,Qassim Region Office,أنشطة المكاتب الرئيسية ، وألأنشطة الاستشارية في مجال الإدارة,58,18,2,0,78
2892,2022,1,Qassim Region Office,أنشطة المكتبات ودور المحفوظات، والمتاحف والأنشطة الثقافية الأخرى,21,14,0,0,35
2894,2022,1,Qassim Region Office,أنشطة المنظمات ذات العضوية,33,13,1,0,47
2895,2022,1,Qassim Region Office,أنشطة النشر,17,7,0,0,24
2896,2022,1,Qassim Region Office,أنشطة تقديم الخدمات للمباني وتجميل المواقع,1308,285,50,12,1655
2897,2022,1,Qassim Region Office,أنشطة جمع النفايات ومعالجتها وتصريفها ، واسترجاع المواد,4,5,0,0,9
2898,2022,1,Qassim Region Office,أنشطة خدمات الأطعمة والمشروبات,3218,894,54,3,4169
2899,2022,1,Qassim Region Office,أنشطة خدمات المعلومات,15,3,0,0,18
2900,2022,1,Qassim Region Office,أنشطة خدمات دعم التعدين,8,2,0,0,10
2901,2022,1,Qassim Region Office,أنشطة زراعة المحاصيل والإنتاج الحيواني والصيد والخدمات المتصلة,1283,87,12,5,1387
2902,2022,1,Qassim Region Office,الإدارة العامة والدفاع ؛ والضمان الاجتماعي الإلزامي,31,28,2,0,61
2903,2022,1,Qassim Region Office,الإقامة,99,51,6,1,157
2904,2022,1,Qassim Region Office,الأنشطة الإبداعية والفنون وأنشطة الترفيه,11,3,0,0,14
2905,2022,1,Qassim Region Office,الأنشطة الأخرى للتعدين واستغلال المحاجر,15,0,0,0,15
2906,2022,1,Qassim Region Office,الأنشطة الإدارية للمكاتب ، وأنشطة الدعم للمكاتب وغير ذلك من أنشطة الدعم للأعمال,81,9,4,0,94
2907,2022,1,Qassim Region Office,الأنشطة الإيجارية,1090,67,3,0,1160
2908,2022,1,Qassim Region Office,الأنشطة البيطرية,11,5,1,0,17
2909,2022,1,Qassim Region Office,الأنشطة الرياضية وأنشطة التسلية والترفيه,83,28,0,0,111
2910,2022,1,Qassim Region Office,الأنشطة العقارية,103,16,1,0,120
2911,2022,1,Qassim Region Office,الأنشطة القانونية وأنشطة المحاسبة,39,1,0,0,40
2912,2022,1,Qassim Region Office,الأنشطة المساعدة لأنشطة الخدمات المالية وأنشطة التأمين,2,0,0,0,2
2913,2022,1,Qassim Region Office,الأنشطة المهنية والعلمية والتقنية الأخرى,22,6,0,0,28
2914,2022,1,Qassim Region Office,الاتصالات,80,23,1,0,104
2916,2022,1,Qassim Region Office,التخزين وأنشطة الدعم للنقل,120,34,5,0,159
2917,2022,1,Qassim Region Office,التعليم,60,38,18,2,118
2919,2022,1,Qassim Region Office,الرعاية مع الإقامة,12,5,0,0,17
2920,2022,1,Qassim Region Office,الصحة البشرية,44,82,27,4,157
2921,2022,1,Qassim Region Office,الصرف الصحي,3,1,0,0,4
2922,2022,1,Qassim Region Office,الصناعة التحويلية الأخرى,30,7,0,0,37
2923,2022,1,Qassim Region Office,الطباعة واستنساخ وسائط الأعلام المسجّلة,54,26,1,0,81
2924,2022,1,Qassim Region Office,النقل البري و النقل عبر الأنابيب,875,157,14,2,1048
2925,2022,1,Qassim Region Office,النقل الجوي,11,9,1,2,23
2926,2022,1,Qassim Region Office,النقل المائي,11,1,0,0,12
2927,2022,1,Qassim Region Office,الهندسة المدنية,46,11,5,1,63
2928,2022,1,Qassim Region Office,تجارة التجزئة، باستثناء المركبات ذات المحركات والدراجات النارية,3408,678,53,6,4145
2929,2022,1,Qassim Region Office,تجارة الجملة ، باستثناء المركبات ذات المحركات والدراجات النارية,1671,569,55,4,2299
2930,2022,1,Qassim Region Office,تجارة الجملة والتجزئة ، وإصلاح المركبات ذات المحركات والدراجات النارية,2241,411,18,2,2672
2931,2022,1,Qassim Region Office,تجميع المياه ومعالجتها وتوصيلها,35,6,0,0,41
2932,2022,1,Qassim Region Office,تشييد المباني,7441,1856,247,39,9583
2933,2022,1,Qassim Region Office,تعدين الفحم والليغنيت,3,0,0,0,3
2934,2022,1,Qassim Region Office,تعدين ركازات الفلزات,42,11,1,0,54
2936,2022,1,Qassim Region Office,توصيل الكهرباء والغاز والبخار وتكييف الهواء,10,4,0,0,14
2937,2022,1,Qassim Region Office,صناعة الآلات والمعدات غير المصنفة في موضع أخر,39,8,2,0,49
2938,2022,1,Qassim Region Office,صناعة المركبات ذات المحركات والمركبات المقطورة ونصف المقطورة,27,6,1,0,34
2939,2022,1,Qassim Region Office,صناعة معدات النقل الأخرى,20,4,0,0,24
2940,2022,1,Qassim Region Office,صنع الأثاث,187,62,8,0,257
2941,2022,1,Qassim Region Office,صنع الحواسيب والمنتجات الإلكترونية والبصرية,51,11,1,0,63
2942,2022,1,Qassim Region Office,صُنع الخشب ومنتجات الخشب والفلين ، باستثناء الأثاث ، صُنع أصناف من القش ومواد الضفر,247,50,4,0,301
2943,2022,1,Qassim Region Office,صنع الفلزات القاعدية,232,42,3,0,277
2944,2022,1,Qassim Region Office,صُنع المشروبات,13,9,3,1,26
2946,2022,1,Qassim Region Office,صُنع الملبوسات,549,77,5,1,632
2947,2022,1,Qassim Region Office,صُنع المنتجات الجلدية والمنتجات ذات الصلة,8,0,0,0,8
2949,2022,1,Qassim Region Office,صُنع المنتجات الغذائية,405,104,35,6,550
2951,2022,1,Qassim Region Office,صُنع المواد الكيميائية والمنتجات الكيميائية,57,17,3,0,77
2952,2022,1,Qassim Region Office,صُنع الورق ومنتجات الورق,6,10,4,0,20
2953,2022,1,Qassim Region Office,صنع فحم الكوك والمنتجات النفطية المكررة,1,1,0,0,2
2956,2022,1,Qassim Region Office,صنع منتجات المعادن اللافلزية الأخرى,164,66,19,3,252
2957,2022,1,Qassim Region Office,صنع منتجات المعادن المشكلة ( باستثناء الآلات والمعدات ),659,103,10,3,775
2958,2022,1,Qassim Region Office,صيد الأسماك وتربية المائيات,21,2,0,0,23
2959,2022,1,Qassim Region Office,وكالات السفر ومشغّلو الجولات السياحية وخدمات الحجز والأنشطة المتصلة بها,43,14,0,0,57
2960,2022,1,Al-Madinah Al-Munawwarah Region Office,أبحاث الإعلان والسوق,48,5,0,0,53
2961,2022,1,Al-Madinah Al-Munawwarah Region Office,إصلاح أجهزة الحاسوب والسلع الشخصية والمنزلية,166,9,0,0,175
2962,2022,1,Al-Madinah Al-Munawwarah Region Office,إصلاح وتركيب الآلات والمعدات,76,8,0,0,84
2963,2022,1,Al-Madinah Al-Munawwarah Region Office,أنشطة أنتاج الأفلام والبرامج التلفزيونية والتسجيلات الصوتية و نشرالموسيقى,13,1,0,0,14
2964,2022,1,Al-Madinah Al-Munawwarah Region Office,أنشطة الأمن والتحقيقات,8,2,1,0,11
2965,2022,1,Al-Madinah Al-Munawwarah Region Office,أنشطة الاستخدام,40,12,0,0,52
2966,2022,1,Al-Madinah Al-Munawwarah Region Office,أنشطة الاسر المعيشية التي تستخدم أفراداً للعمل المنزلي,3,0,0,0,3
2967,2022,1,Al-Madinah Al-Munawwarah Region Office,أنشطة البرمجة الحاسوبية والخبرة الاستشارية وما يتصل بها من أنشطة,56,9,0,0,65
2970,2022,1,Al-Madinah Al-Munawwarah Region Office,أنشطة التشييد المتخصصة,1673,343,11,0,2027
2971,2022,1,Al-Madinah Al-Munawwarah Region Office,أنشطة الخدمات الشخصية الأخرى,1481,144,3,0,1628
2972,2022,1,Al-Madinah Al-Munawwarah Region Office,أنشطة الخدمات المالية ، فيما عدا تمويل التأمين وصناديق المعاشات,25,2,0,0,27
2973,2022,1,Al-Madinah Al-Munawwarah Region Office,أنشطة العمل الاجتماعي، دون إقامة، لكبار السن وذوي الإعاقة,70,37,10,0,117
2974,2022,1,Al-Madinah Al-Munawwarah Region Office,أنشطة المعمارية والهندسية ، والاختبارات الفنية والتحليل,87,55,4,1,147
2975,2022,1,Al-Madinah Al-Munawwarah Region Office,أنشطة المكاتب الرئيسية ، وألأنشطة الاستشارية في مجال الإدارة,58,10,1,0,69
2977,2022,1,Al-Madinah Al-Munawwarah Region Office,أنشطة المنظمات ذات العضوية,16,4,3,0,23
2978,2022,1,Al-Madinah Al-Munawwarah Region Office,أنشطة النشر,36,13,0,0,49
2979,2022,1,Al-Madinah Al-Munawwarah Region Office,أنشطة تقديم الخدمات للمباني وتجميل المواقع,840,231,17,2,1090
2980,2022,1,Al-Madinah Al-Munawwarah Region Office,أنشطة جمع النفايات ومعالجتها وتصريفها ، واسترجاع المواد,5,2,0,0,7
2981,2022,1,Al-Madinah Al-Munawwarah Region Office,أنشطة خدمات الأطعمة والمشروبات,3356,787,41,2,4186
2983,2022,1,Al-Madinah Al-Munawwarah Region Office,أنشطة خدمات دعم التعدين,5,8,0,0,13
2984,2022,1,Al-Madinah Al-Munawwarah Region Office,أنشطة زراعة المحاصيل والإنتاج الحيواني والصيد والخدمات المتصلة,640,60,3,0,703
2986,2022,1,Al-Madinah Al-Munawwarah Region Office,الإقامة,219,109,32,5,365
2988,2022,1,Al-Madinah Al-Munawwarah Region Office,الأنشطة الأخرى للتعدين واستغلال المحاجر,21,6,0,0,27
2989,2022,1,Al-Madinah Al-Munawwarah Region Office,الأنشطة الإدارية للمكاتب ، وأنشطة الدعم للمكاتب وغير ذلك من أنشطة الدعم للأعمال,101,7,0,0,108
2990,2022,1,Al-Madinah Al-Munawwarah Region Office,الأنشطة الإيجارية,687,46,3,0,736
2992,2022,1,Al-Madinah Al-Munawwarah Region Office,الأنشطة الرياضية وأنشطة التسلية والترفيه,72,19,1,0,92
2993,2022,1,Al-Madinah Al-Munawwarah Region Office,الأنشطة العقارية,163,22,4,0,189
2994,2022,1,Al-Madinah Al-Munawwarah Region Office,الأنشطة القانونية وأنشطة المحاسبة,44,10,0,0,54
2995,2022,1,Al-Madinah Al-Munawwarah Region Office,الأنشطة المساعدة لأنشطة الخدمات المالية وأنشطة التأمين,11,4,0,0,15
2996,2022,1,Al-Madinah Al-Munawwarah Region Office,الأنشطة المهنية والعلمية والتقنية الأخرى,47,13,1,0,61
2998,2022,1,Al-Madinah Al-Munawwarah Region Office,الاتصالات,43,3,0,0,46
3000,2022,1,Al-Madinah Al-Munawwarah Region Office,التخزين وأنشطة الدعم للنقل,219,34,1,3,257
3001,2022,1,Al-Madinah Al-Munawwarah Region Office,التعليم,80,64,24,1,169
3003,2022,1,Al-Madinah Al-Munawwarah Region Office,الرعاية مع الإقامة,10,5,0,0,15
3004,2022,1,Al-Madinah Al-Munawwarah Region Office,الصحة البشرية,34,95,24,5,158
3005,2022,1,Al-Madinah Al-Munawwarah Region Office,الصرف الصحي,2,2,0,0,4
3006,2022,1,Al-Madinah Al-Munawwarah Region Office,الصناعة التحويلية الأخرى,31,14,1,1,47
3007,2022,1,Al-Madinah Al-Munawwarah Region Office,الطباعة واستنساخ وسائط الأعلام المسجّلة,55,14,1,0,70
3008,2022,1,Al-Madinah Al-Munawwarah Region Office,النقل البري و النقل عبر الأنابيب,673,68,0,0,741
3009,2022,1,Al-Madinah Al-Munawwarah Region Office,النقل الجوي,9,2,0,0,11
3010,2022,1,Al-Madinah Al-Munawwarah Region Office,النقل المائي,8,0,0,0,8
3011,2022,1,Al-Madinah Al-Munawwarah Region Office,الهندسة المدنية,40,4,1,0,45
3012,2022,1,Al-Madinah Al-Munawwarah Region Office,تجارة التجزئة، باستثناء المركبات ذات المحركات والدراجات النارية,4920,954,50,4,5928
3013,2022,1,Al-Madinah Al-Munawwarah Region Office,تجارة الجملة ، باستثناء المركبات ذات المحركات والدراجات النارية,1573,397,32,2,2004
3014,2022,1,Al-Madinah Al-Munawwarah Region Office,تجارة الجملة والتجزئة ، وإصلاح المركبات ذات المحركات والدراجات النارية,1578,218,6,0,1802
3015,2022,1,Al-Madinah Al-Munawwarah Region Office,تجميع المياه ومعالجتها وتوصيلها,28,6,1,0,35
3016,2022,1,Al-Madinah Al-Munawwarah Region Office,تشييد المباني,3062,849,59,20,3990
3017,2022,1,Al-Madinah Al-Munawwarah Region Office,تعدين ركازات الفلزات,19,6,0,0,25
3019,2022,1,Al-Madinah Al-Munawwarah Region Office,توصيل الكهرباء والغاز والبخار وتكييف الهواء,15,9,2,0,26
3020,2022,1,Al-Madinah Al-Munawwarah Region Office,صناعة الآلات والمعدات غير المصنفة في موضع أخر,19,3,0,0,22
3021,2022,1,Al-Madinah Al-Munawwarah Region Office,صناعة المركبات ذات المحركات والمركبات المقطورة ونصف المقطورة,41,2,0,0,43
3022,2022,1,Al-Madinah Al-Munawwarah Region Office,صناعة معدات النقل الأخرى,10,4,0,0,14
3023,2022,1,Al-Madinah Al-Munawwarah Region Office,صنع الأثاث,185,39,1,0,225
3024,2022,1,Al-Madinah Al-Munawwarah Region Office,صنع الحواسيب والمنتجات الإلكترونية والبصرية,40,11,0,0,51
3025,2022,1,Al-Madinah Al-Munawwarah Region Office,صُنع الخشب ومنتجات الخشب والفلين ، باستثناء الأثاث ، صُنع أصناف من القش ومواد الضفر,108,20,0,0,128
3026,2022,1,Al-Madinah Al-Munawwarah Region Office,صنع الفلزات القاعدية,91,17,4,1,113
3028,2022,1,Al-Madinah Al-Munawwarah Region Office,صنع المعدات الكهربائية,70,15,0,0,85
3029,2022,1,Al-Madinah Al-Munawwarah Region Office,صُنع الملبوسات,663,75,3,0,741
3030,2022,1,Al-Madinah Al-Munawwarah Region Office,صُنع المنتجات الجلدية والمنتجات ذات الصلة,9,1,1,0,11
3031,2022,1,Al-Madinah Al-Munawwarah Region Office,صنع المنتجات الصيدلانية الأساسية والمستحضرات الصيدلانية,5,2,0,0,7
3032,2022,1,Al-Madinah Al-Munawwarah Region Office,صُنع المنتجات الغذائية,466,119,5,2,592
3033,2022,1,Al-Madinah Al-Munawwarah Region Office,صُنع المنسوجات,81,19,2,0,102
3034,2022,1,Al-Madinah Al-Munawwarah Region Office,صُنع المواد الكيميائية والمنتجات الكيميائية,37,13,2,0,52
3035,2022,1,Al-Madinah Al-Munawwarah Region Office,صُنع الورق ومنتجات الورق,3,4,1,0,8
3038,2022,1,Al-Madinah Al-Munawwarah Region Office,صنع منتجات المطاط واللدائن,28,18,4,0,50
3039,2022,1,Al-Madinah Al-Munawwarah Region Office,صنع منتجات المعادن اللافلزية الأخرى,115,47,11,0,173
3040,2022,1,Al-Madinah Al-Munawwarah Region Office,صنع منتجات المعادن المشكلة ( باستثناء الآلات والمعدات ),276,52,5,0,333
3041,2022,1,Al-Madinah Al-Munawwarah Region Office,صيد الأسماك وتربية المائيات,23,1,0,0,24
3042,2022,1,Al-Madinah Al-Munawwarah Region Office,وكالات السفر ومشغّلو الجولات السياحية وخدمات الحجز والأنشطة المتصلة بها,65,14,1,0,80
3043,2022,1,Tabuk Region Office,أبحاث الإعلان والسوق,16,0,1,0,17
3044,2022,1,Tabuk Region Office,إصلاح أجهزة الحاسوب والسلع الشخصية والمنزلية,178,34,0,0,212
3045,2022,1,Tabuk Region Office,إصلاح وتركيب الآلات والمعدات,60,1,0,0,61
3047,2022,1,Tabuk Region Office,أنشطة الأمن والتحقيقات,1,0,0,0,1
3048,2022,1,Tabuk Region Office,أنشطة الاستخدام,22,2,1,0,25
3050,2022,1,Tabuk Region Office,أنشطة البرمجة الحاسوبية والخبرة الاستشارية وما يتصل بها من أنشطة,7,1,0,0,8
3052,2022,1,Tabuk Region Office,أنشطة البريد ونقل الرسائل والطرود بواسطة مندوبين,4,0,0,0,4
3053,2022,1,Tabuk Region Office,أنشطة التشييد المتخصصة,1140,140,4,0,1284
3054,2022,1,Tabuk Region Office,أنشطة الخدمات الشخصية الأخرى,946,73,2,0,1021
3055,2022,1,Tabuk Region Office,أنشطة الخدمات المالية ، فيما عدا تمويل التأمين وصناديق المعاشات,17,3,0,0,20
3056,2022,1,Tabuk Region Office,أنشطة العمل الاجتماعي، دون إقامة، لكبار السن وذوي الإعاقة,28,12,1,0,41
3057,2022,1,Tabuk Region Office,أنشطة المعمارية والهندسية ، والاختبارات الفنية والتحليل,66,23,1,0,90
3058,2022,1,Tabuk Region Office,أنشطة المكاتب الرئيسية ، وألأنشطة الاستشارية في مجال الإدارة,10,1,0,0,11
3059,2022,1,Tabuk Region Office,أنشطة المكتبات ودور المحفوظات، والمتاحف والأنشطة الثقافية الأخرى,22,9,0,0,31
3060,2022,1,Tabuk Region Office,أنشطة المنظمات ذات العضوية,5,2,0,0,7
3061,2022,1,Tabuk Region Office,أنشطة النشر,7,1,0,0,8
3062,2022,1,Tabuk Region Office,أنشطة تقديم الخدمات للمباني وتجميل المواقع,355,59,5,1,420
3064,2022,1,Tabuk Region Office,أنشطة خدمات الأطعمة والمشروبات,1837,369,26,0,2232
3067,2022,1,Tabuk Region Office,أنشطة زراعة المحاصيل والإنتاج الحيواني والصيد والخدمات المتصلة,559,36,1,2,598
3069,2022,1,Tabuk Region Office,الإقامة,85,32,3,0,120
3070,2022,1,Tabuk Region Office,الأنشطة الإبداعية والفنون وأنشطة الترفيه,1,0,0,0,1
3071,2022,1,Tabuk Region Office,الأنشطة الأخرى للتعدين واستغلال المحاجر,6,2,0,0,8
3072,2022,1,Tabuk Region Office,الأنشطة الإدارية للمكاتب ، وأنشطة الدعم للمكاتب وغير ذلك من أنشطة الدعم للأعمال,45,4,1,0,50
3073,2022,1,Tabuk Region Office,الأنشطة الإيجارية,393,10,0,0,403
3075,2022,1,Tabuk Region Office,الأنشطة الرياضية وأنشطة التسلية والترفيه,55,9,0,0,64
3076,2022,1,Tabuk Region Office,الأنشطة العقارية,55,6,0,0,61
3077,2022,1,Tabuk Region Office,الأنشطة القانونية وأنشطة المحاسبة,8,1,0,0,9
3079,2022,1,Tabuk Region Office,الأنشطة المهنية والعلمية والتقنية الأخرى,20,2,0,0,22
3080,2022,1,Tabuk Region Office,الاتصالات,17,1,0,0,18
3082,2022,1,Tabuk Region Office,التخزين وأنشطة الدعم للنقل,74,7,0,0,81
3083,2022,1,Tabuk Region Office,التعليم,35,39,16,2,92
3085,2022,1,Tabuk Region Office,الصحة البشرية,22,47,11,1,81
3087,2022,1,Tabuk Region Office,الصناعة التحويلية الأخرى,14,0,0,0,14
3088,2022,1,Tabuk Region Office,الطباعة واستنساخ وسائط الأعلام المسجّلة,27,7,0,0,34
3089,2022,1,Tabuk Region Office,النقل البري و النقل عبر الأنابيب,467,61,5,0,533
3091,2022,1,Tabuk Region Office,النقل المائي,9,1,0,0,10
3092,2022,1,Tabuk Region Office,الهندسة المدنية,12,2,0,0,14
3093,2022,1,Tabuk Region Office,تجارة التجزئة، باستثناء المركبات ذات المحركات والدراجات النارية,2030,282,13,2,2327
3094,2022,1,Tabuk Region Office,تجارة الجملة ، باستثناء المركبات ذات المحركات والدراجات النارية,579,103,8,0,690
3095,2022,1,Tabuk Region Office,تجارة الجملة والتجزئة ، وإصلاح المركبات ذات المحركات والدراجات النارية,959,135,0,0,1094
3096,2022,1,Tabuk Region Office,تجميع المياه ومعالجتها وتوصيلها,40,4,0,0,44
3097,2022,1,Tabuk Region Office,تشييد المباني,2176,379,26,4,2585
3100,2022,1,Tabuk Region Office,توصيل الكهرباء والغاز والبخار وتكييف الهواء,9,2,0,0,11
3101,2022,1,Tabuk Region Office,صناعة الآلات والمعدات غير المصنفة في موضع أخر,19,2,0,0,21
3102,2022,1,Tabuk Region Office,صناعة المركبات ذات المحركات والمركبات المقطورة ونصف المقطورة,30,2,0,0,32
3104,2022,1,Tabuk Region Office,صنع الأثاث,149,23,0,0,172
3105,2022,1,Tabuk Region Office,صنع الحواسيب والمنتجات الإلكترونية والبصرية,42,4,1,0,47
3106,2022,1,Tabuk Region Office,صُنع الخشب ومنتجات الخشب والفلين ، باستثناء الأثاث ، صُنع أصناف من القش ومواد الضفر,86,22,0,0,108
3107,2022,1,Tabuk Region Office,صنع الفلزات القاعدية,22,3,1,0,26
3108,2022,1,Tabuk Region Office,صُنع المشروبات,25,7,1,0,33
3109,2022,1,Tabuk Region Office,صنع المعدات الكهربائية,44,5,0,0,49
3110,2022,1,Tabuk Region Office,صُنع الملبوسات,624,38,0,0,662
3111,2022,1,Tabuk Region Office,صُنع المنتجات الجلدية والمنتجات ذات الصلة,4,3,0,0,7
3113,2022,1,Tabuk Region Office,صُنع المنتجات الغذائية,196,41,2,2,241
3114,2022,1,Tabuk Region Office,صُنع المنسوجات,42,12,0,0,54
3116,2022,1,Tabuk Region Office,صُنع الورق ومنتجات الورق,2,4,0,0,6
3118,2022,1,Tabuk Region Office,صنع منتجات المطاط واللدائن,9,7,1,0,17
3119,2022,1,Tabuk Region Office,صنع منتجات المعادن اللافلزية الأخرى,51,22,0,0,73
3120,2022,1,Tabuk Region Office,صنع منتجات المعادن المشكلة ( باستثناء الآلات والمعدات ),158,36,1,1,196
3121,2022,1,Tabuk Region Office,صيد الأسماك وتربية المائيات,27,10,0,0,37
3122,2022,1,Tabuk Region Office,وكالات السفر ومشغّلو الجولات السياحية وخدمات الحجز والأنشطة المتصلة بها,23,3,0,0,26
3123,2022,1,Jazan Region Office,أبحاث الإعلان والسوق,24,3,0,0,27
3124,2022,1,Jazan Region Office,إصلاح أجهزة الحاسوب والسلع الشخصية والمنزلية,164,13,0,0,177
3125,2022,1,Jazan Region Office,إصلاح وتركيب الآلات والمعدات,160,6,0,0,166
3126,2022,1,Jazan Region Office,أنشطة أنتاج الأفلام والبرامج التلفزيونية والتسجيلات الصوتية و نشرالموسيقى,9,0,0,0,9
3127,2022,1,Jazan Region Office,أنشطة الأمن والتحقيقات,7,1,0,0,8
3128,2022,1,Jazan Region Office,أنشطة الاستخدام,22,2,0,0,24
3129,2022,1,Jazan Region Office,أنشطة الاسر المعيشية التي تستخدم أفراداً للعمل المنزلي,6,0,0,0,6
3130,2022,1,Jazan Region Office,أنشطة البرمجة الحاسوبية والخبرة الاستشارية وما يتصل بها من أنشطة,13,0,0,0,13
3131,2022,1,Jazan Region Office,أنشطة البريد ونقل الرسائل والطرود بواسطة مندوبين,1,0,0,0,1
3132,2022,1,Jazan Region Office,أنشطة التشييد المتخصصة,1304,151,6,1,1462
3133,2022,1,Jazan Region Office,أنشطة الخدمات الشخصية الأخرى,1289,86,0,0,1375
3134,2022,1,Jazan Region Office,أنشطة الخدمات المالية ، فيما عدا تمويل التأمين وصناديق المعاشات,28,5,0,0,33
3135,2022,1,Jazan Region Office,أنشطة العمل الاجتماعي، دون إقامة، لكبار السن وذوي الإعاقة,28,29,2,0,59
3137,2022,1,Jazan Region Office,أنشطة المعمارية والهندسية ، والاختبارات الفنية والتحليل,68,21,2,0,91
3138,2022,1,Jazan Region Office,أنشطة المكاتب الرئيسية ، وألأنشطة الاستشارية في مجال الإدارة,26,4,0,0,30
3139,2022,1,Jazan Region Office,أنشطة المكتبات ودور المحفوظات، والمتاحف والأنشطة الثقافية الأخرى,23,10,1,0,34
3140,2022,1,Jazan Region Office,أنشطة المنظمات ذات العضوية,30,4,0,0,34
3142,2022,1,Jazan Region Office,أنشطة تقديم الخدمات للمباني وتجميل المواقع,400,82,2,0,484
3144,2022,1,Jazan Region Office,أنشطة خدمات الأطعمة والمشروبات,3232,575,18,0,3825
3146,2022,1,Jazan Region Office,أنشطة خدمات دعم التعدين,10,6,0,0,16
3147,2022,1,Jazan Region Office,أنشطة زراعة المحاصيل والإنتاج الحيواني والصيد والخدمات المتصلة,491,31,1,0,523
3148,2022,1,Jazan Region Office,الإدارة العامة والدفاع ؛ والضمان الاجتماعي الإلزامي,20,6,0,0,26
3149,2022,1,Jazan Region Office,الإقامة,194,44,7,0,245
3151,2022,1,Jazan Region Office,الأنشطة الأخرى للتعدين واستغلال المحاجر,11,4,0,0,15
3152,2022,1,Jazan Region Office,الأنشطة الإدارية للمكاتب ، وأنشطة الدعم للمكاتب وغير ذلك من أنشطة الدعم للأعمال,44,2,0,0,46
3153,2022,1,Jazan Region Office,الأنشطة الإيجارية,1184,26,1,0,1211
3155,2022,1,Jazan Region Office,الأنشطة الرياضية وأنشطة التسلية والترفيه,46,8,1,0,55
3156,2022,1,Jazan Region Office,الأنشطة العقارية,72,14,0,1,87
3157,2022,1,Jazan Region Office,الأنشطة القانونية وأنشطة المحاسبة,15,3,0,0,18
3159,2022,1,Jazan Region Office,الأنشطة المهنية والعلمية والتقنية الأخرى,23,3,0,0,26
3163,2022,1,Jazan Region Office,التخزين وأنشطة الدعم للنقل,77,18,1,1,97
3164,2022,1,Jazan Region Office,التعليم,47,35,3,0,85
3165,2022,1,Jazan Region Office,الحراجة وقطع الأخشاب,1,1,0,0,2
3166,2022,1,Jazan Region Office,الرعاية مع الإقامة,9,4,0,0,13
3167,2022,1,Jazan Region Office,الصحة البشرية,37,64,12,2,115
3168,2022,1,Jazan Region Office,الصرف الصحي,1,2,0,0,3
3169,2022,1,Jazan Region Office,الصناعة التحويلية الأخرى,15,8,0,0,23
3170,2022,1,Jazan Region Office,الطباعة واستنساخ وسائط الأعلام المسجّلة,17,4,0,0,21
3171,2022,1,Jazan Region Office,النقل البري و النقل عبر الأنابيب,334,34,2,0,370
3172,2022,1,Jazan Region Office,النقل الجوي,8,2,0,0,10
3174,2022,1,Jazan Region Office,الهندسة المدنية,23,2,2,0,27
3175,2022,1,Jazan Region Office,تجارة التجزئة، باستثناء المركبات ذات المحركات والدراجات النارية,3837,535,16,1,4389
3176,2022,1,Jazan Region Office,تجارة الجملة ، باستثناء المركبات ذات المحركات والدراجات النارية,1370,306,20,1,1697
3177,2022,1,Jazan Region Office,تجارة الجملة والتجزئة ، وإصلاح المركبات ذات المحركات والدراجات النارية,1494,159,5,1,1659
3178,2022,1,Jazan Region Office,تجميع المياه ومعالجتها وتوصيلها,51,7,1,1,60
3179,2022,1,Jazan Region Office,تشييد المباني,2673,433,37,1,3144
3180,2022,1,Jazan Region Office,تعدين ركازات الفلزات,23,6,0,0,29
3183,2022,1,Jazan Region Office,صناعة الآلات والمعدات غير المصنفة في موضع أخر,37,3,0,0,40
3184,2022,1,Jazan Region Office,صناعة المركبات ذات المحركات والمركبات المقطورة ونصف المقطورة,83,4,0,0,87
3186,2022,1,Jazan Region Office,صنع الأثاث,181,16,0,0,197
3187,2022,1,Jazan Region Office,صنع الحواسيب والمنتجات الإلكترونية والبصرية,40,10,0,0,50
3188,2022,1,Jazan Region Office,صُنع الخشب ومنتجات الخشب والفلين ، باستثناء الأثاث ، صُنع أصناف من القش ومواد الضفر,159,15,0,0,174
3189,2022,1,Jazan Region Office,صنع الفلزات القاعدية,58,14,1,2,75
3190,2022,1,Jazan Region Office,صُنع المشروبات,15,3,3,1,22
3191,2022,1,Jazan Region Office,صنع المعدات الكهربائية,72,6,0,0,78
3192,2022,1,Jazan Region Office,صُنع الملبوسات,424,41,0,0,465
3193,2022,1,Jazan Region Office,صُنع المنتجات الجلدية والمنتجات ذات الصلة,48,1,0,0,49
3194,2022,1,Jazan Region Office,صنع المنتجات الصيدلانية الأساسية والمستحضرات الصيدلانية,6,1,0,0,7
3195,2022,1,Jazan Region Office,صُنع المنتجات الغذائية,288,73,5,0,366
3197,2022,1,Jazan Region Office,صُنع المواد الكيميائية والمنتجات الكيميائية,37,9,2,0,48
3198,2022,1,Jazan Region Office,صُنع الورق ومنتجات الورق,3,1,1,0,5
3199,2022,1,Jazan Region Office,صنع فحم الكوك والمنتجات النفطية المكررة,3,0,0,0,3
3201,2022,1,Jazan Region Office,صنع منتجات المطاط واللدائن,9,9,1,0,19
3202,2022,1,Jazan Region Office,صنع منتجات المعادن اللافلزية الأخرى,106,42,11,2,161
3203,2022,1,Jazan Region Office,صنع منتجات المعادن المشكلة ( باستثناء الآلات والمعدات ),438,18,1,0,457
3204,2022,1,Jazan Region Office,صيد الأسماك وتربية المائيات,128,66,4,0,198
3205,2022,1,Jazan Region Office,وكالات السفر ومشغّلو الجولات السياحية وخدمات الحجز والأنشطة المتصلة بها,20,2,0,0,22
3206,2022,1,Hail Region Office,أبحاث الإعلان والسوق,20,6,0,0,26
3207,2022,1,Hail Region Office,إصلاح أجهزة الحاسوب والسلع الشخصية والمنزلية,140,9,0,0,149
3208,2022,1,Hail Region Office,إصلاح وتركيب الآلات والمعدات,28,2,0,0,30
3209,2022,1,Hail Region Office,أنشطة أنتاج الأفلام والبرامج التلفزيونية والتسجيلات الصوتية و نشرالموسيقى,8,0,0,0,8
3210,2022,1,Hail Region Office,أنشطة الأمن والتحقيقات,4,1,0,0,5
3211,2022,1,Hail Region Office,أنشطة الاستخدام,11,3,0,0,14
3213,2022,1,Hail Region Office,أنشطة البرمجة الحاسوبية والخبرة الاستشارية وما يتصل بها من أنشطة,6,4,0,0,10
3215,2022,1,Hail Region Office,أنشطة التشييد المتخصصة,1208,178,2,0,1388
3216,2022,1,Hail Region Office,أنشطة الخدمات الشخصية الأخرى,792,71,1,0,864
3217,2022,1,Hail Region Office,أنشطة الخدمات المالية ، فيما عدا تمويل التأمين وصناديق المعاشات,25,2,0,0,27
3218,2022,1,Hail Region Office,أنشطة العمل الاجتماعي، دون إقامة، لكبار السن وذوي الإعاقة,40,21,0,0,61
3219,2022,1,Hail Region Office,أنشطة المعمارية والهندسية ، والاختبارات الفنية والتحليل,66,16,1,0,83
3220,2022,1,Hail Region Office,أنشطة المكاتب الرئيسية ، وألأنشطة الاستشارية في مجال الإدارة,21,2,0,0,23
3221,2022,1,Hail Region Office,أنشطة المكتبات ودور المحفوظات، والمتاحف والأنشطة الثقافية الأخرى,7,2,0,0,9
3222,2022,1,Hail Region Office,أنشطة المنظمات ذات العضوية,27,4,0,0,31
3223,2022,1,Hail Region Office,أنشطة النشر,37,0,0,0,37
3224,2022,1,Hail Region Office,أنشطة تقديم الخدمات للمباني وتجميل المواقع,359,55,8,1,423
3225,2022,1,Hail Region Office,أنشطة جمع النفايات ومعالجتها وتصريفها ، واسترجاع المواد,3,0,0,0,3
3226,2022,1,Hail Region Office,أنشطة خدمات الأطعمة والمشروبات,1647,293,18,1,1959
3229,2022,1,Hail Region Office,أنشطة زراعة المحاصيل والإنتاج الحيواني والصيد والخدمات المتصلة,1316,49,6,1,1372
3231,2022,1,Hail Region Office,الإقامة,69,20,1,0,90
3234,2022,1,Hail Region Office,الأنشطة الإدارية للمكاتب ، وأنشطة الدعم للمكاتب وغير ذلك من أنشطة الدعم للأعمال,53,5,0,0,58
3235,2022,1,Hail Region Office,الأنشطة الإيجارية,840,38,1,0,879
3237,2022,1,Hail Region Office,الأنشطة الرياضية وأنشطة التسلية والترفيه,45,19,0,0,64
3238,2022,1,Hail Region Office,الأنشطة العقارية,70,8,0,0,78
3239,2022,1,Hail Region Office,الأنشطة القانونية وأنشطة المحاسبة,7,3,0,0,10
3240,2022,1,Hail Region Office,الأنشطة المهنية والعلمية والتقنية الأخرى,15,0,1,0,16
3241,2022,1,Hail Region Office,الاتصالات,27,2,0,0,29
3242,2022,1,Hail Region Office,التخزين وأنشطة الدعم للنقل,68,14,0,0,82
3243,2022,1,Hail Region Office,التعليم,32,27,4,0,63
3246,2022,1,Hail Region Office,الصحة البشرية,42,57,16,2,117
3249,2022,1,Hail Region Office,الطباعة واستنساخ وسائط الأعلام المسجّلة,43,7,0,0,50
3250,2022,1,Hail Region Office,النقل البري و النقل عبر الأنابيب,503,39,2,0,544
3251,2022,1,Hail Region Office,النقل الجوي,22,6,0,0,28
3253,2022,1,Hail Region Office,الهندسة المدنية,14,6,1,0,21
3254,2022,1,Hail Region Office,تجارة التجزئة، باستثناء المركبات ذات المحركات والدراجات النارية,1626,290,16,0,1932
3255,2022,1,Hail Region Office,تجارة الجملة ، باستثناء المركبات ذات المحركات والدراجات النارية,490,99,8,2,599
3256,2022,1,Hail Region Office,تجارة الجملة والتجزئة ، وإصلاح المركبات ذات المحركات والدراجات النارية,796,148,2,0,946
3257,2022,1,Hail Region Office,تجميع المياه ومعالجتها وتوصيلها,18,2,1,0,21
3258,2022,1,Hail Region Office,تشييد المباني,2857,588,58,8,3511
3259,2022,1,Hail Region Office,تعدين الفحم والليغنيت,2,0,0,0,2
3261,2022,1,Hail Region Office,تمويل التأمين وإعادة التأمين وصناديق المعاشات التقاعدية باستثناء الضمان الاجتماعي الإلزامي,1,0,0,0,1
3263,2022,1,Hail Region Office,صناعة الآلات والمعدات غير المصنفة في موضع أخر,23,3,0,0,26
3265,2022,1,Hail Region Office,صناعة معدات النقل الأخرى,5,0,0,0,5
3266,2022,1,Hail Region Office,صنع الأثاث,131,23,0,0,154
3267,2022,1,Hail Region Office,صنع الحواسيب والمنتجات الإلكترونية والبصرية,36,4,0,0,40
3268,2022,1,Hail Region Office,صُنع الخشب ومنتجات الخشب والفلين ، باستثناء الأثاث ، صُنع أصناف من القش ومواد الضفر,61,8,1,0,70
3269,2022,1,Hail Region Office,صنع الفلزات القاعدية,87,27,3,0,117
3270,2022,1,Hail Region Office,صُنع المشروبات,7,7,0,0,14
3271,2022,1,Hail Region Office,صنع المعدات الكهربائية,45,3,0,0,48
3272,2022,1,Hail Region Office,صُنع الملبوسات,324,35,0,0,359
3275,2022,1,Hail Region Office,صُنع المنتجات الغذائية,200,35,7,0,242
3276,2022,1,Hail Region Office,صُنع المنسوجات,53,22,0,0,75
3277,2022,1,Hail Region Office,صُنع المواد الكيميائية والمنتجات الكيميائية,85,34,0,0,119
3279,2022,1,Hail Region Office,صنع منتجات المطاط واللدائن,13,7,3,0,23
3280,2022,1,Hail Region Office,صنع منتجات المعادن اللافلزية الأخرى,109,35,8,1,153
3281,2022,1,Hail Region Office,صنع منتجات المعادن المشكلة ( باستثناء الآلات والمعدات ),114,37,0,0,151
3282,2022,1,Hail Region Office,صيد الأسماك وتربية المائيات,32,0,0,0,32
3283,2022,1,Hail Region Office,وكالات السفر ومشغّلو الجولات السياحية وخدمات الحجز والأنشطة المتصلة بها,10,1,0,0,11
3284,2022,1,Asir Region Office,أبحاث الإعلان والسوق,42,2,0,0,44
3285,2022,1,Asir Region Office,إصلاح أجهزة الحاسوب والسلع الشخصية والمنزلية,231,33,1,0,265
3286,2022,1,Asir Region Office,إصلاح وتركيب الآلات والمعدات,66,3,1,0,70
3287,2022,1,Asir Region Office,أنشطة أنتاج الأفلام والبرامج التلفزيونية والتسجيلات الصوتية و نشرالموسيقى,13,0,0,0,13
3288,2022,1,Asir Region Office,أنشطة الأمن والتحقيقات,12,4,2,1,19
3289,2022,1,Asir Region Office,أنشطة الاستخدام,42,7,0,1,50
3290,2022,1,Asir Region Office,أنشطة البرمجة الحاسوبية والخبرة الاستشارية وما يتصل بها من أنشطة,18,6,0,0,24
3291,2022,1,Asir Region Office,أنشطة البرمجة والإذاعة,7,3,0,0,10
3292,2022,1,Asir Region Office,أنشطة البريد ونقل الرسائل والطرود بواسطة مندوبين,7,2,0,0,9
3293,2022,1,Asir Region Office,أنشطة التشييد المتخصصة,1858,262,10,1,2131
3294,2022,1,Asir Region Office,أنشطة الخدمات الشخصية الأخرى,1246,122,3,0,1371
3295,2022,1,Asir Region Office,أنشطة الخدمات المالية ، فيما عدا تمويل التأمين وصناديق المعاشات,20,1,0,0,21
3296,2022,1,Asir Region Office,أنشطة العمل الاجتماعي، دون إقامة، لكبار السن وذوي الإعاقة,49,42,5,0,96
3297,2022,1,Asir Region Office,أنشطة المعمارية والهندسية ، والاختبارات الفنية والتحليل,120,45,3,1,169
3298,2022,1,Asir Region Office,أنشطة المكاتب الرئيسية ، وألأنشطة الاستشارية في مجال الإدارة,24,2,1,0,27
3299,2022,1,Asir Region Office,أنشطة المكتبات ودور المحفوظات، والمتاحف والأنشطة الثقافية الأخرى,31,18,1,0,50
3301,2022,1,Asir Region Office,أنشطة النشر,16,1,1,0,18
3302,2022,1,Asir Region Office,أنشطة تقديم الخدمات للمباني وتجميل المواقع,433,72,5,2,512
3303,2022,1,Asir Region Office,أنشطة جمع النفايات ومعالجتها وتصريفها ، واسترجاع المواد,7,1,0,0,8
3304,2022,1,Asir Region Office,أنشطة خدمات الأطعمة والمشروبات,3743,913,62,4,4722
3305,2022,1,Asir Region Office,أنشطة خدمات المعلومات,19,3,0,0,22
3306,2022,1,Asir Region Office,أنشطة خدمات دعم التعدين,25,5,1,0,31
3307,2022,1,Asir Region Office,أنشطة زراعة المحاصيل والإنتاج الحيواني والصيد والخدمات المتصلة,1200,39,2,0,1241
3309,2022,1,Asir Region Office,الإقامة,247,75,5,1,328
3311,2022,1,Asir Region Office,الأنشطة الأخرى للتعدين واستغلال المحاجر,18,5,0,0,23
3312,2022,1,Asir Region Office,الأنشطة الإدارية للمكاتب ، وأنشطة الدعم للمكاتب وغير ذلك من أنشطة الدعم للأعمال,98,6,1,1,106
3313,2022,1,Asir Region Office,الأنشطة الإيجارية,1044,71,2,1,1118
3314,2022,1,Asir Region Office,الأنشطة البيطرية,10,6,2,0,18
3315,2022,1,Asir Region Office,الأنشطة الرياضية وأنشطة التسلية والترفيه,85,32,0,0,117
3316,2022,1,Asir Region Office,الأنشطة العقارية,110,20,1,0,131
3317,2022,1,Asir Region Office,الأنشطة القانونية وأنشطة المحاسبة,28,4,0,0,32
3318,2022,1,Asir Region Office,الأنشطة المساعدة لأنشطة الخدمات المالية وأنشطة التأمين,5,0,0,0,5
3319,2022,1,Asir Region Office,الأنشطة المهنية والعلمية والتقنية الأخرى,30,4,2,0,36
3321,2022,1,Asir Region Office,الاتصالات,24,2,0,0,26
3322,2022,1,Asir Region Office,التخزين وأنشطة الدعم للنقل,90,27,3,0,120
3323,2022,1,Asir Region Office,التعليم,37,38,13,1,89
3324,2022,1,Asir Region Office,الرعاية مع الإقامة,13,3,0,0,16
3325,2022,1,Asir Region Office,الصحة البشرية,68,96,37,6,207
3326,2022,1,Asir Region Office,الصرف الصحي,1,2,1,0,4
3327,2022,1,Asir Region Office,الصناعة التحويلية الأخرى,24,12,1,0,37
3328,2022,1,Asir Region Office,الطباعة واستنساخ وسائط الأعلام المسجّلة,32,13,1,0,46
3329,2022,1,Asir Region Office,النقل البري و النقل عبر الأنابيب,1271,161,6,2,1440
3331,2022,1,Asir Region Office,النقل المائي,11,0,0,0,11
3332,2022,1,Asir Region Office,الهندسة المدنية,36,10,2,0,48
3333,2022,1,Asir Region Office,تجارة التجزئة، باستثناء المركبات ذات المحركات والدراجات النارية,3877,706,47,4,4634
3334,2022,1,Asir Region Office,تجارة الجملة ، باستثناء المركبات ذات المحركات والدراجات النارية,1059,250,19,3,1331
3335,2022,1,Asir Region Office,تجارة الجملة والتجزئة ، وإصلاح المركبات ذات المحركات والدراجات النارية,1750,360,12,0,2122
3336,2022,1,Asir Region Office,تجميع المياه ومعالجتها وتوصيلها,103,27,0,0,130
3337,2022,1,Asir Region Office,تشييد المباني,5955,1386,115,17,7473
3338,2022,1,Asir Region Office,تعدين ركازات الفلزات,89,17,0,0,106
3340,2022,1,Asir Region Office,توصيل الكهرباء والغاز والبخار وتكييف الهواء,9,8,1,1,19
3341,2022,1,Asir Region Office,صناعة الآلات والمعدات غير المصنفة في موضع أخر,39,6,0,0,45
3343,2022,1,Asir Region Office,صناعة معدات النقل الأخرى,8,1,0,0,9
3344,2022,1,Asir Region Office,صنع الأثاث,238,30,0,0,268
3345,2022,1,Asir Region Office,صنع الحواسيب والمنتجات الإلكترونية والبصرية,64,21,0,0,85
3346,2022,1,Asir Region Office,صُنع الخشب ومنتجات الخشب والفلين ، باستثناء الأثاث ، صُنع أصناف من القش ومواد الضفر,247,57,1,0,305
3347,2022,1,Asir Region Office,صنع الفلزات القاعدية,110,31,0,0,141
3348,2022,1,Asir Region Office,صُنع المشروبات,22,8,1,0,31
3349,2022,1,Asir Region Office,صنع المعدات الكهربائية,49,10,0,0,59
3350,2022,1,Asir Region Office,صُنع الملبوسات,543,57,1,0,601
3351,2022,1,Asir Region Office,صُنع المنتجات الجلدية والمنتجات ذات الصلة,10,3,0,0,13
3353,2022,1,Asir Region Office,صُنع المنتجات الغذائية,338,109,10,1,458
3355,2022,1,Asir Region Office,صُنع المواد الكيميائية والمنتجات الكيميائية,49,22,5,0,76
3356,2022,1,Asir Region Office,صُنع الورق ومنتجات الورق,8,4,1,0,13
3359,2022,1,Asir Region Office,صنع منتجات المطاط واللدائن,35,12,2,1,50
3360,2022,1,Asir Region Office,صنع منتجات المعادن اللافلزية الأخرى,155,86,17,2,260
3361,2022,1,Asir Region Office,صنع منتجات المعادن المشكلة ( باستثناء الآلات والمعدات ),363,33,3,0,399
3362,2022,1,Asir Region Office,صيد الأسماك وتربية المائيات,83,16,0,0,99
3364,2022,1,Makkah / Jeddah Region Office,أبحاث الإعلان والسوق,258,43,1,0,302
3365,2022,1,Makkah / Jeddah Region Office,إصلاح أجهزة الحاسوب والسلع الشخصية والمنزلية,511,86,7,1,605
3366,2022,1,Makkah / Jeddah Region Office,إصلاح وتركيب الآلات والمعدات,241,51,13,1,306
3367,2022,1,Makkah / Jeddah Region Office,أنشطة أنتاج الأفلام والبرامج التلفزيونية والتسجيلات الصوتية و نشرالموسيقى,102,21,0,0,123
3368,2022,1,Makkah / Jeddah Region Office,أنشطة الأمن والتحقيقات,38,20,8,3,69
3369,2022,1,Makkah / Jeddah Region Office,أنشطة الاستخدام,147,28,5,3,183
3371,2022,1,Makkah / Jeddah Region Office,أنشطة البرمجة الحاسوبية والخبرة الاستشارية وما يتصل بها من أنشطة,335,128,11,3,477
3373,2022,1,Makkah / Jeddah Region Office,أنشطة البريد ونقل الرسائل والطرود بواسطة مندوبين,29,4,0,0,33
3374,2022,1,Makkah / Jeddah Region Office,أنشطة التشييد المتخصصة,5552,1745,132,23,7452
3375,2022,1,Makkah / Jeddah Region Office,أنشطة الخدمات الشخصية الأخرى,3267,523,32,4,3826
3376,2022,1,Makkah / Jeddah Region Office,أنشطة الخدمات المالية ، فيما عدا تمويل التأمين وصناديق المعاشات,90,32,6,2,130
3377,2022,1,Makkah / Jeddah Region Office,أنشطة العمل الاجتماعي، دون إقامة، لكبار السن وذوي الإعاقة,138,133,13,0,284
3378,2022,1,Makkah / Jeddah Region Office,أنشطة المعالجة وخدمات إدارة النفايات الأخرى,3,2,0,0,5
3379,2022,1,Makkah / Jeddah Region Office,أنشطة المعمارية والهندسية ، والاختبارات الفنية والتحليل,398,238,19,6,661
3380,2022,1,Makkah / Jeddah Region Office,أنشطة المكاتب الرئيسية ، وألأنشطة الاستشارية في مجال الإدارة,354,171,3,0,528
3381,2022,1,Makkah / Jeddah Region Office,أنشطة المكتبات ودور المحفوظات، والمتاحف والأنشطة الثقافية الأخرى,63,44,3,1,111
3383,2022,1,Makkah / Jeddah Region Office,أنشطة المنظمات ذات العضوية,34,13,0,0,47
3384,2022,1,Makkah / Jeddah Region Office,أنشطة النشر,90,19,3,0,112
3385,2022,1,Makkah / Jeddah Region Office,أنشطة تقديم الخدمات للمباني وتجميل المواقع,1902,854,84,33,2873
3386,2022,1,Makkah / Jeddah Region Office,أنشطة جمع النفايات ومعالجتها وتصريفها ، واسترجاع المواد,29,9,2,0,40
3387,2022,1,Makkah / Jeddah Region Office,أنشطة خدمات الأطعمة والمشروبات,6381,1981,243,31,8636
3388,2022,1,Makkah / Jeddah Region Office,أنشطة خدمات المعلومات,119,39,4,0,162
3390,2022,1,Makkah / Jeddah Region Office,أنشطة زراعة المحاصيل والإنتاج الحيواني والصيد والخدمات المتصلة,583,89,8,2,682
3392,2022,1,Makkah / Jeddah Region Office,الإدارة العامة والدفاع ؛ والضمان الاجتماعي الإلزامي,284,153,17,2,456
3393,2022,1,Makkah / Jeddah Region Office,الإقامة,394,305,37,6,742
3394,2022,1,Makkah / Jeddah Region Office,الأنشطة الإبداعية والفنون وأنشطة الترفيه,62,14,1,0,77
3395,2022,1,Makkah / Jeddah Region Office,الأنشطة الأخرى للتعدين واستغلال المحاجر,54,17,4,2,77
3396,2022,1,Makkah / Jeddah Region Office,الأنشطة الإدارية للمكاتب ، وأنشطة الدعم للمكاتب وغير ذلك من أنشطة الدعم للأعمال,551,62,9,0,622
3397,2022,1,Makkah / Jeddah Region Office,الأنشطة الإيجارية,1128,144,14,3,1289
3398,2022,1,Makkah / Jeddah Region Office,الأنشطة البيطرية,23,17,3,0,43
3399,2022,1,Makkah / Jeddah Region Office,الأنشطة الرياضية وأنشطة التسلية والترفيه,290,100,10,1,401
3400,2022,1,Makkah / Jeddah Region Office,الأنشطة العقارية,677,219,33,1,930
3401,2022,1,Makkah / Jeddah Region Office,الأنشطة القانونية وأنشطة المحاسبة,262,96,7,1,366
3403,2022,1,Makkah / Jeddah Region Office,الأنشطة المهنية والعلمية والتقنية الأخرى,206,28,1,0,235
3405,2022,1,Makkah / Jeddah Region Office,الاتصالات,144,47,4,0,195
3407,2022,1,Makkah / Jeddah Region Office,التخزين وأنشطة الدعم للنقل,425,195,43,11,674
3408,2022,1,Makkah / Jeddah Region Office,التعليم,244,272,89,14,619
3410,2022,1,Makkah / Jeddah Region Office,الرعاية مع الإقامة,11,11,0,0,22
3411,2022,1,Makkah / Jeddah Region Office,الصحة البشرية,256,365,128,32,781
3412,2022,1,Makkah / Jeddah Region Office,الصرف الصحي,11,14,2,1,28
3413,2022,1,Makkah / Jeddah Region Office,الصناعة التحويلية الأخرى,97,82,8,3,190
3414,2022,1,Makkah / Jeddah Region Office,الطباعة واستنساخ وسائط الأعلام المسجّلة,202,133,26,2,363
3415,2022,1,Makkah / Jeddah Region Office,النقل البري و النقل عبر الأنابيب,1335,377,57,12,1781
3416,2022,1,Makkah / Jeddah Region Office,النقل الجوي,45,51,18,10,124
3417,2022,1,Makkah / Jeddah Region Office,النقل المائي,72,38,10,4,124
3418,2022,1,Makkah / Jeddah Region Office,الهندسة المدنية,98,38,14,1,151
3419,2022,1,Makkah / Jeddah Region Office,تجارة التجزئة، باستثناء المركبات ذات المحركات والدراجات النارية,11216,3099,281,67,14663
3420,2022,1,Makkah / Jeddah Region Office,تجارة الجملة ، باستثناء المركبات ذات المحركات والدراجات النارية,8915,4528,482,90,14015
3421,2022,1,Makkah / Jeddah Region Office,تجارة الجملة والتجزئة ، وإصلاح المركبات ذات المحركات والدراجات النارية,3282,831,57,19,4189
3422,2022,1,Makkah / Jeddah Region Office,تجميع المياه ومعالجتها وتوصيلها,59,26,2,3,90
3423,2022,1,Makkah / Jeddah Region Office,تشييد المباني,8372,3235,403,108,12118
3424,2022,1,Makkah / Jeddah Region Office,تعدين الفحم والليغنيت,7,2,0,0,9
3425,2022,1,Makkah / Jeddah Region Office,تعدين ركازات الفلزات,33,15,6,3,57
3426,2022,1,Makkah / Jeddah Region Office,تمويل التأمين وإعادة التأمين وصناديق المعاشات التقاعدية باستثناء الضمان الاجتماعي الإلزامي,8,27,9,4,48
3427,2022,1,Makkah / Jeddah Region Office,توصيل الكهرباء والغاز والبخار وتكييف الهواء,48,30,12,7,97
3428,2022,1,Makkah / Jeddah Region Office,صناعة الآلات والمعدات غير المصنفة في موضع أخر,72,21,7,1,101
3429,2022,1,Makkah / Jeddah Region Office,صناعة المركبات ذات المحركات والمركبات المقطورة ونصف المقطورة,70,28,6,0,104
3430,2022,1,Makkah / Jeddah Region Office,صناعة معدات النقل الأخرى,58,20,2,2,82
3431,2022,1,Makkah / Jeddah Region Office,صنع الأثاث,238,105,21,2,366
3432,2022,1,Makkah / Jeddah Region Office,صنع الحواسيب والمنتجات الإلكترونية والبصرية,133,68,17,2,220
3433,2022,1,Makkah / Jeddah Region Office,صُنع الخشب ومنتجات الخشب والفلين ، باستثناء الأثاث ، صُنع أصناف من القش ومواد الضفر,253,67,17,3,340
3434,2022,1,Makkah / Jeddah Region Office,صنع الفلزات القاعدية,102,110,37,7,256
3435,2022,1,Makkah / Jeddah Region Office,صُنع المشروبات,60,43,12,6,121
3436,2022,1,Makkah / Jeddah Region Office,صنع المعدات الكهربائية,150,73,11,2,236
3437,2022,1,Makkah / Jeddah Region Office,صُنع الملبوسات,1052,186,13,2,1253
3439,2022,1,Makkah / Jeddah Region Office,صنع المنتجات الصيدلانية الأساسية والمستحضرات الصيدلانية,13,11,7,1,32
3440,2022,1,Makkah / Jeddah Region Office,صُنع المنتجات الغذائية,730,387,66,23,1206
3441,2022,1,Makkah / Jeddah Region Office,صُنع المنسوجات,81,37,15,2,135
3442,2022,1,Makkah / Jeddah Region Office,صُنع المواد الكيميائية والمنتجات الكيميائية,216,137,37,4,394
3443,2022,1,Makkah / Jeddah Region Office,صُنع الورق ومنتجات الورق,38,46,12,5,101
3444,2022,1,Makkah / Jeddah Region Office,صنع فحم الكوك والمنتجات النفطية المكررة,11,14,3,0,28
3445,2022,1,Makkah / Jeddah Region Office,صُنع منتجات التبغ,5,3,0,0,8
3446,2022,1,Makkah / Jeddah Region Office,صنع منتجات المطاط واللدائن,85,107,49,9,250
3447,2022,1,Makkah / Jeddah Region Office,صنع منتجات المعادن اللافلزية الأخرى,160,97,31,13,301
3448,2022,1,Makkah / Jeddah Region Office,صنع منتجات المعادن المشكلة ( باستثناء الآلات والمعدات ),315,116,40,8,479
3449,2022,1,Makkah / Jeddah Region Office,صيد الأسماك وتربية المائيات,196,57,0,0,253
3450,2022,1,Makkah / Jeddah Region Office,وكالات السفر ومشغّلو الجولات السياحية وخدمات الحجز والأنشطة المتصلة بها,175,89,8,0,272
3451,2022,1,Najran Region Office,أبحاث الإعلان والسوق,11,2,0,0,13
3452,2022,1,Najran Region Office,إصلاح أجهزة الحاسوب والسلع الشخصية والمنزلية,68,6,0,0,74
3453,2022,1,Najran Region Office,إصلاح وتركيب الآلات والمعدات,41,5,0,1,47
3455,2022,1,Najran Region Office,أنشطة الأمن والتحقيقات,2,0,0,1,3
3456,2022,1,Najran Region Office,أنشطة الاستخدام,16,3,0,0,19
3460,2022,1,Najran Region Office,أنشطة التشييد المتخصصة,1436,238,11,6,1691
3461,2022,1,Najran Region Office,أنشطة الخدمات الشخصية الأخرى,534,38,0,0,572
3462,2022,1,Najran Region Office,أنشطة الخدمات المالية ، فيما عدا تمويل التأمين وصناديق المعاشات,20,1,0,0,21
3463,2022,1,Najran Region Office,أنشطة العمل الاجتماعي، دون إقامة، لكبار السن وذوي الإعاقة,21,6,0,0,27
3465,2022,1,Najran Region Office,أنشطة المعمارية والهندسية ، والاختبارات الفنية والتحليل,50,18,2,0,70
3466,2022,1,Najran Region Office,أنشطة المكاتب الرئيسية ، وألأنشطة الاستشارية في مجال الإدارة,13,2,0,0,15
3469,2022,1,Najran Region Office,أنشطة المنظمات ذات العضوية,18,0,0,0,18
3470,2022,1,Najran Region Office,أنشطة النشر,16,4,0,0,20
3471,2022,1,Najran Region Office,أنشطة تقديم الخدمات للمباني وتجميل المواقع,185,30,4,4,223
3473,2022,1,Najran Region Office,أنشطة خدمات الأطعمة والمشروبات,1241,235,14,2,1492
3476,2022,1,Najran Region Office,أنشطة زراعة المحاصيل والإنتاج الحيواني والصيد والخدمات المتصلة,852,24,4,0,880
3477,2022,1,Najran Region Office,استخراج النفط الخام والغاز الطبيعي,2,0,0,0,2
3478,2022,1,Najran Region Office,الإدارة العامة والدفاع ؛ والضمان الاجتماعي الإلزامي,51,17,1,0,69
3479,2022,1,Najran Region Office,الإقامة,81,22,1,1,105
3481,2022,1,Najran Region Office,الأنشطة الأخرى للتعدين واستغلال المحاجر,7,0,0,0,7
3482,2022,1,Najran Region Office,الأنشطة الإدارية للمكاتب ، وأنشطة الدعم للمكاتب وغير ذلك من أنشطة الدعم للأعمال,39,2,0,0,41
3483,2022,1,Najran Region Office,الأنشطة الإيجارية,1240,73,2,1,1316
3484,2022,1,Najran Region Office,الأنشطة البيطرية,3,3,0,0,6
3485,2022,1,Najran Region Office,الأنشطة الرياضية وأنشطة التسلية والترفيه,24,13,0,1,38
3486,2022,1,Najran Region Office,الأنشطة العقارية,33,4,0,0,37
3491,2022,1,Najran Region Office,التخزين وأنشطة الدعم للنقل,235,64,2,0,301
3492,2022,1,Najran Region Office,التعليم,16,16,6,0,38
3493,2022,1,Najran Region Office,الرعاية مع الإقامة,3,1,0,0,4
3494,2022,1,Najran Region Office,الصحة البشرية,17,48,12,1,78
3497,2022,1,Najran Region Office,النقل البري و النقل عبر الأنابيب,813,88,0,1,902
3498,2022,1,Najran Region Office,النقل الجوي,6,3,0,0,9
3499,2022,1,Najran Region Office,النقل المائي,11,1,0,0,12
3500,2022,1,Najran Region Office,الهندسة المدنية,11,4,4,3,22
3501,2022,1,Najran Region Office,تجارة التجزئة، باستثناء المركبات ذات المحركات والدراجات النارية,1591,361,23,2,1977
3502,2022,1,Najran Region Office,تجارة الجملة ، باستثناء المركبات ذات المحركات والدراجات النارية,470,99,11,1,581
3503,2022,1,Najran Region Office,تجارة الجملة والتجزئة ، وإصلاح المركبات ذات المحركات والدراجات النارية,550,110,3,0,663
3504,2022,1,Najran Region Office,تجميع المياه ومعالجتها وتوصيلها,19,5,0,0,24
3505,2022,1,Najran Region Office,تشييد المباني,2376,535,69,13,2993
3509,2022,1,Najran Region Office,صناعة الآلات والمعدات غير المصنفة في موضع أخر,10,2,0,0,12
3512,2022,1,Najran Region Office,صنع الأثاث,85,22,1,0,108
3513,2022,1,Najran Region Office,صنع الحواسيب والمنتجات الإلكترونية والبصرية,15,2,0,0,17
3514,2022,1,Najran Region Office,صُنع الخشب ومنتجات الخشب والفلين ، باستثناء الأثاث ، صُنع أصناف من القش ومواد الضفر,77,9,0,0,86
3515,2022,1,Najran Region Office,صنع الفلزات القاعدية,81,17,1,1,100
3517,2022,1,Najran Region Office,صنع المعدات الكهربائية,14,2,0,0,16
3518,2022,1,Najran Region Office,صُنع الملبوسات,311,26,0,0,337
3521,2022,1,Najran Region Office,صُنع المنتجات الغذائية,134,25,1,0,160
3522,2022,1,Najran Region Office,صُنع المنسوجات,35,7,0,0,42
3524,2022,1,Najran Region Office,صُنع الورق ومنتجات الورق,14,3,1,0,18
3525,2022,1,Najran Region Office,صنع منتجات المطاط واللدائن,21,2,0,0,23
3526,2022,1,Najran Region Office,صنع منتجات المعادن اللافلزية الأخرى,61,20,7,1,89
3527,2022,1,Najran Region Office,صنع منتجات المعادن المشكلة ( باستثناء الآلات والمعدات ),155,22,4,0,181
3528,2022,1,Najran Region Office,صيد الأسماك وتربية المائيات,37,1,0,0,38
3530,2022,1,Head Office,أنشطة التشييد المتخصصة,1,0,0,0,1
3532,2022,1,Head Office,أنشطة خدمات الأطعمة والمشروبات,4,1,0,0,5
3533,2022,1,Head Office,أنشطة زراعة المحاصيل والإنتاج الحيواني والصيد والخدمات المتصلة,2,2,0,0,4
3536,2022,1,Head Office,التخزين وأنشطة الدعم للنقل,1,0,0,0,1
3537,2022,1,Head Office,النقل البري و النقل عبر الأنابيب,1,0,0,0,1
3538,2022,1,Head Office,تجارة التجزئة، باستثناء المركبات ذات المحركات والدراجات النارية,5,0,0,0,5
3539,2022,1,Head Office,تجارة الجملة ، باستثناء المركبات ذات المحركات والدراجات النارية,1,0,0,0,1
3540,2022,1,Head Office,تجارة الجملة والتجزئة ، وإصلاح المركبات ذات المحركات والدراجات النارية,1,0,0,0,1
3541,2022,1,Head Office,تشييد المباني,2,1,0,0,3
3545,2022,1,Eastern Region Office,أبحاث الإعلان والسوق,177,33,1,0,211
3546,2022,1,Eastern Region Office,إصلاح أجهزة الحاسوب والسلع الشخصية والمنزلية,332,67,8,2,409
3547,2022,1,Eastern Region Office,إصلاح وتركيب الآلات والمعدات,251,95,8,2,356
3548,2022,1,Eastern Region Office,أنشطة أنتاج الأفلام والبرامج التلفزيونية والتسجيلات الصوتية و نشرالموسيقى,28,7,0,0,35
3549,2022,1,Eastern Region Office,أنشطة الأمن والتحقيقات,26,23,9,6,64
3550,2022,1,Eastern Region Office,أنشطة الاستخدام,97,23,6,6,132
3551,2022,1,Eastern Region Office,أنشطة الاسر المعيشية التي تستخدم أفراداً للعمل المنزلي,3,0,0,0,3
3552,2022,1,Eastern Region Office,أنشطة البرمجة الحاسوبية والخبرة الاستشارية وما يتصل بها من أنشطة,148,55,9,1,213
3554,2022,1,Eastern Region Office,أنشطة البريد ونقل الرسائل والطرود بواسطة مندوبين,17,2,1,0,20
3555,2022,1,Eastern Region Office,أنشطة التشييد المتخصصة,2910,1029,123,20,4082
3556,2022,1,Eastern Region Office,أنشطة الخدمات الشخصية الأخرى,2398,401,27,3,2829
3557,2022,1,Eastern Region Office,أنشطة الخدمات المالية ، فيما عدا تمويل التأمين وصناديق المعاشات,48,18,6,1,73
3558,2022,1,Eastern Region Office,أنشطة العمل الاجتماعي، دون إقامة، لكبار السن وذوي الإعاقة,75,77,4,0,156
3560,2022,1,Eastern Region Office,أنشطة المعمارية والهندسية ، والاختبارات الفنية والتحليل,210,174,41,19,444
3561,2022,1,Eastern Region Office,أنشطة المكاتب الرئيسية ، وألأنشطة الاستشارية في مجال الإدارة,164,57,8,1,230
3562,2022,1,Eastern Region Office,أنشطة المكتبات ودور المحفوظات، والمتاحف والأنشطة الثقافية الأخرى,51,25,0,0,76
3564,2022,1,Eastern Region Office,أنشطة المنظمات ذات العضوية,23,4,1,0,28
3565,2022,1,Eastern Region Office,أنشطة النشر,37,12,0,0,49
3566,2022,1,Eastern Region Office,أنشطة تقديم الخدمات للمباني وتجميل المواقع,1452,772,121,42,2387
3567,2022,1,Eastern Region Office,أنشطة جمع النفايات ومعالجتها وتصريفها ، واسترجاع المواد,17,18,2,2,39
3568,2022,1,Eastern Region Office,أنشطة خدمات الأطعمة والمشروبات,4136,1638,172,23,5969
3569,2022,1,Eastern Region Office,أنشطة خدمات المعلومات,49,19,1,0,69
3570,2022,1,Eastern Region Office,أنشطة خدمات دعم التعدين,129,128,67,39,363
3571,2022,1,Eastern Region Office,أنشطة زراعة المحاصيل والإنتاج الحيواني والصيد والخدمات المتصلة,531,63,8,0,602
3573,2022,1,Eastern Region Office,الإدارة العامة والدفاع ؛ والضمان الاجتماعي الإلزامي,188,114,28,4,334
3574,2022,1,Eastern Region Office,الإقامة,178,165,19,1,363
3575,2022,1,Eastern Region Office,الأنشطة الإبداعية والفنون وأنشطة الترفيه,19,0,0,0,19
3576,2022,1,Eastern Region Office,الأنشطة الأخرى للتعدين واستغلال المحاجر,46,30,10,1,87
3577,2022,1,Eastern Region Office,الأنشطة الإدارية للمكاتب ، وأنشطة الدعم للمكاتب وغير ذلك من أنشطة الدعم للأعمال,222,37,2,1,262
3578,2022,1,Eastern Region Office,الأنشطة الإيجارية,719,143,24,5,891
3579,2022,1,Eastern Region Office,الأنشطة البيطرية,10,7,2,0,19
3580,2022,1,Eastern Region Office,الأنشطة الرياضية وأنشطة التسلية والترفيه,174,69,3,1,247
3581,2022,1,Eastern Region Office,الأنشطة العقارية,295,138,11,1,445
3582,2022,1,Eastern Region Office,الأنشطة القانونية وأنشطة المحاسبة,114,47,3,0,164
3583,2022,1,Eastern Region Office,الأنشطة المساعدة لأنشطة الخدمات المالية وأنشطة التأمين,12,13,2,1,28
3584,2022,1,Eastern Region Office,الأنشطة المهنية والعلمية والتقنية الأخرى,97,17,0,0,114
3586,2022,1,Eastern Region Office,الاتصالات,63,18,0,0,81
3587,2022,1,Eastern Region Office,البحث والتطوير في المجال العلمي,4,3,1,0,8
3588,2022,1,Eastern Region Office,التخزين وأنشطة الدعم للنقل,335,131,34,3,503
3589,2022,1,Eastern Region Office,التعليم,165,175,55,13,408
3591,2022,1,Eastern Region Office,الرعاية مع الإقامة,9,6,0,1,16
3592,2022,1,Eastern Region Office,الصحة البشرية,105,161,58,25,349
3593,2022,1,Eastern Region Office,الصرف الصحي,11,9,1,1,22
3594,2022,1,Eastern Region Office,الصناعة التحويلية الأخرى,70,41,4,0,115
3595,2022,1,Eastern Region Office,الطباعة واستنساخ وسائط الأعلام المسجّلة,105,79,7,0,191
3596,2022,1,Eastern Region Office,النقل البري و النقل عبر الأنابيب,1054,347,80,24,1505
3597,2022,1,Eastern Region Office,النقل الجوي,73,71,30,6,180
3598,2022,1,Eastern Region Office,النقل المائي,31,19,6,0,56
3599,2022,1,Eastern Region Office,الهندسة المدنية,126,75,24,3,228
3600,2022,1,Eastern Region Office,تجارة التجزئة، باستثناء المركبات ذات المحركات والدراجات النارية,6213,2005,203,38,8459
3601,2022,1,Eastern Region Office,تجارة الجملة ، باستثناء المركبات ذات المحركات والدراجات النارية,2778,1422,209,49,4458
3602,2022,1,Eastern Region Office,تجارة الجملة والتجزئة ، وإصلاح المركبات ذات المحركات والدراجات النارية,2529,800,37,5,3371
3603,2022,1,Eastern Region Office,تجميع المياه ومعالجتها وتوصيلها,30,14,1,1,46
3604,2022,1,Eastern Region Office,تشييد المباني,4636,2682,552,210,8080
3606,2022,1,Eastern Region Office,تعدين ركازات الفلزات,90,76,11,1,178
3607,2022,1,Eastern Region Office,تمويل التأمين وإعادة التأمين وصناديق المعاشات التقاعدية باستثناء الضمان الاجتماعي الإلزامي,5,12,3,3,23
3608,2022,1,Eastern Region Office,توصيل الكهرباء والغاز والبخار وتكييف الهواء,40,53,15,4,112
3609,2022,1,Eastern Region Office,صناعة الآلات والمعدات غير المصنفة في موضع أخر,46,42,10,2,100
3610,2022,1,Eastern Region Office,صناعة المركبات ذات المحركات والمركبات المقطورة ونصف المقطورة,21,12,1,0,34
3611,2022,1,Eastern Region Office,صناعة معدات النقل الأخرى,20,14,3,1,38
3612,2022,1,Eastern Region Office,صنع الأثاث,317,116,9,1,443
3613,2022,1,Eastern Region Office,صنع الحواسيب والمنتجات الإلكترونية والبصرية,104,47,9,3,163
3614,2022,1,Eastern Region Office,صُنع الخشب ومنتجات الخشب والفلين ، باستثناء الأثاث ، صُنع أصناف من القش ومواد الضفر,297,164,19,5,485
3615,2022,1,Eastern Region Office,صنع الفلزات القاعدية,118,112,50,11,291
3616,2022,1,Eastern Region Office,صُنع المشروبات,20,17,3,1,41
3617,2022,1,Eastern Region Office,صنع المعدات الكهربائية,181,78,16,3,278
3618,2022,1,Eastern Region Office,صُنع الملبوسات,813,178,5,0,996
3619,2022,1,Eastern Region Office,صُنع المنتجات الجلدية والمنتجات ذات الصلة,6,1,0,0,7
3620,2022,1,Eastern Region Office,صنع المنتجات الصيدلانية الأساسية والمستحضرات الصيدلانية,5,3,3,0,11
3621,2022,1,Eastern Region Office,صُنع المنتجات الغذائية,481,228,53,10,772
3622,2022,1,Eastern Region Office,صُنع المنسوجات,155,81,8,0,244
3623,2022,1,Eastern Region Office,صُنع المواد الكيميائية والمنتجات الكيميائية,131,81,16,0,228
3624,2022,1,Eastern Region Office,صُنع الورق ومنتجات الورق,28,20,10,3,61
3625,2022,1,Eastern Region Office,صنع فحم الكوك والمنتجات النفطية المكررة,14,13,4,2,33
3627,2022,1,Eastern Region Office,صنع منتجات المطاط واللدائن,55,85,61,9,210
3628,2022,1,Eastern Region Office,صنع منتجات المعادن اللافلزية الأخرى,179,119,36,9,343
3629,2022,1,Eastern Region Office,صنع منتجات المعادن المشكلة ( باستثناء الآلات والمعدات ),427,268,73,17,785
3630,2022,1,Eastern Region Office,صيد الأسماك وتربية المائيات,281,169,5,0,455
3631,2022,1,Eastern Region Office,وكالات السفر ومشغّلو الجولات السياحية وخدمات الحجز والأنشطة المتصلة بها,83,37,7,0,127
3632,2022,1,Al-Ahsa Governorate Office,أبحاث الإعلان والسوق,22,5,0,0,27
3633,2022,1,Al-Ahsa Governorate Office,إصلاح أجهزة الحاسوب والسلع الشخصية والمنزلية,136,20,2,0,158
3634,2022,1,Al-Ahsa Governorate Office,إصلاح وتركيب الآلات والمعدات,73,5,0,0,78
3635,2022,1,Al-Ahsa Governorate Office,أنشطة أنتاج الأفلام والبرامج التلفزيونية والتسجيلات الصوتية و نشرالموسيقى,8,0,0,0,8
3636,2022,1,Al-Ahsa Governorate Office,أنشطة الأمن والتحقيقات,5,1,1,1,8
3642,2022,1,Al-Ahsa Governorate Office,أنشطة التشييد المتخصصة,982,209,10,2,1203
3643,2022,1,Al-Ahsa Governorate Office,أنشطة الخدمات الشخصية الأخرى,1008,128,3,1,1140
3644,2022,1,Al-Ahsa Governorate Office,أنشطة الخدمات المالية ، فيما عدا تمويل التأمين وصناديق المعاشات,23,2,1,0,26
3645,2022,1,Al-Ahsa Governorate Office,أنشطة العمل الاجتماعي، دون إقامة، لكبار السن وذوي الإعاقة,21,21,2,0,44
3647,2022,1,Al-Ahsa Governorate Office,أنشطة المعمارية والهندسية ، والاختبارات الفنية والتحليل,35,33,4,0,72
3648,2022,1,Al-Ahsa Governorate Office,أنشطة المكاتب الرئيسية ، وألأنشطة الاستشارية في مجال الإدارة,29,3,0,0,32
3651,2022,1,Al-Ahsa Governorate Office,أنشطة النشر,3,1,0,0,4
3652,2022,1,Al-Ahsa Governorate Office,أنشطة تقديم الخدمات للمباني وتجميل المواقع,191,55,3,0,249
3653,2022,1,Al-Ahsa Governorate Office,أنشطة جمع النفايات ومعالجتها وتصريفها ، واسترجاع المواد,3,2,0,0,5
3654,2022,1,Al-Ahsa Governorate Office,أنشطة خدمات الأطعمة والمشروبات,1480,588,29,1,2098
3657,2022,1,Al-Ahsa Governorate Office,أنشطة زراعة المحاصيل والإنتاج الحيواني والصيد والخدمات المتصلة,436,47,6,0,489
3659,2022,1,Al-Ahsa Governorate Office,الإقامة,56,26,4,0,86
3661,2022,1,Al-Ahsa Governorate Office,الأنشطة الأخرى للتعدين واستغلال المحاجر,17,2,0,0,19
3662,2022,1,Al-Ahsa Governorate Office,الأنشطة الإدارية للمكاتب ، وأنشطة الدعم للمكاتب وغير ذلك من أنشطة الدعم للأعمال,49,10,0,0,59
3663,2022,1,Al-Ahsa Governorate Office,الأنشطة الإيجارية,320,45,5,2,372
3664,2022,1,Al-Ahsa Governorate Office,الأنشطة البيطرية,6,1,0,0,7
3665,2022,1,Al-Ahsa Governorate Office,الأنشطة الرياضية وأنشطة التسلية والترفيه,38,15,1,0,54
3666,2022,1,Al-Ahsa Governorate Office,الأنشطة العقارية,43,9,1,0,53
3669,2022,1,Al-Ahsa Governorate Office,الأنشطة المهنية والعلمية والتقنية الأخرى,35,1,0,0,36
3670,2022,1,Al-Ahsa Governorate Office,الاتصالات,21,5,0,0,26
3671,2022,1,Al-Ahsa Governorate Office,التخزين وأنشطة الدعم للنقل,69,18,1,0,88
3672,2022,1,Al-Ahsa Governorate Office,التعليم,40,31,12,1,84
3674,2022,1,Al-Ahsa Governorate Office,الصحة البشرية,35,59,14,6,114
3676,2022,1,Al-Ahsa Governorate Office,الصناعة التحويلية الأخرى,24,3,0,0,27
3677,2022,1,Al-Ahsa Governorate Office,الطباعة واستنساخ وسائط الأعلام المسجّلة,35,6,1,1,43
3678,2022,1,Al-Ahsa Governorate Office,النقل البري و النقل عبر الأنابيب,254,42,8,2,306
3679,2022,1,Al-Ahsa Governorate Office,النقل الجوي,12,4,1,0,17
3681,2022,1,Al-Ahsa Governorate Office,الهندسة المدنية,21,8,3,2,34
3682,2022,1,Al-Ahsa Governorate Office,تجارة التجزئة، باستثناء المركبات ذات المحركات والدراجات النارية,2112,473,34,3,2622
3683,2022,1,Al-Ahsa Governorate Office,تجارة الجملة ، باستثناء المركبات ذات المحركات والدراجات النارية,573,146,10,2,731
3684,2022,1,Al-Ahsa Governorate Office,تجارة الجملة والتجزئة ، وإصلاح المركبات ذات المحركات والدراجات النارية,852,204,7,0,1063
3685,2022,1,Al-Ahsa Governorate Office,تجميع المياه ومعالجتها وتوصيلها,12,6,0,0,18
3686,2022,1,Al-Ahsa Governorate Office,تشييد المباني,1664,645,54,14,2377
3688,2022,1,Al-Ahsa Governorate Office,تعدين ركازات الفلزات,27,8,1,1,37
3690,2022,1,Al-Ahsa Governorate Office,توصيل الكهرباء والغاز والبخار وتكييف الهواء,11,4,0,0,15
3691,2022,1,Al-Ahsa Governorate Office,صناعة الآلات والمعدات غير المصنفة في موضع أخر,17,6,1,0,24
3692,2022,1,Al-Ahsa Governorate Office,صناعة المركبات ذات المحركات والمركبات المقطورة ونصف المقطورة,10,1,0,0,11
3694,2022,1,Al-Ahsa Governorate Office,صنع الأثاث,142,41,1,0,184
3695,2022,1,Al-Ahsa Governorate Office,صنع الحواسيب والمنتجات الإلكترونية والبصرية,88,22,0,0,110
3696,2022,1,Al-Ahsa Governorate Office,صُنع الخشب ومنتجات الخشب والفلين ، باستثناء الأثاث ، صُنع أصناف من القش ومواد الضفر,57,21,1,1,80
3697,2022,1,Al-Ahsa Governorate Office,صنع الفلزات القاعدية,57,13,0,0,70
3699,2022,1,Al-Ahsa Governorate Office,صنع المعدات الكهربائية,52,20,2,0,74
3700,2022,1,Al-Ahsa Governorate Office,صُنع الملبوسات,532,69,2,0,603
3701,2022,1,Al-Ahsa Governorate Office,صُنع المنتجات الجلدية والمنتجات ذات الصلة,7,0,0,0,7
3703,2022,1,Al-Ahsa Governorate Office,صُنع المنتجات الغذائية,252,81,14,4,351
3704,2022,1,Al-Ahsa Governorate Office,صُنع المنسوجات,38,6,1,0,45
3705,2022,1,Al-Ahsa Governorate Office,صُنع المواد الكيميائية والمنتجات الكيميائية,32,6,5,0,43
3706,2022,1,Al-Ahsa Governorate Office,صُنع الورق ومنتجات الورق,3,2,1,0,6
3707,2022,1,Al-Ahsa Governorate Office,صنع فحم الكوك والمنتجات النفطية المكررة,0,2,1,0,3
3709,2022,1,Al-Ahsa Governorate Office,صنع منتجات المطاط واللدائن,12,6,4,1,23
3710,2022,1,Al-Ahsa Governorate Office,صنع منتجات المعادن اللافلزية الأخرى,64,43,12,0,119
3711,2022,1,Al-Ahsa Governorate Office,صنع منتجات المعادن المشكلة ( باستثناء الآلات والمعدات ),116,64,6,1,187
3712,2022,1,Al-Ahsa Governorate Office,صيد الأسماك وتربية المائيات,17,2,1,0,20
3713,2022,1,Al-Ahsa Governorate Office,وكالات السفر ومشغّلو الجولات السياحية وخدمات الحجز والأنشطة المتصلة بها,17,4,0,0,21
3714,2022,1,Jubail Governorate Office,أبحاث الإعلان والسوق,28,5,0,0,33
3715,2022,1,Jubail Governorate Office,إصلاح أجهزة الحاسوب والسلع الشخصية والمنزلية,51,14,2,1,68
3716,2022,1,Jubail Governorate Office,إصلاح وتركيب الآلات والمعدات,58,33,4,0,95
3717,2022,1,Jubail Governorate Office,أنشطة أنتاج الأفلام والبرامج التلفزيونية والتسجيلات الصوتية و نشرالموسيقى,4,0,0,0,4
3718,2022,1,Jubail Governorate Office,أنشطة الأمن والتحقيقات,7,0,2,0,9
3719,2022,1,Jubail Governorate Office,أنشطة الاستخدام,12,3,0,1,16
3721,2022,1,Jubail Governorate Office,أنشطة البرمجة الحاسوبية والخبرة الاستشارية وما يتصل بها من أنشطة,11,5,0,0,16
3722,2022,1,Jubail Governorate Office,أنشطة البريد ونقل الرسائل والطرود بواسطة مندوبين,1,0,0,0,1
3723,2022,1,Jubail Governorate Office,أنشطة التشييد المتخصصة,804,312,32,18,1166
3724,2022,1,Jubail Governorate Office,أنشطة الخدمات الشخصية الأخرى,517,82,5,1,605
3725,2022,1,Jubail Governorate Office,أنشطة الخدمات المالية ، فيما عدا تمويل التأمين وصناديق المعاشات,10,2,1,0,13
3726,2022,1,Jubail Governorate Office,أنشطة العمل الاجتماعي، دون إقامة، لكبار السن وذوي الإعاقة,11,7,1,0,19
3728,2022,1,Jubail Governorate Office,أنشطة المعمارية والهندسية ، والاختبارات الفنية والتحليل,49,16,1,3,69
3729,2022,1,Jubail Governorate Office,أنشطة المكاتب الرئيسية ، وألأنشطة الاستشارية في مجال الإدارة,15,3,0,0,18
3733,2022,1,Jubail Governorate Office,أنشطة النشر,32,4,0,0,36
3734,2022,1,Jubail Governorate Office,أنشطة تقديم الخدمات للمباني وتجميل المواقع,257,121,24,5,407
3735,2022,1,Jubail Governorate Office,أنشطة جمع النفايات ومعالجتها وتصريفها ، واسترجاع المواد,3,1,1,1,6
3736,2022,1,Jubail Governorate Office,أنشطة خدمات الأطعمة والمشروبات,1028,342,15,2,1387
3737,2022,1,Jubail Governorate Office,أنشطة خدمات المعلومات,4,1,0,0,5
3738,2022,1,Jubail Governorate Office,أنشطة خدمات دعم التعدين,21,22,10,10,63
3739,2022,1,Jubail Governorate Office,أنشطة زراعة المحاصيل والإنتاج الحيواني والصيد والخدمات المتصلة,407,25,2,0,434
3741,2022,1,Jubail Governorate Office,الإقامة,51,29,5,0,85
3742,2022,1,Jubail Governorate Office,الأنشطة الأخرى للتعدين واستغلال المحاجر,6,6,3,2,17
3743,2022,1,Jubail Governorate Office,الأنشطة الإدارية للمكاتب ، وأنشطة الدعم للمكاتب وغير ذلك من أنشطة الدعم للأعمال,29,2,0,0,31
3744,2022,1,Jubail Governorate Office,الأنشطة الإيجارية,421,44,4,1,470
3745,2022,1,Jubail Governorate Office,الأنشطة البيطرية,5,1,0,0,6
3746,2022,1,Jubail Governorate Office,الأنشطة الرياضية وأنشطة التسلية والترفيه,32,10,0,0,42
3747,2022,1,Jubail Governorate Office,الأنشطة العقارية,37,9,0,0,46
3748,2022,1,Jubail Governorate Office,الأنشطة القانونية وأنشطة المحاسبة,7,3,0,0,10
3750,2022,1,Jubail Governorate Office,الأنشطة المهنية والعلمية والتقنية الأخرى,21,3,0,0,24
3751,2022,1,Jubail Governorate Office,الاتصالات,20,4,0,0,24
3753,2022,1,Jubail Governorate Office,التخزين وأنشطة الدعم للنقل,66,18,3,1,88
3754,2022,1,Jubail Governorate Office,التعليم,30,17,11,0,58
3757,2022,1,Jubail Governorate Office,الصحة البشرية,22,19,13,6,60
3760,2022,1,Jubail Governorate Office,الطباعة واستنساخ وسائط الأعلام المسجّلة,14,10,1,0,25
3761,2022,1,Jubail Governorate Office,النقل البري و النقل عبر الأنابيب,257,75,4,1,337
3762,2022,1,Jubail Governorate Office,النقل الجوي,11,6,0,2,19
3764,2022,1,Jubail Governorate Office,الهندسة المدنية,46,34,7,1,88
3765,2022,1,Jubail Governorate Office,تجارة التجزئة، باستثناء المركبات ذات المحركات والدراجات النارية,1271,255,20,2,1548
3766,2022,1,Jubail Governorate Office,تجارة الجملة ، باستثناء المركبات ذات المحركات والدراجات النارية,567,181,19,6,773
3767,2022,1,Jubail Governorate Office,تجارة الجملة والتجزئة ، وإصلاح المركبات ذات المحركات والدراجات النارية,691,114,4,0,809
3768,2022,1,Jubail Governorate Office,تجميع المياه ومعالجتها وتوصيلها,4,6,0,0,10
3769,2022,1,Jubail Governorate Office,تشييد المباني,1341,707,136,41,2225
3771,2022,1,Jubail Governorate Office,تعدين ركازات الفلزات,44,12,1,1,58
3773,2022,1,Jubail Governorate Office,توصيل الكهرباء والغاز والبخار وتكييف الهواء,12,13,2,1,28
3774,2022,1,Jubail Governorate Office,صناعة الآلات والمعدات غير المصنفة في موضع أخر,17,17,4,0,38
3775,2022,1,Jubail Governorate Office,صناعة المركبات ذات المحركات والمركبات المقطورة ونصف المقطورة,11,3,0,0,14
3776,2022,1,Jubail Governorate Office,صناعة معدات النقل الأخرى,12,5,1,0,18
3777,2022,1,Jubail Governorate Office,صنع الأثاث,46,7,0,0,53
3779,2022,1,Jubail Governorate Office,صُنع الخشب ومنتجات الخشب والفلين ، باستثناء الأثاث ، صُنع أصناف من القش ومواد الضفر,73,18,4,0,95
3780,2022,1,Jubail Governorate Office,صنع الفلزات القاعدية,64,27,16,5,112
3782,2022,1,Jubail Governorate Office,صنع المعدات الكهربائية,66,21,4,1,92
3783,2022,1,Jubail Governorate Office,صُنع الملبوسات,191,21,1,0,213
3787,2022,1,Jubail Governorate Office,صُنع المنسوجات,51,13,1,0,65
3788,2022,1,Jubail Governorate Office,صُنع المواد الكيميائية والمنتجات الكيميائية,24,22,18,3,67
3789,2022,1,Jubail Governorate Office,صُنع الورق ومنتجات الورق,1,1,0,0,2
3790,2022,1,Jubail Governorate Office,صنع فحم الكوك والمنتجات النفطية المكررة,2,5,0,1,8
3792,2022,1,Jubail Governorate Office,صنع منتجات المطاط واللدائن,16,27,10,10,63
3793,2022,1,Jubail Governorate Office,صنع منتجات المعادن اللافلزية الأخرى,54,29,11,2,96
3794,2022,1,Jubail Governorate Office,صنع منتجات المعادن المشكلة ( باستثناء الآلات والمعدات ),164,54,22,6,246
3795,2022,1,Jubail Governorate Office,صيد الأسماك وتربية المائيات,92,86,1,0,179
3796,2022,1,Jubail Governorate Office,وكالات السفر ومشغّلو الجولات السياحية وخدمات الحجز والأنشطة المتصلة بها,6,2,0,0,8
3797,2022,1,Al-Kharj Office,أبحاث الإعلان والسوق,16,5,0,0,21
3798,2022,1,Al-Kharj Office,إصلاح أجهزة الحاسوب والسلع الشخصية والمنزلية,98,6,0,0,104
3799,2022,1,Al-Kharj Office,إصلاح وتركيب الآلات والمعدات,48,5,1,0,54
3801,2022,1,Al-Kharj Office,أنشطة الأمن والتحقيقات,3,2,0,0,5
3802,2022,1,Al-Kharj Office,أنشطة الاستخدام,17,6,1,0,24
3803,2022,1,Al-Kharj Office,أنشطة البرمجة الحاسوبية والخبرة الاستشارية وما يتصل بها من أنشطة,5,0,0,0,5
3806,2022,1,Al-Kharj Office,أنشطة التشييد المتخصصة,1111,182,12,1,1306
3807,2022,1,Al-Kharj Office,أنشطة الخدمات الشخصية الأخرى,636,63,2,0,701
3808,2022,1,Al-Kharj Office,أنشطة الخدمات المالية ، فيما عدا تمويل التأمين وصناديق المعاشات,31,6,0,0,37
3809,2022,1,Al-Kharj Office,أنشطة العمل الاجتماعي، دون إقامة، لكبار السن وذوي الإعاقة,20,18,0,0,38
3810,2022,1,Al-Kharj Office,أنشطة المعمارية والهندسية ، والاختبارات الفنية والتحليل,30,7,1,1,39
3811,2022,1,Al-Kharj Office,أنشطة المكاتب الرئيسية ، وألأنشطة الاستشارية في مجال الإدارة,16,4,0,0,20
3812,2022,1,Al-Kharj Office,أنشطة المكتبات ودور المحفوظات، والمتاحف والأنشطة الثقافية الأخرى,21,1,0,0,22
3814,2022,1,Al-Kharj Office,أنشطة النشر,9,3,0,0,12
3815,2022,1,Al-Kharj Office,أنشطة تقديم الخدمات للمباني وتجميل المواقع,209,52,7,0,268
3816,2022,1,Al-Kharj Office,أنشطة جمع النفايات ومعالجتها وتصريفها ، واسترجاع المواد,2,1,1,0,4
3817,2022,1,Al-Kharj Office,أنشطة خدمات الأطعمة والمشروبات,1195,251,10,0,1456
3818,2022,1,Al-Kharj Office,أنشطة خدمات المعلومات,9,0,0,0,9
3819,2022,1,Al-Kharj Office,أنشطة خدمات دعم التعدين,11,3,0,0,14
3820,2022,1,Al-Kharj Office,أنشطة زراعة المحاصيل والإنتاج الحيواني والصيد والخدمات المتصلة,1847,109,15,1,1972
3821,2022,1,Al-Kharj Office,الإدارة العامة والدفاع ؛ والضمان الاجتماعي الإلزامي,17,8,0,0,25
3822,2022,1,Al-Kharj Office,الإقامة,58,12,0,0,70
3823,2022,1,Al-Kharj Office,الأنشطة الإبداعية والفنون وأنشطة الترفيه,7,0,1,0,8
3824,2022,1,Al-Kharj Office,الأنشطة الأخرى للتعدين واستغلال المحاجر,20,4,0,0,24
3825,2022,1,Al-Kharj Office,الأنشطة الإدارية للمكاتب ، وأنشطة الدعم للمكاتب وغير ذلك من أنشطة الدعم للأعمال,44,5,0,0,49
3826,2022,1,Al-Kharj Office,الأنشطة الإيجارية,685,29,1,0,715
3828,2022,1,Al-Kharj Office,الأنشطة الرياضية وأنشطة التسلية والترفيه,35,10,0,0,45
3829,2022,1,Al-Kharj Office,الأنشطة العقارية,95,18,0,1,114
3831,2022,1,Al-Kharj Office,الأنشطة المساعدة لأنشطة الخدمات المالية وأنشطة التأمين,2,1,0,0,3
3832,2022,1,Al-Kharj Office,الأنشطة المهنية والعلمية والتقنية الأخرى,14,0,0,0,14
3834,2022,1,Al-Kharj Office,التخزين وأنشطة الدعم للنقل,76,11,0,0,87
3835,2022,1,Al-Kharj Office,التعليم,32,14,7,0,53
3838,2022,1,Al-Kharj Office,الصحة البشرية,22,25,7,2,56
3839,2022,1,Al-Kharj Office,الصرف الصحي,1,1,0,0,2
3840,2022,1,Al-Kharj Office,الصناعة التحويلية الأخرى,11,6,1,0,18
3841,2022,1,Al-Kharj Office,الطباعة واستنساخ وسائط الأعلام المسجّلة,18,3,0,0,21
3842,2022,1,Al-Kharj Office,النقل البري و النقل عبر الأنابيب,957,106,7,0,1070
3845,2022,1,Al-Kharj Office,الهندسة المدنية,8,8,2,2,20
3846,2022,1,Al-Kharj Office,تجارة التجزئة، باستثناء المركبات ذات المحركات والدراجات النارية,1855,294,13,1,2163
3847,2022,1,Al-Kharj Office,تجارة الجملة ، باستثناء المركبات ذات المحركات والدراجات النارية,789,209,15,0,1013
3848,2022,1,Al-Kharj Office,تجارة الجملة والتجزئة ، وإصلاح المركبات ذات المحركات والدراجات النارية,856,133,3,0,992
3849,2022,1,Al-Kharj Office,تجميع المياه ومعالجتها وتوصيلها,13,3,0,1,17
3850,2022,1,Al-Kharj Office,تشييد المباني,1765,447,37,5,2254
3851,2022,1,Al-Kharj Office,تعدين الفحم والليغنيت,0,1,0,0,1
3852,2022,1,Al-Kharj Office,تعدين ركازات الفلزات,15,2,0,0,17
3854,2022,1,Al-Kharj Office,صناعة الآلات والمعدات غير المصنفة في موضع أخر,22,7,0,0,29
3855,2022,1,Al-Kharj Office,صناعة المركبات ذات المحركات والمركبات المقطورة ونصف المقطورة,21,4,1,0,26
3856,2022,1,Al-Kharj Office,صناعة معدات النقل الأخرى,8,4,1,0,13
3857,2022,1,Al-Kharj Office,صنع الأثاث,76,16,1,1,94
3858,2022,1,Al-Kharj Office,صنع الحواسيب والمنتجات الإلكترونية والبصرية,37,3,0,0,40
3859,2022,1,Al-Kharj Office,صُنع الخشب ومنتجات الخشب والفلين ، باستثناء الأثاث ، صُنع أصناف من القش ومواد الضفر,82,17,2,0,101
3860,2022,1,Al-Kharj Office,صنع الفلزات القاعدية,107,28,3,0,138
3861,2022,1,Al-Kharj Office,صُنع المشروبات,11,8,4,7,30
3862,2022,1,Al-Kharj Office,صنع المعدات الكهربائية,50,7,1,0,58
3863,2022,1,Al-Kharj Office,صُنع الملبوسات,348,34,1,0,383
3864,2022,1,Al-Kharj Office,صُنع المنتجات الجلدية والمنتجات ذات الصلة,6,0,0,0,6
3866,2022,1,Al-Kharj Office,صُنع المنتجات الغذائية,190,68,11,0,269
3867,2022,1,Al-Kharj Office,صُنع المنسوجات,33,10,0,0,43
3868,2022,1,Al-Kharj Office,صُنع المواد الكيميائية والمنتجات الكيميائية,52,19,5,0,76
3869,2022,1,Al-Kharj Office,صُنع الورق ومنتجات الورق,8,4,5,0,17
3870,2022,1,Al-Kharj Office,صنع فحم الكوك والمنتجات النفطية المكررة,0,3,0,0,3
3872,2022,1,Al-Kharj Office,صنع منتجات المطاط واللدائن,18,16,5,1,40
3873,2022,1,Al-Kharj Office,صنع منتجات المعادن اللافلزية الأخرى,63,41,12,0,116
3874,2022,1,Al-Kharj Office,صنع منتجات المعادن المشكلة ( باستثناء الآلات والمعدات ),126,32,4,1,163
3875,2022,1,Al-Kharj Office,صيد الأسماك وتربية المائيات,35,1,0,0,36
3876,2022,1,Al-Kharj Office,وكالات السفر ومشغّلو الجولات السياحية وخدمات الحجز والأنشطة المتصلة بها,4,1,0,0,5
3877,2022,1,Dawadmi Governorate Office,أبحاث الإعلان والسوق,4,2,0,0,6
3878,2022,1,Dawadmi Governorate Office,إصلاح أجهزة الحاسوب والسلع الشخصية والمنزلية,37,9,0,0,46
3879,2022,1,Dawadmi Governorate Office,إصلاح وتركيب الآلات والمعدات,13,4,0,0,17
3882,2022,1,Dawadmi Governorate Office,أنشطة الاستخدام,10,1,0,0,11
3883,2022,1,Dawadmi Governorate Office,أنشطة الاسر المعيشية التي تستخدم أفراداً للعمل المنزلي,2,0,0,0,2
3885,2022,1,Dawadmi Governorate Office,أنشطة البرمجة والإذاعة,0,2,0,0,2
3887,2022,1,Dawadmi Governorate Office,أنشطة التشييد المتخصصة,739,111,5,0,855
3888,2022,1,Dawadmi Governorate Office,أنشطة الخدمات الشخصية الأخرى,382,31,2,0,415
3889,2022,1,Dawadmi Governorate Office,أنشطة الخدمات المالية ، فيما عدا تمويل التأمين وصناديق المعاشات,20,2,0,0,22
3890,2022,1,Dawadmi Governorate Office,أنشطة العمل الاجتماعي، دون إقامة، لكبار السن وذوي الإعاقة,17,1,1,0,19
3891,2022,1,Dawadmi Governorate Office,أنشطة المعمارية والهندسية ، والاختبارات الفنية والتحليل,28,5,0,0,33
3892,2022,1,Dawadmi Governorate Office,أنشطة المكاتب الرئيسية ، وألأنشطة الاستشارية في مجال الإدارة,7,0,0,0,7
3894,2022,1,Dawadmi Governorate Office,أنشطة المنظمات ذات العضوية,7,0,0,0,7
3896,2022,1,Dawadmi Governorate Office,أنشطة تقديم الخدمات للمباني وتجميل المواقع,759,145,12,1,917
3897,2022,1,Dawadmi Governorate Office,أنشطة جمع النفايات ومعالجتها وتصريفها ، واسترجاع المواد,2,0,0,0,2
3898,2022,1,Dawadmi Governorate Office,أنشطة خدمات الأطعمة والمشروبات,655,78,5,0,738
3899,2022,1,Dawadmi Governorate Office,أنشطة خدمات المعلومات,4,0,0,0,4
3900,2022,1,Dawadmi Governorate Office,أنشطة خدمات دعم التعدين,1,2,0,0,3
3901,2022,1,Dawadmi Governorate Office,أنشطة زراعة المحاصيل والإنتاج الحيواني والصيد والخدمات المتصلة,1745,33,0,0,1778
3903,2022,1,Dawadmi Governorate Office,الإقامة,37,6,0,0,43
3904,2022,1,Dawadmi Governorate Office,الأنشطة الإبداعية والفنون وأنشطة الترفيه,3,0,0,0,3
3905,2022,1,Dawadmi Governorate Office,الأنشطة الأخرى للتعدين واستغلال المحاجر,3,2,1,0,6
3906,2022,1,Dawadmi Governorate Office,الأنشطة الإدارية للمكاتب ، وأنشطة الدعم للمكاتب وغير ذلك من أنشطة الدعم للأعمال,14,1,0,0,15
3907,2022,1,Dawadmi Governorate Office,الأنشطة الإيجارية,1139,30,1,1,1171
3909,2022,1,Dawadmi Governorate Office,الأنشطة الرياضية وأنشطة التسلية والترفيه,24,5,0,0,29
3910,2022,1,Dawadmi Governorate Office,الأنشطة العقارية,33,5,0,0,38
3913,2022,1,Dawadmi Governorate Office,الأنشطة المهنية والعلمية والتقنية الأخرى,7,1,0,0,8
3914,2022,1,Dawadmi Governorate Office,الاتصالات,5,0,1,0,6
3915,2022,1,Dawadmi Governorate Office,التخزين وأنشطة الدعم للنقل,62,4,0,0,66
3916,2022,1,Dawadmi Governorate Office,التعليم,19,12,2,0,33
3918,2022,1,Dawadmi Governorate Office,الصحة البشرية,18,7,3,0,28
3921,2022,1,Dawadmi Governorate Office,الطباعة واستنساخ وسائط الأعلام المسجّلة,7,1,0,0,8
3922,2022,1,Dawadmi Governorate Office,النقل البري و النقل عبر الأنابيب,779,67,5,0,851
3923,2022,1,Dawadmi Governorate Office,النقل الجوي,14,3,0,0,17
3924,2022,1,Dawadmi Governorate Office,النقل المائي,4,0,0,0,4
3925,2022,1,Dawadmi Governorate Office,الهندسة المدنية,3,2,2,0,7
3926,2022,1,Dawadmi Governorate Office,تجارة التجزئة، باستثناء المركبات ذات المحركات والدراجات النارية,757,90,2,0,849
3927,2022,1,Dawadmi Governorate Office,تجارة الجملة ، باستثناء المركبات ذات المحركات والدراجات النارية,313,68,4,0,385
3928,2022,1,Dawadmi Governorate Office,تجارة الجملة والتجزئة ، وإصلاح المركبات ذات المحركات والدراجات النارية,613,57,5,1,676
3929,2022,1,Dawadmi Governorate Office,تجميع المياه ومعالجتها وتوصيلها,7,3,1,0,11
3930,2022,1,Dawadmi Governorate Office,تشييد المباني,830,172,23,3,1028
3932,2022,1,Dawadmi Governorate Office,توصيل الكهرباء والغاز والبخار وتكييف الهواء,6,0,1,0,7
3933,2022,1,Dawadmi Governorate Office,صناعة الآلات والمعدات غير المصنفة في موضع أخر,7,0,0,0,7
3936,2022,1,Dawadmi Governorate Office,صنع الأثاث,47,10,0,0,57
3938,2022,1,Dawadmi Governorate Office,صُنع الخشب ومنتجات الخشب والفلين ، باستثناء الأثاث ، صُنع أصناف من القش ومواد الضفر,57,8,2,0,67
3939,2022,1,Dawadmi Governorate Office,صنع الفلزات القاعدية,59,7,0,0,66
3940,2022,1,Dawadmi Governorate Office,صُنع المشروبات,7,1,0,0,8
3941,2022,1,Dawadmi Governorate Office,صنع المعدات الكهربائية,24,4,0,0,28
3942,2022,1,Dawadmi Governorate Office,صُنع الملبوسات,189,16,1,0,206
3945,2022,1,Dawadmi Governorate Office,صُنع المنتجات الغذائية,89,13,0,0,102
3946,2022,1,Dawadmi Governorate Office,صُنع المنسوجات,28,3,0,0,31
3947,2022,1,Dawadmi Governorate Office,صُنع المواد الكيميائية والمنتجات الكيميائية,15,3,0,0,18
3949,2022,1,Dawadmi Governorate Office,صنع منتجات المطاط واللدائن,7,2,1,0,10
3950,2022,1,Dawadmi Governorate Office,صنع منتجات المعادن اللافلزية الأخرى,63,24,0,0,87
3951,2022,1,Dawadmi Governorate Office,صنع منتجات المعادن المشكلة ( باستثناء الآلات والمعدات ),84,13,0,0,97
3952,2022,1,Dawadmi Governorate Office,صيد الأسماك وتربية المائيات,44,0,0,0,44
3954,2022,1,Taif Governorate Office,أبحاث الإعلان والسوق,33,2,0,0,35
3955,2022,1,Taif Governorate Office,إصلاح أجهزة الحاسوب والسلع الشخصية والمنزلية,176,14,0,0,190
3956,2022,1,Taif Governorate Office,إصلاح وتركيب الآلات والمعدات,77,4,0,0,81
3957,2022,1,Taif Governorate Office,أنشطة أنتاج الأفلام والبرامج التلفزيونية والتسجيلات الصوتية و نشرالموسيقى,19,3,0,0,22
3958,2022,1,Taif Governorate Office,أنشطة الأمن والتحقيقات,9,2,0,0,11
3959,2022,1,Taif Governorate Office,أنشطة الاستخدام,28,3,0,0,31
3962,2022,1,Taif Governorate Office,أنشطة البرمجة والإذاعة,1,0,1,0,2
3964,2022,1,Taif Governorate Office,أنشطة التشييد المتخصصة,1277,167,1,0,1445
3965,2022,1,Taif Governorate Office,أنشطة الخدمات الشخصية الأخرى,1247,75,0,0,1322
3966,2022,1,Taif Governorate Office,أنشطة الخدمات المالية ، فيما عدا تمويل التأمين وصناديق المعاشات,12,0,0,0,12
3967,2022,1,Taif Governorate Office,أنشطة العمل الاجتماعي، دون إقامة، لكبار السن وذوي الإعاقة,33,30,1,0,64
3969,2022,1,Taif Governorate Office,أنشطة المعمارية والهندسية ، والاختبارات الفنية والتحليل,188,72,3,0,263
3970,2022,1,Taif Governorate Office,أنشطة المكاتب الرئيسية ، وألأنشطة الاستشارية في مجال الإدارة,11,4,0,0,15
3971,2022,1,Taif Governorate Office,أنشطة المكتبات ودور المحفوظات، والمتاحف والأنشطة الثقافية الأخرى,36,7,2,0,45
3973,2022,1,Taif Governorate Office,أنشطة المنظمات ذات العضوية,17,2,1,0,20
3974,2022,1,Taif Governorate Office,أنشطة النشر,11,5,0,0,16
3975,2022,1,Taif Governorate Office,أنشطة تقديم الخدمات للمباني وتجميل المواقع,285,47,8,1,341
3976,2022,1,Taif Governorate Office,أنشطة جمع النفايات ومعالجتها وتصريفها ، واسترجاع المواد,8,0,0,0,8
3977,2022,1,Taif Governorate Office,أنشطة خدمات الأطعمة والمشروبات,2762,565,34,0,3361
3979,2022,1,Taif Governorate Office,أنشطة خدمات دعم التعدين,20,5,1,0,26
3980,2022,1,Taif Governorate Office,أنشطة زراعة المحاصيل والإنتاج الحيواني والصيد والخدمات المتصلة,875,22,2,0,899
3981,2022,1,Taif Governorate Office,الإدارة العامة والدفاع ؛ والضمان الاجتماعي الإلزامي,16,6,4,0,26
3982,2022,1,Taif Governorate Office,الإقامة,211,48,7,0,266
3983,2022,1,Taif Governorate Office,الأنشطة الإبداعية والفنون وأنشطة الترفيه,9,5,0,0,14
3984,2022,1,Taif Governorate Office,الأنشطة الأخرى للتعدين واستغلال المحاجر,14,1,0,0,15
3985,2022,1,Taif Governorate Office,الأنشطة الإدارية للمكاتب ، وأنشطة الدعم للمكاتب وغير ذلك من أنشطة الدعم للأعمال,74,7,0,0,81
3986,2022,1,Taif Governorate Office,الأنشطة الإيجارية,1147,51,2,0,1200
3987,2022,1,Taif Governorate Office,الأنشطة البيطرية,23,4,0,0,27
3988,2022,1,Taif Governorate Office,الأنشطة الرياضية وأنشطة التسلية والترفيه,57,28,1,0,86
3989,2022,1,Taif Governorate Office,الأنشطة العقارية,85,11,1,0,97
3990,2022,1,Taif Governorate Office,الأنشطة القانونية وأنشطة المحاسبة,13,2,0,0,15
3991,2022,1,Taif Governorate Office,الأنشطة المهنية والعلمية والتقنية الأخرى,48,5,0,0,53
3992,2022,1,Taif Governorate Office,الاتصالات,30,1,0,0,31
3994,2022,1,Taif Governorate Office,التخزين وأنشطة الدعم للنقل,92,7,2,0,101
3995,2022,1,Taif Governorate Office,التعليم,35,32,19,0,86
3997,2022,1,Taif Governorate Office,الصحة البشرية,31,105,14,2,152
3998,2022,1,Taif Governorate Office,الصناعة التحويلية الأخرى,31,15,1,1,48
3999,2022,1,Taif Governorate Office,الطباعة واستنساخ وسائط الأعلام المسجّلة,31,11,0,0,42
4000,2022,1,Taif Governorate Office,النقل البري و النقل عبر الأنابيب,740,87,0,0,827
4001,2022,1,Taif Governorate Office,النقل الجوي,14,3,0,0,17
4002,2022,1,Taif Governorate Office,النقل المائي,8,1,0,0,9
4003,2022,1,Taif Governorate Office,الهندسة المدنية,19,3,1,0,23
4004,2022,1,Taif Governorate Office,تجارة التجزئة، باستثناء المركبات ذات المحركات والدراجات النارية,3339,462,22,0,3823
4005,2022,1,Taif Governorate Office,تجارة الجملة ، باستثناء المركبات ذات المحركات والدراجات النارية,965,172,18,0,1155
4006,2022,1,Taif Governorate Office,تجارة الجملة والتجزئة ، وإصلاح المركبات ذات المحركات والدراجات النارية,1595,170,4,0,1769
4007,2022,1,Taif Governorate Office,تجميع المياه ومعالجتها وتوصيلها,147,19,2,0,168
4008,2022,1,Taif Governorate Office,تشييد المباني,2452,488,42,3,2985
4009,2022,1,Taif Governorate Office,تعدين الفحم والليغنيت,4,0,0,0,4
4010,2022,1,Taif Governorate Office,تعدين ركازات الفلزات,22,2,0,0,24
4012,2022,1,Taif Governorate Office,توصيل الكهرباء والغاز والبخار وتكييف الهواء,12,0,0,0,12
4013,2022,1,Taif Governorate Office,صناعة الآلات والمعدات غير المصنفة في موضع أخر,21,1,0,0,22
4014,2022,1,Taif Governorate Office,صناعة المركبات ذات المحركات والمركبات المقطورة ونصف المقطورة,34,2,0,0,36
4016,2022,1,Taif Governorate Office,صنع الأثاث,192,27,3,0,222
4017,2022,1,Taif Governorate Office,صنع الحواسيب والمنتجات الإلكترونية والبصرية,107,12,0,0,119
4018,2022,1,Taif Governorate Office,صُنع الخشب ومنتجات الخشب والفلين ، باستثناء الأثاث ، صُنع أصناف من القش ومواد الضفر,198,25,0,0,223
4019,2022,1,Taif Governorate Office,صنع الفلزات القاعدية,112,21,2,0,135
4020,2022,1,Taif Governorate Office,صُنع المشروبات,18,5,0,0,23
4021,2022,1,Taif Governorate Office,صنع المعدات الكهربائية,77,16,0,0,93
4022,2022,1,Taif Governorate Office,صُنع الملبوسات,549,49,2,0,600
4025,2022,1,Taif Governorate Office,صُنع المنتجات الغذائية,386,91,4,1,482
4026,2022,1,Taif Governorate Office,صُنع المنسوجات,69,19,1,0,89
4027,2022,1,Taif Governorate Office,صُنع المواد الكيميائية والمنتجات الكيميائية,61,11,2,0,74
4028,2022,1,Taif Governorate Office,صُنع الورق ومنتجات الورق,7,3,0,0,10
4030,2022,1,Taif Governorate Office,صنع منتجات المطاط واللدائن,20,8,0,0,28
4031,2022,1,Taif Governorate Office,صنع منتجات المعادن اللافلزية الأخرى,95,25,2,1,123
4032,2022,1,Taif Governorate Office,صنع منتجات المعادن المشكلة ( باستثناء الآلات والمعدات ),582,55,0,0,637
4033,2022,1,Taif Governorate Office,صيد الأسماك وتربية المائيات,32,2,0,0,34
4034,2022,1,Taif Governorate Office,وكالات السفر ومشغّلو الجولات السياحية وخدمات الحجز والأنشطة المتصلة بها,20,4,0,0,24
4035,2022,1,Bishah Governorate Office,أبحاث الإعلان والسوق,5,1,0,0,6
4036,2022,1,Bishah Governorate Office,إصلاح أجهزة الحاسوب والسلع الشخصية والمنزلية,54,1,0,0,55
4037,2022,1,Bishah Governorate Office,إصلاح وتركيب الآلات والمعدات,14,0,0,0,14
4038,2022,1,Bishah Governorate Office,أنشطة الأمن والتحقيقات,1,0,0,0,1
4040,2022,1,Bishah Governorate Office,أنشطة الاسر المعيشية التي تستخدم أفراداً للعمل المنزلي,2,0,0,0,2
4042,2022,1,Bishah Governorate Office,أنشطة البريد ونقل الرسائل والطرود بواسطة مندوبين,2,0,0,0,2
4043,2022,1,Bishah Governorate Office,أنشطة التشييد المتخصصة,592,68,1,0,661
4044,2022,1,Bishah Governorate Office,أنشطة الخدمات الشخصية الأخرى,246,17,0,0,263
4045,2022,1,Bishah Governorate Office,أنشطة الخدمات المالية ، فيما عدا تمويل التأمين وصناديق المعاشات,12,1,0,0,13
4046,2022,1,Bishah Governorate Office,أنشطة العمل الاجتماعي، دون إقامة، لكبار السن وذوي الإعاقة,28,9,0,0,37
4047,2022,1,Bishah Governorate Office,أنشطة المعمارية والهندسية ، والاختبارات الفنية والتحليل,23,3,2,0,28
4048,2022,1,Bishah Governorate Office,أنشطة المكاتب الرئيسية ، وألأنشطة الاستشارية في مجال الإدارة,7,1,0,0,8
4050,2022,1,Bishah Governorate Office,أنشطة المنظمات ذات العضوية,8,1,0,0,9
4051,2022,1,Bishah Governorate Office,أنشطة النشر,4,0,0,0,4
4052,2022,1,Bishah Governorate Office,أنشطة تقديم الخدمات للمباني وتجميل المواقع,49,12,0,0,61
4054,2022,1,Bishah Governorate Office,أنشطة خدمات الأطعمة والمشروبات,631,96,2,0,729
4057,2022,1,Bishah Governorate Office,أنشطة زراعة المحاصيل والإنتاج الحيواني والصيد والخدمات المتصلة,583,16,0,0,599
4059,2022,1,Bishah Governorate Office,الإقامة,33,11,1,0,45
4060,2022,1,Bishah Governorate Office,الأنشطة الإبداعية والفنون وأنشطة الترفيه,1,0,0,0,1
4061,2022,1,Bishah Governorate Office,الأنشطة الأخرى للتعدين واستغلال المحاجر,11,4,1,0,16
4062,2022,1,Bishah Governorate Office,الأنشطة الإدارية للمكاتب ، وأنشطة الدعم للمكاتب وغير ذلك من أنشطة الدعم للأعمال,22,3,0,0,25
4063,2022,1,Bishah Governorate Office,الأنشطة الإيجارية,290,6,1,0,297
4065,2022,1,Bishah Governorate Office,الأنشطة الرياضية وأنشطة التسلية والترفيه,12,3,0,0,15
4066,2022,1,Bishah Governorate Office,الأنشطة العقارية,8,3,1,0,12
4068,2022,1,Bishah Governorate Office,الأنشطة المساعدة لأنشطة الخدمات المالية وأنشطة التأمين,1,0,0,0,1
4072,2022,1,Bishah Governorate Office,التخزين وأنشطة الدعم للنقل,36,3,0,0,39
4073,2022,1,Bishah Governorate Office,التعليم,18,7,1,0,26
4075,2022,1,Bishah Governorate Office,الصحة البشرية,10,13,2,0,25
4076,2022,1,Bishah Governorate Office,الصناعة التحويلية الأخرى,3,1,0,0,4
4078,2022,1,Bishah Governorate Office,النقل البري و النقل عبر الأنابيب,322,35,1,0,358
4080,2022,1,Bishah Governorate Office,النقل المائي,2,0,0,0,2
4081,2022,1,Bishah Governorate Office,الهندسة المدنية,7,2,0,0,9
4082,2022,1,Bishah Governorate Office,تجارة التجزئة، باستثناء المركبات ذات المحركات والدراجات النارية,1003,158,6,0,1167
4083,2022,1,Bishah Governorate Office,تجارة الجملة ، باستثناء المركبات ذات المحركات والدراجات النارية,226,68,1,1,296
4084,2022,1,Bishah Governorate Office,تجارة الجملة والتجزئة ، وإصلاح المركبات ذات المحركات والدراجات النارية,449,48,0,0,497
4085,2022,1,Bishah Governorate Office,تجميع المياه ومعالجتها وتوصيلها,9,2,0,0,11
4086,2022,1,Bishah Governorate Office,تشييد المباني,828,173,7,3,1011
4087,2022,1,Bishah Governorate Office,تعدين ركازات الفلزات,14,3,0,0,17
4089,2022,1,Bishah Governorate Office,صناعة الآلات والمعدات غير المصنفة في موضع أخر,7,0,0,0,7
4092,2022,1,Bishah Governorate Office,صنع الأثاث,51,14,0,0,65
4093,2022,1,Bishah Governorate Office,صنع الحواسيب والمنتجات الإلكترونية والبصرية,37,3,0,0,40
4094,2022,1,Bishah Governorate Office,صُنع الخشب ومنتجات الخشب والفلين ، باستثناء الأثاث ، صُنع أصناف من القش ومواد الضفر,49,5,0,0,54
4095,2022,1,Bishah Governorate Office,صنع الفلزات القاعدية,31,5,0,0,36
4096,2022,1,Bishah Governorate Office,صُنع المشروبات,7,1,0,0,8
4097,2022,1,Bishah Governorate Office,صنع المعدات الكهربائية,19,0,0,0,19
4098,2022,1,Bishah Governorate Office,صُنع الملبوسات,133,16,0,0,149
4099,2022,1,Bishah Governorate Office,صُنع المنتجات الجلدية والمنتجات ذات الصلة,5,0,0,0,5
4100,2022,1,Bishah Governorate Office,صنع المنتجات الصيدلانية الأساسية والمستحضرات الصيدلانية,2,1,0,0,3
4101,2022,1,Bishah Governorate Office,صُنع المنتجات الغذائية,87,14,1,0,102
4103,2022,1,Bishah Governorate Office,صُنع المواد الكيميائية والمنتجات الكيميائية,19,3,0,0,22
4105,2022,1,Bishah Governorate Office,صنع منتجات المطاط واللدائن,7,5,0,0,12
4106,2022,1,Bishah Governorate Office,صنع منتجات المعادن اللافلزية الأخرى,35,12,4,2,53
4107,2022,1,Bishah Governorate Office,صنع منتجات المعادن المشكلة ( باستثناء الآلات والمعدات ),112,9,0,0,121
4108,2022,1,Bishah Governorate Office,صيد الأسماك وتربية المائيات,16,0,0,0,16
4109,2022,1,Bishah Governorate Office,وكالات السفر ومشغّلو الجولات السياحية وخدمات الحجز والأنشطة المتصلة بها,2,0,0,0,2
4110,2022,1,Hafr Al-Batin Governorate Office,أبحاث الإعلان والسوق,17,3,0,0,20
4111,2022,1,Hafr Al-Batin Governorate Office,إصلاح أجهزة الحاسوب والسلع الشخصية والمنزلية,64,5,0,0,69
4112,2022,1,Hafr Al-Batin Governorate Office,إصلاح وتركيب الآلات والمعدات,28,0,0,0,28
4113,2022,1,Hafr Al-Batin Governorate Office,أنشطة أنتاج الأفلام والبرامج التلفزيونية والتسجيلات الصوتية و نشرالموسيقى,3,0,0,0,3
4115,2022,1,Hafr Al-Batin Governorate Office,أنشطة الاستخدام,19,7,2,1,29
4117,2022,1,Hafr Al-Batin Governorate Office,أنشطة البرمجة الحاسوبية والخبرة الاستشارية وما يتصل بها من أنشطة,4,0,0,0,4
4119,2022,1,Hafr Al-Batin Governorate Office,أنشطة التشييد المتخصصة,706,128,9,1,844
4120,2022,1,Hafr Al-Batin Governorate Office,أنشطة الخدمات الشخصية الأخرى,567,49,2,0,618
4123,2022,1,Hafr Al-Batin Governorate Office,أنشطة المعمارية والهندسية ، والاختبارات الفنية والتحليل,41,10,2,0,53
4124,2022,1,Hafr Al-Batin Governorate Office,أنشطة المكاتب الرئيسية ، وألأنشطة الاستشارية في مجال الإدارة,15,2,0,0,17
4126,2022,1,Hafr Al-Batin Governorate Office,أنشطة المنظمات ذات العضوية,1,1,0,0,2
4127,2022,1,Hafr Al-Batin Governorate Office,أنشطة النشر,12,5,0,0,17
4128,2022,1,Hafr Al-Batin Governorate Office,أنشطة تقديم الخدمات للمباني وتجميل المواقع,113,25,2,0,140
4129,2022,1,Hafr Al-Batin Governorate Office,أنشطة جمع النفايات ومعالجتها وتصريفها ، واسترجاع المواد,2,0,1,0,3
4130,2022,1,Hafr Al-Batin Governorate Office,أنشطة خدمات الأطعمة والمشروبات,1606,289,16,1,1912
4132,2022,1,Hafr Al-Batin Governorate Office,أنشطة خدمات دعم التعدين,11,0,0,0,11
4133,2022,1,Hafr Al-Batin Governorate Office,أنشطة زراعة المحاصيل والإنتاج الحيواني والصيد والخدمات المتصلة,253,6,0,0,259
4135,2022,1,Hafr Al-Batin Governorate Office,الإقامة,42,17,1,0,60
4136,2022,1,Hafr Al-Batin Governorate Office,الأنشطة الإبداعية والفنون وأنشطة الترفيه,2,0,0,0,2
4137,2022,1,Hafr Al-Batin Governorate Office,الأنشطة الأخرى للتعدين واستغلال المحاجر,8,2,0,0,10
4138,2022,1,Hafr Al-Batin Governorate Office,الأنشطة الإدارية للمكاتب ، وأنشطة الدعم للمكاتب وغير ذلك من أنشطة الدعم للأعمال,33,3,0,0,36
4139,2022,1,Hafr Al-Batin Governorate Office,الأنشطة الإيجارية,506,25,0,0,531
4140,2022,1,Hafr Al-Batin Governorate Office,الأنشطة البيطرية,8,0,0,0,8
4141,2022,1,Hafr Al-Batin Governorate Office,الأنشطة الرياضية وأنشطة التسلية والترفيه,19,7,0,0,26
4142,2022,1,Hafr Al-Batin Governorate Office,الأنشطة العقارية,26,3,0,0,29
4143,2022,1,Hafr Al-Batin Governorate Office,الأنشطة القانونية وأنشطة المحاسبة,7,0,0,0,7
4144,2022,1,Hafr Al-Batin Governorate Office,الأنشطة المساعدة لأنشطة الخدمات المالية وأنشطة التأمين,3,0,0,0,3
4145,2022,1,Hafr Al-Batin Governorate Office,الأنشطة المهنية والعلمية والتقنية الأخرى,12,2,1,0,15
4147,2022,1,Hafr Al-Batin Governorate Office,التخزين وأنشطة الدعم للنقل,88,22,1,0,111
4148,2022,1,Hafr Al-Batin Governorate Office,التعليم,23,22,6,1,52
4149,2022,1,Hafr Al-Batin Governorate Office,الصحة البشرية,27,24,9,0,60
4151,2022,1,Hafr Al-Batin Governorate Office,الطباعة واستنساخ وسائط الأعلام المسجّلة,11,5,0,0,16
4152,2022,1,Hafr Al-Batin Governorate Office,النقل البري و النقل عبر الأنابيب,423,84,7,2,516
4153,2022,1,Hafr Al-Batin Governorate Office,النقل الجوي,7,4,0,0,11
4155,2022,1,Hafr Al-Batin Governorate Office,الهندسة المدنية,4,1,0,0,5
4156,2022,1,Hafr Al-Batin Governorate Office,تجارة التجزئة، باستثناء المركبات ذات المحركات والدراجات النارية,1324,202,12,0,1538
4157,2022,1,Hafr Al-Batin Governorate Office,تجارة الجملة ، باستثناء المركبات ذات المحركات والدراجات النارية,394,72,9,1,476
4158,2022,1,Hafr Al-Batin Governorate Office,تجارة الجملة والتجزئة ، وإصلاح المركبات ذات المحركات والدراجات النارية,741,119,6,0,866
4159,2022,1,Hafr Al-Batin Governorate Office,تجميع المياه ومعالجتها وتوصيلها,6,1,0,0,7
4160,2022,1,Hafr Al-Batin Governorate Office,تشييد المباني,1378,293,35,1,1707
4162,2022,1,Hafr Al-Batin Governorate Office,تعدين ركازات الفلزات,45,7,0,0,52
4164,2022,1,Hafr Al-Batin Governorate Office,صناعة الآلات والمعدات غير المصنفة في موضع أخر,16,0,0,0,16
4165,2022,1,Hafr Al-Batin Governorate Office,صناعة المركبات ذات المحركات والمركبات المقطورة ونصف المقطورة,17,2,0,0,19
4166,2022,1,Hafr Al-Batin Governorate Office,صناعة معدات النقل الأخرى,8,1,0,0,9
4167,2022,1,Hafr Al-Batin Governorate Office,صنع الأثاث,123,21,0,0,144
4169,2022,1,Hafr Al-Batin Governorate Office,صُنع الخشب ومنتجات الخشب والفلين ، باستثناء الأثاث ، صُنع أصناف من القش ومواد الضفر,62,9,0,0,71
4170,2022,1,Hafr Al-Batin Governorate Office,صنع الفلزات القاعدية,28,10,0,0,38
4171,2022,1,Hafr Al-Batin Governorate Office,صُنع المشروبات,8,5,2,0,15
4172,2022,1,Hafr Al-Batin Governorate Office,صنع المعدات الكهربائية,72,10,0,0,82
4173,2022,1,Hafr Al-Batin Governorate Office,صُنع الملبوسات,315,28,0,0,343
4174,2022,1,Hafr Al-Batin Governorate Office,صُنع المنتجات الجلدية والمنتجات ذات الصلة,3,2,1,0,6
4176,2022,1,Hafr Al-Batin Governorate Office,صُنع المنتجات الغذائية,131,36,8,1,176
4177,2022,1,Hafr Al-Batin Governorate Office,صُنع المنسوجات,66,11,1,0,78
4178,2022,1,Hafr Al-Batin Governorate Office,صُنع المواد الكيميائية والمنتجات الكيميائية,23,6,0,0,29
4182,2022,1,Hafr Al-Batin Governorate Office,صنع منتجات المطاط واللدائن,10,6,1,0,17
4183,2022,1,Hafr Al-Batin Governorate Office,صنع منتجات المعادن اللافلزية الأخرى,105,38,6,0,149
4184,2022,1,Hafr Al-Batin Governorate Office,صنع منتجات المعادن المشكلة ( باستثناء الآلات والمعدات ),136,31,2,0,169
4185,2022,1,Hafr Al-Batin Governorate Office,صيد الأسماك وتربية المائيات,30,1,0,0,31
4186,2022,1,Hafr Al-Batin Governorate Office,وكالات السفر ومشغّلو الجولات السياحية وخدمات الحجز والأنشطة المتصلة بها,4,3,0,0,7
4187,2022,1,Yanbu Governorate Office,أبحاث الإعلان والسوق,14,0,0,0,14
4188,2022,1,Yanbu Governorate Office,إصلاح أجهزة الحاسوب والسلع الشخصية والمنزلية,69,7,0,0,76
4189,2022,1,Yanbu Governorate Office,إصلاح وتركيب الآلات والمعدات,30,5,0,0,35
4191,2022,1,Yanbu Governorate Office,أنشطة الأمن والتحقيقات,1,0,0,0,1
4192,2022,1,Yanbu Governorate Office,أنشطة الاستخدام,12,1,0,0,13
4195,2022,1,Yanbu Governorate Office,أنشطة التشييد المتخصصة,618,109,9,0,736
4196,2022,1,Yanbu Governorate Office,أنشطة الخدمات الشخصية الأخرى,381,40,4,0,425
4197,2022,1,Yanbu Governorate Office,أنشطة الخدمات المالية ، فيما عدا تمويل التأمين وصناديق المعاشات,6,0,0,0,6
4198,2022,1,Yanbu Governorate Office,أنشطة العمل الاجتماعي، دون إقامة، لكبار السن وذوي الإعاقة,23,9,0,0,32
4199,2022,1,Yanbu Governorate Office,أنشطة المعمارية والهندسية ، والاختبارات الفنية والتحليل,30,6,0,1,37
4203,2022,1,Yanbu Governorate Office,أنشطة المنظمات ذات العضوية,8,5,0,0,13
4204,2022,1,Yanbu Governorate Office,أنشطة النشر,4,1,0,0,5
4205,2022,1,Yanbu Governorate Office,أنشطة تقديم الخدمات للمباني وتجميل المواقع,116,50,0,1,167
4206,2022,1,Yanbu Governorate Office,أنشطة خدمات الأطعمة والمشروبات,997,241,9,0,1247
4209,2022,1,Yanbu Governorate Office,أنشطة زراعة المحاصيل والإنتاج الحيواني والصيد والخدمات المتصلة,193,9,0,0,202
4211,2022,1,Yanbu Governorate Office,الإقامة,57,17,4,0,78
4213,2022,1,Yanbu Governorate Office,الأنشطة الأخرى للتعدين واستغلال المحاجر,6,2,0,0,8
4214,2022,1,Yanbu Governorate Office,الأنشطة الإدارية للمكاتب ، وأنشطة الدعم للمكاتب وغير ذلك من أنشطة الدعم للأعمال,20,0,0,0,20
4215,2022,1,Yanbu Governorate Office,الأنشطة الإيجارية,201,13,1,0,215
4216,2022,1,Yanbu Governorate Office,الأنشطة الرياضية وأنشطة التسلية والترفيه,26,6,1,0,33
4217,2022,1,Yanbu Governorate Office,الأنشطة العقارية,17,2,0,0,19
4222,2022,1,Yanbu Governorate Office,التخزين وأنشطة الدعم للنقل,44,13,2,1,60
4223,2022,1,Yanbu Governorate Office,التعليم,19,20,7,0,46
4224,2022,1,Yanbu Governorate Office,الرعاية مع الإقامة,8,1,0,0,9
4225,2022,1,Yanbu Governorate Office,الصحة البشرية,16,23,4,2,45
4227,2022,1,Yanbu Governorate Office,الصناعة التحويلية الأخرى,7,1,0,0,8
4228,2022,1,Yanbu Governorate Office,الطباعة واستنساخ وسائط الأعلام المسجّلة,16,1,0,0,17
4229,2022,1,Yanbu Governorate Office,النقل البري و النقل عبر الأنابيب,298,47,10,0,355
4231,2022,1,Yanbu Governorate Office,النقل المائي,10,1,1,0,12
4232,2022,1,Yanbu Governorate Office,الهندسة المدنية,11,4,1,1,17
4233,2022,1,Yanbu Governorate Office,تجارة التجزئة، باستثناء المركبات ذات المحركات والدراجات النارية,1079,210,9,2,1300
4234,2022,1,Yanbu Governorate Office,تجارة الجملة ، باستثناء المركبات ذات المحركات والدراجات النارية,322,87,9,0,418
4235,2022,1,Yanbu Governorate Office,تجارة الجملة والتجزئة ، وإصلاح المركبات ذات المحركات والدراجات النارية,558,75,2,0,635
4236,2022,1,Yanbu Governorate Office,تجميع المياه ومعالجتها وتوصيلها,5,2,0,0,7
4237,2022,1,Yanbu Governorate Office,تشييد المباني,1005,346,51,3,1405
4238,2022,1,Yanbu Governorate Office,تعدين الفحم والليغنيت,2,0,0,0,2
4239,2022,1,Yanbu Governorate Office,تعدين ركازات الفلزات,5,0,0,0,5
4241,2022,1,Yanbu Governorate Office,توصيل الكهرباء والغاز والبخار وتكييف الهواء,6,2,0,0,8
4242,2022,1,Yanbu Governorate Office,صناعة الآلات والمعدات غير المصنفة في موضع أخر,4,1,1,0,6
4243,2022,1,Yanbu Governorate Office,صناعة المركبات ذات المحركات والمركبات المقطورة ونصف المقطورة,7,1,1,0,9
4244,2022,1,Yanbu Governorate Office,صناعة معدات النقل الأخرى,6,0,0,0,6
4245,2022,1,Yanbu Governorate Office,صنع الأثاث,46,4,0,0,50
4247,2022,1,Yanbu Governorate Office,صُنع الخشب ومنتجات الخشب والفلين ، باستثناء الأثاث ، صُنع أصناف من القش ومواد الضفر,38,5,1,0,44
4249,2022,1,Yanbu Governorate Office,صُنع المشروبات,6,1,0,0,7
4250,2022,1,Yanbu Governorate Office,صنع المعدات الكهربائية,17,2,1,1,21
4251,2022,1,Yanbu Governorate Office,صُنع الملبوسات,171,15,0,0,186
4253,2022,1,Yanbu Governorate Office,صُنع المنتجات الغذائية,85,20,7,0,112
4254,2022,1,Yanbu Governorate Office,صُنع المنسوجات,11,1,1,0,13
4255,2022,1,Yanbu Governorate Office,صُنع المواد الكيميائية والمنتجات الكيميائية,12,10,7,2,31
4257,2022,1,Yanbu Governorate Office,صنع فحم الكوك والمنتجات النفطية المكررة,2,1,2,1,6
4259,2022,1,Yanbu Governorate Office,صنع منتجات المطاط واللدائن,8,6,1,1,16
4260,2022,1,Yanbu Governorate Office,صنع منتجات المعادن اللافلزية الأخرى,32,17,16,4,69
4261,2022,1,Yanbu Governorate Office,صنع منتجات المعادن المشكلة ( باستثناء الآلات والمعدات ),70,13,3,0,86
4262,2022,1,Yanbu Governorate Office,صيد الأسماك وتربية المائيات,47,17,0,0,64
4263,2022,1,Yanbu Governorate Office,وكالات السفر ومشغّلو الجولات السياحية وخدمات الحجز والأنشطة المتصلة بها,6,2,0,0,8
4264,2022,1,Makkah Al-Mukarramah Office,أبحاث الإعلان والسوق,55,6,0,0,61
4265,2022,1,Makkah Al-Mukarramah Office,إصلاح أجهزة الحاسوب والسلع الشخصية والمنزلية,291,35,0,0,326
4266,2022,1,Makkah Al-Mukarramah Office,إصلاح وتركيب الآلات والمعدات,177,11,0,0,188
4267,2022,1,Makkah Al-Mukarramah Office,أنشطة أنتاج الأفلام والبرامج التلفزيونية والتسجيلات الصوتية و نشرالموسيقى,24,1,0,0,25
4268,2022,1,Makkah Al-Mukarramah Office,أنشطة الأمن والتحقيقات,19,7,4,2,32
4269,2022,1,Makkah Al-Mukarramah Office,أنشطة الاستخدام,37,5,1,1,44
4271,2022,1,Makkah Al-Mukarramah Office,أنشطة البرمجة الحاسوبية والخبرة الاستشارية وما يتصل بها من أنشطة,43,9,0,0,52
4273,2022,1,Makkah Al-Mukarramah Office,أنشطة البريد ونقل الرسائل والطرود بواسطة مندوبين,8,1,0,0,9
4274,2022,1,Makkah Al-Mukarramah Office,أنشطة التشييد المتخصصة,2552,541,37,2,3132
4275,2022,1,Makkah Al-Mukarramah Office,أنشطة الخدمات الشخصية الأخرى,2028,248,9,0,2285
4276,2022,1,Makkah Al-Mukarramah Office,أنشطة الخدمات المالية ، فيما عدا تمويل التأمين وصناديق المعاشات,63,11,0,0,74
4277,2022,1,Makkah Al-Mukarramah Office,أنشطة العمل الاجتماعي، دون إقامة، لكبار السن وذوي الإعاقة,211,105,9,1,326
4279,2022,1,Makkah Al-Mukarramah Office,أنشطة المعمارية والهندسية ، والاختبارات الفنية والتحليل,265,168,7,2,442
4281,2022,1,Makkah Al-Mukarramah Office,أنشطة المكتبات ودور المحفوظات، والمتاحف والأنشطة الثقافية الأخرى,59,11,1,0,71
4283,2022,1,Makkah Al-Mukarramah Office,أنشطة المنظمات ذات العضوية,45,9,0,0,54
4284,2022,1,Makkah Al-Mukarramah Office,أنشطة النشر,25,1,0,0,26
4285,2022,1,Makkah Al-Mukarramah Office,أنشطة تقديم الخدمات للمباني وتجميل المواقع,811,198,24,2,1035
4287,2022,1,Makkah Al-Mukarramah Office,أنشطة خدمات الأطعمة والمشروبات,4706,996,65,4,5771
4290,2022,1,Makkah Al-Mukarramah Office,أنشطة زراعة المحاصيل والإنتاج الحيواني والصيد والخدمات المتصلة,764,28,1,1,794
4291,2022,1,Makkah Al-Mukarramah Office,الإدارة العامة والدفاع ؛ والضمان الاجتماعي الإلزامي,67,39,2,0,108
4292,2022,1,Makkah Al-Mukarramah Office,الإقامة,384,163,40,9,596
4294,2022,1,Makkah Al-Mukarramah Office,الأنشطة الأخرى للتعدين واستغلال المحاجر,15,4,0,0,19
4295,2022,1,Makkah Al-Mukarramah Office,الأنشطة الإدارية للمكاتب ، وأنشطة الدعم للمكاتب وغير ذلك من أنشطة الدعم للأعمال,162,12,0,0,174
4296,2022,1,Makkah Al-Mukarramah Office,الأنشطة الإيجارية,972,38,0,1,1011
4298,2022,1,Makkah Al-Mukarramah Office,الأنشطة الرياضية وأنشطة التسلية والترفيه,76,24,1,0,101
4299,2022,1,Makkah Al-Mukarramah Office,الأنشطة العقارية,211,34,3,0,248
4300,2022,1,Makkah Al-Mukarramah Office,الأنشطة القانونية وأنشطة المحاسبة,45,5,0,0,50
4301,2022,1,Makkah Al-Mukarramah Office,الأنشطة المساعدة لأنشطة الخدمات المالية وأنشطة التأمين,12,10,1,0,23
4302,2022,1,Makkah Al-Mukarramah Office,الأنشطة المهنية والعلمية والتقنية الأخرى,67,11,0,0,78
4305,2022,1,Makkah Al-Mukarramah Office,التخزين وأنشطة الدعم للنقل,92,16,2,0,110
4306,2022,1,Makkah Al-Mukarramah Office,التعليم,78,49,22,2,151
4308,2022,1,Makkah Al-Mukarramah Office,الرعاية مع الإقامة,12,3,1,0,16
4309,2022,1,Makkah Al-Mukarramah Office,الصحة البشرية,90,126,32,3,251
4310,2022,1,Makkah Al-Mukarramah Office,الصرف الصحي,7,1,1,0,9
4311,2022,1,Makkah Al-Mukarramah Office,الصناعة التحويلية الأخرى,40,12,2,0,54
4312,2022,1,Makkah Al-Mukarramah Office,الطباعة واستنساخ وسائط الأعلام المسجّلة,64,23,2,0,89
4313,2022,1,Makkah Al-Mukarramah Office,النقل البري و النقل عبر الأنابيب,1023,162,15,2,1202
4314,2022,1,Makkah Al-Mukarramah Office,النقل الجوي,20,3,1,0,24
4316,2022,1,Makkah Al-Mukarramah Office,الهندسة المدنية,55,11,0,1,67
4317,2022,1,Makkah Al-Mukarramah Office,تجارة التجزئة، باستثناء المركبات ذات المحركات والدراجات النارية,5937,1130,51,5,7123
4318,2022,1,Makkah Al-Mukarramah Office,تجارة الجملة ، باستثناء المركبات ذات المحركات والدراجات النارية,1781,441,31,2,2255
4319,2022,1,Makkah Al-Mukarramah Office,تجارة الجملة والتجزئة ، وإصلاح المركبات ذات المحركات والدراجات النارية,2134,320,8,0,2462
4320,2022,1,Makkah Al-Mukarramah Office,تجميع المياه ومعالجتها وتوصيلها,67,23,0,1,91
4321,2022,1,Makkah Al-Mukarramah Office,تشييد المباني,5333,1664,151,12,7160
4322,2022,1,Makkah Al-Mukarramah Office,تعدين ركازات الفلزات,23,2,0,0,25
4323,2022,1,Makkah Al-Mukarramah Office,تمويل التأمين وإعادة التأمين وصناديق المعاشات التقاعدية باستثناء الضمان الاجتماعي الإلزامي,3,2,0,0,5
4324,2022,1,Makkah Al-Mukarramah Office,توصيل الكهرباء والغاز والبخار وتكييف الهواء,9,10,2,0,21
4325,2022,1,Makkah Al-Mukarramah Office,صناعة الآلات والمعدات غير المصنفة في موضع أخر,28,3,0,0,31
4326,2022,1,Makkah Al-Mukarramah Office,صناعة المركبات ذات المحركات والمركبات المقطورة ونصف المقطورة,41,5,1,0,47
4327,2022,1,Makkah Al-Mukarramah Office,صناعة معدات النقل الأخرى,15,0,0,1,16
4328,2022,1,Makkah Al-Mukarramah Office,صنع الأثاث,158,34,2,0,194
4329,2022,1,Makkah Al-Mukarramah Office,صنع الحواسيب والمنتجات الإلكترونية والبصرية,72,16,0,0,88
4330,2022,1,Makkah Al-Mukarramah Office,صُنع الخشب ومنتجات الخشب والفلين ، باستثناء الأثاث ، صُنع أصناف من القش ومواد الضفر,231,40,2,0,273
4331,2022,1,Makkah Al-Mukarramah Office,صنع الفلزات القاعدية,63,24,2,0,89
4332,2022,1,Makkah Al-Mukarramah Office,صُنع المشروبات,20,9,3,0,32
4333,2022,1,Makkah Al-Mukarramah Office,صنع المعدات الكهربائية,89,14,1,0,104
4334,2022,1,Makkah Al-Mukarramah Office,صُنع الملبوسات,730,80,0,0,810
4335,2022,1,Makkah Al-Mukarramah Office,صُنع المنتجات الجلدية والمنتجات ذات الصلة,18,2,0,0,20
4337,2022,1,Makkah Al-Mukarramah Office,صُنع المنتجات الغذائية,564,145,15,2,726
4338,2022,1,Makkah Al-Mukarramah Office,صُنع المنسوجات,114,20,0,0,134
4339,2022,1,Makkah Al-Mukarramah Office,صُنع المواد الكيميائية والمنتجات الكيميائية,74,28,0,0,102
4340,2022,1,Makkah Al-Mukarramah Office,صُنع الورق ومنتجات الورق,8,3,1,0,12
4341,2022,1,Makkah Al-Mukarramah Office,صنع فحم الكوك والمنتجات النفطية المكررة,3,0,0,0,3
4342,2022,1,Makkah Al-Mukarramah Office,صُنع منتجات التبغ,2,1,0,0,3
4343,2022,1,Makkah Al-Mukarramah Office,صنع منتجات المطاط واللدائن,22,10,2,1,35
4344,2022,1,Makkah Al-Mukarramah Office,صنع منتجات المعادن اللافلزية الأخرى,122,38,9,0,169
4345,2022,1,Makkah Al-Mukarramah Office,صنع منتجات المعادن المشكلة ( باستثناء الآلات والمعدات ),519,89,8,0,616
4346,2022,1,Makkah Al-Mukarramah Office,صيد الأسماك وتربية المائيات,169,14,1,0,184
4347,2022,1,Makkah Al-Mukarramah Office,وكالات السفر ومشغّلو الجولات السياحية وخدمات الحجز والأنشطة المتصلة بها,126,40,3,0,169
4348,2022,1,Al-Baha District Office,أبحاث الإعلان والسوق,4,2,0,0,6
4349,2022,1,Al-Baha District Office,إصلاح أجهزة الحاسوب والسلع الشخصية والمنزلية,48,2,0,0,50
4350,2022,1,Al-Baha District Office,إصلاح وتركيب الآلات والمعدات,18,1,0,0,19
4351,2022,1,Al-Baha District Office,أنشطة أنتاج الأفلام والبرامج التلفزيونية والتسجيلات الصوتية و نشرالموسيقى,1,0,0,0,1
4353,2022,1,Al-Baha District Office,أنشطة الاستخدام,9,1,0,0,10
4354,2022,1,Al-Baha District Office,أنشطة البرمجة الحاسوبية والخبرة الاستشارية وما يتصل بها من أنشطة,2,0,0,0,2
4355,2022,1,Al-Baha District Office,أنشطة التشييد المتخصصة,483,68,0,1,552
4356,2022,1,Al-Baha District Office,أنشطة الخدمات الشخصية الأخرى,285,16,0,0,301
4358,2022,1,Al-Baha District Office,أنشطة العمل الاجتماعي، دون إقامة، لكبار السن وذوي الإعاقة,28,16,0,0,44
4359,2022,1,Al-Baha District Office,أنشطة المعمارية والهندسية ، والاختبارات الفنية والتحليل,84,37,3,0,124
4363,2022,1,Al-Baha District Office,أنشطة المنظمات ذات العضوية,14,5,0,0,19
4365,2022,1,Al-Baha District Office,أنشطة تقديم الخدمات للمباني وتجميل المواقع,61,8,2,0,71
4367,2022,1,Al-Baha District Office,أنشطة خدمات الأطعمة والمشروبات,692,178,5,0,875
4370,2022,1,Al-Baha District Office,أنشطة زراعة المحاصيل والإنتاج الحيواني والصيد والخدمات المتصلة,316,5,0,0,321
4371,2022,1,Al-Baha District Office,الإدارة العامة والدفاع ؛ والضمان الاجتماعي الإلزامي,7,9,1,0,17
4372,2022,1,Al-Baha District Office,الإقامة,47,23,1,0,71
4375,2022,1,Al-Baha District Office,الأنشطة الإدارية للمكاتب ، وأنشطة الدعم للمكاتب وغير ذلك من أنشطة الدعم للأعمال,23,0,0,0,23
4376,2022,1,Al-Baha District Office,الأنشطة الإيجارية,142,4,0,0,146
4378,2022,1,Al-Baha District Office,الأنشطة الرياضية وأنشطة التسلية والترفيه,23,2,0,0,25
4379,2022,1,Al-Baha District Office,الأنشطة العقارية,11,1,0,0,12
4380,2022,1,Al-Baha District Office,الأنشطة القانونية وأنشطة المحاسبة,4,0,0,0,4
4381,2022,1,Al-Baha District Office,الأنشطة المهنية والعلمية والتقنية الأخرى,5,0,0,0,5
4382,2022,1,Al-Baha District Office,الاتصالات,7,1,0,0,8
4383,2022,1,Al-Baha District Office,التخزين وأنشطة الدعم للنقل,28,2,0,0,30
4384,2022,1,Al-Baha District Office,التعليم,13,7,0,0,20
4386,2022,1,Al-Baha District Office,الصحة البشرية,21,20,1,0,42
4388,2022,1,Al-Baha District Office,الصناعة التحويلية الأخرى,9,0,0,0,9
4390,2022,1,Al-Baha District Office,النقل البري و النقل عبر الأنابيب,145,15,0,0,160
4392,2022,1,Al-Baha District Office,الهندسة المدنية,6,3,1,0,10
4393,2022,1,Al-Baha District Office,تجارة التجزئة، باستثناء المركبات ذات المحركات والدراجات النارية,1094,224,9,0,1327
4394,2022,1,Al-Baha District Office,تجارة الجملة ، باستثناء المركبات ذات المحركات والدراجات النارية,391,180,6,0,577
4395,2022,1,Al-Baha District Office,تجارة الجملة والتجزئة ، وإصلاح المركبات ذات المحركات والدراجات النارية,401,60,1,0,462
4396,2022,1,Al-Baha District Office,تجميع المياه ومعالجتها وتوصيلها,21,1,0,0,22
4397,2022,1,Al-Baha District Office,تشييد المباني,745,152,11,1,909
4398,2022,1,Al-Baha District Office,تعدين ركازات الفلزات,11,1,0,0,12
4403,2022,1,Al-Baha District Office,صنع الأثاث,53,9,0,0,62
4404,2022,1,Al-Baha District Office,صنع الحواسيب والمنتجات الإلكترونية والبصرية,16,4,0,0,20
4405,2022,1,Al-Baha District Office,صُنع الخشب ومنتجات الخشب والفلين ، باستثناء الأثاث ، صُنع أصناف من القش ومواد الضفر,55,13,0,0,68
4406,2022,1,Al-Baha District Office,صنع الفلزات القاعدية,24,3,0,0,27
4407,2022,1,Al-Baha District Office,صُنع المشروبات,5,2,0,0,7
4408,2022,1,Al-Baha District Office,صنع المعدات الكهربائية,16,1,0,0,17
4409,2022,1,Al-Baha District Office,صُنع الملبوسات,116,15,0,0,131
4412,2022,1,Al-Baha District Office,صُنع المنتجات الغذائية,104,13,1,0,118
4413,2022,1,Al-Baha District Office,صُنع المنسوجات,10,3,0,0,13
4414,2022,1,Al-Baha District Office,صُنع المواد الكيميائية والمنتجات الكيميائية,9,2,0,0,11
4416,2022,1,Al-Baha District Office,صنع منتجات المطاط واللدائن,4,2,0,0,6
4417,2022,1,Al-Baha District Office,صنع منتجات المعادن اللافلزية الأخرى,41,24,5,0,70
4418,2022,1,Al-Baha District Office,صنع منتجات المعادن المشكلة ( باستثناء الآلات والمعدات ),139,17,0,0,156
4419,2022,1,Al-Baha District Office,صيد الأسماك وتربية المائيات,7,0,0,0,7
4421,2022,1,Al-Jouf Region Office,أبحاث الإعلان والسوق,43,3,0,0,46
4422,2022,1,Al-Jouf Region Office,إصلاح أجهزة الحاسوب والسلع الشخصية والمنزلية,88,8,1,0,97
4423,2022,1,Al-Jouf Region Office,إصلاح وتركيب الآلات والمعدات,25,3,0,0,28
4426,2022,1,Al-Jouf Region Office,أنشطة الاستخدام,16,3,0,0,19
4427,2022,1,Al-Jouf Region Office,أنشطة البرمجة الحاسوبية والخبرة الاستشارية وما يتصل بها من أنشطة,9,3,0,0,12
4430,2022,1,Al-Jouf Region Office,أنشطة التشييد المتخصصة,738,174,8,0,920
4431,2022,1,Al-Jouf Region Office,أنشطة الخدمات الشخصية الأخرى,532,53,0,0,585
4433,2022,1,Al-Jouf Region Office,أنشطة العمل الاجتماعي، دون إقامة، لكبار السن وذوي الإعاقة,15,16,0,0,31
4434,2022,1,Al-Jouf Region Office,أنشطة المعمارية والهندسية ، والاختبارات الفنية والتحليل,100,38,1,0,139
4435,2022,1,Al-Jouf Region Office,أنشطة المكاتب الرئيسية ، وألأنشطة الاستشارية في مجال الإدارة,10,2,0,0,12
4439,2022,1,Al-Jouf Region Office,أنشطة تقديم الخدمات للمباني وتجميل المواقع,314,84,7,1,406
4440,2022,1,Al-Jouf Region Office,أنشطة جمع النفايات ومعالجتها وتصريفها ، واسترجاع المواد,4,0,0,0,4
4441,2022,1,Al-Jouf Region Office,أنشطة خدمات الأطعمة والمشروبات,1031,204,6,0,1241
4443,2022,1,Al-Jouf Region Office,أنشطة خدمات دعم التعدين,6,1,0,0,7
4444,2022,1,Al-Jouf Region Office,أنشطة زراعة المحاصيل والإنتاج الحيواني والصيد والخدمات المتصلة,699,21,0,2,722
4446,2022,1,Al-Jouf Region Office,الإقامة,66,11,1,0,78
4447,2022,1,Al-Jouf Region Office,الأنشطة الإبداعية والفنون وأنشطة الترفيه,3,0,0,0,3
4448,2022,1,Al-Jouf Region Office,الأنشطة الأخرى للتعدين واستغلال المحاجر,7,1,0,0,8
4449,2022,1,Al-Jouf Region Office,الأنشطة الإدارية للمكاتب ، وأنشطة الدعم للمكاتب وغير ذلك من أنشطة الدعم للأعمال,33,1,0,0,34
4450,2022,1,Al-Jouf Region Office,الأنشطة الإيجارية,604,21,0,0,625
4452,2022,1,Al-Jouf Region Office,الأنشطة الرياضية وأنشطة التسلية والترفيه,43,6,0,0,49
4453,2022,1,Al-Jouf Region Office,الأنشطة العقارية,30,2,1,0,33
4454,2022,1,Al-Jouf Region Office,الأنشطة القانونية وأنشطة المحاسبة,13,1,0,0,14
4456,2022,1,Al-Jouf Region Office,الاتصالات,20,1,0,0,21
4457,2022,1,Al-Jouf Region Office,التخزين وأنشطة الدعم للنقل,115,17,3,0,135
4458,2022,1,Al-Jouf Region Office,التعليم,18,29,12,0,59
4461,2022,1,Al-Jouf Region Office,الصحة البشرية,21,29,7,0,57
4464,2022,1,Al-Jouf Region Office,الطباعة واستنساخ وسائط الأعلام المسجّلة,16,4,0,0,20
4465,2022,1,Al-Jouf Region Office,النقل البري و النقل عبر الأنابيب,480,62,1,0,543
4466,2022,1,Al-Jouf Region Office,النقل الجوي,13,0,0,0,13
4467,2022,1,Al-Jouf Region Office,الهندسة المدنية,15,3,0,0,18
4468,2022,1,Al-Jouf Region Office,تجارة التجزئة، باستثناء المركبات ذات المحركات والدراجات النارية,1438,224,10,1,1673
4469,2022,1,Al-Jouf Region Office,تجارة الجملة ، باستثناء المركبات ذات المحركات والدراجات النارية,400,85,3,1,489
4470,2022,1,Al-Jouf Region Office,تجارة الجملة والتجزئة ، وإصلاح المركبات ذات المحركات والدراجات النارية,607,97,0,0,704
4471,2022,1,Al-Jouf Region Office,تجميع المياه ومعالجتها وتوصيلها,10,1,0,0,11
4472,2022,1,Al-Jouf Region Office,تشييد المباني,1000,205,16,1,1222
4474,2022,1,Al-Jouf Region Office,تعدين ركازات الفلزات,5,1,0,0,6
4475,2022,1,Al-Jouf Region Office,توصيل الكهرباء والغاز والبخار وتكييف الهواء,8,2,0,0,10
4477,2022,1,Al-Jouf Region Office,صناعة المركبات ذات المحركات والمركبات المقطورة ونصف المقطورة,13,3,0,0,16
4478,2022,1,Al-Jouf Region Office,صناعة معدات النقل الأخرى,2,2,0,0,4
4479,2022,1,Al-Jouf Region Office,صنع الأثاث,94,10,0,0,104
4481,2022,1,Al-Jouf Region Office,صُنع الخشب ومنتجات الخشب والفلين ، باستثناء الأثاث ، صُنع أصناف من القش ومواد الضفر,55,5,0,0,60
4482,2022,1,Al-Jouf Region Office,صنع الفلزات القاعدية,38,9,0,0,47
4483,2022,1,Al-Jouf Region Office,صُنع المشروبات,7,4,1,1,13
4484,2022,1,Al-Jouf Region Office,صنع المعدات الكهربائية,25,3,0,0,28
4485,2022,1,Al-Jouf Region Office,صُنع الملبوسات,240,19,0,0,259
4486,2022,1,Al-Jouf Region Office,صُنع المنتجات الجلدية والمنتجات ذات الصلة,1,0,0,0,1
4487,2022,1,Al-Jouf Region Office,صنع المنتجات الصيدلانية الأساسية والمستحضرات الصيدلانية,3,0,0,0,3
4488,2022,1,Al-Jouf Region Office,صُنع المنتجات الغذائية,156,45,1,0,202
4489,2022,1,Al-Jouf Region Office,صُنع المنسوجات,29,8,0,0,37
4492,2022,1,Al-Jouf Region Office,صنع منتجات المطاط واللدائن,9,3,0,0,12
4493,2022,1,Al-Jouf Region Office,صنع منتجات المعادن اللافلزية الأخرى,55,23,5,0,83
4494,2022,1,Al-Jouf Region Office,صنع منتجات المعادن المشكلة ( باستثناء الآلات والمعدات ),152,17,1,0,170
4495,2022,1,Al-Jouf Region Office,صيد الأسماك وتربية المائيات,31,2,0,0,33
4496,2022,1,Al-Jouf Region Office,وكالات السفر ومشغّلو الجولات السياحية وخدمات الحجز والأنشطة المتصلة بها,7,3,0,0,10
4497,2022,1,Northern Border Region Office,أبحاث الإعلان والسوق,9,1,0,0,10
4498,2022,1,Northern Border Region Office,إصلاح أجهزة الحاسوب والسلع الشخصية والمنزلية,49,1,0,0,50
4499,2022,1,Northern Border Region Office,إصلاح وتركيب الآلات والمعدات,22,2,0,0,24
4502,2022,1,Northern Border Region Office,أنشطة الاستخدام,11,1,0,0,12
4504,2022,1,Northern Border Region Office,أنشطة البرمجة الحاسوبية والخبرة الاستشارية وما يتصل بها من أنشطة,3,0,0,0,3
4506,2022,1,Northern Border Region Office,أنشطة التشييد المتخصصة,362,44,3,0,409
4507,2022,1,Northern Border Region Office,أنشطة الخدمات الشخصية الأخرى,425,29,0,0,454
4508,2022,1,Northern Border Region Office,أنشطة الخدمات المالية ، فيما عدا تمويل التأمين وصناديق المعاشات,10,2,0,0,12
4510,2022,1,Northern Border Region Office,أنشطة المعمارية والهندسية ، والاختبارات الفنية والتحليل,108,30,1,0,139
4511,2022,1,Northern Border Region Office,أنشطة المكاتب الرئيسية ، وألأنشطة الاستشارية في مجال الإدارة,6,3,0,0,9
4513,2022,1,Northern Border Region Office,أنشطة المنظمات ذات العضوية,11,1,0,0,12
4514,2022,1,Northern Border Region Office,أنشطة النشر,1,0,0,0,1
4515,2022,1,Northern Border Region Office,أنشطة تقديم الخدمات للمباني وتجميل المواقع,112,15,0,0,127
4516,2022,1,Northern Border Region Office,أنشطة خدمات الأطعمة والمشروبات,941,136,3,0,1080
4519,2022,1,Northern Border Region Office,أنشطة زراعة المحاصيل والإنتاج الحيواني والصيد والخدمات المتصلة,246,6,0,0,252
4521,2022,1,Northern Border Region Office,الإقامة,31,12,1,0,44
4523,2022,1,Northern Border Region Office,الأنشطة الأخرى للتعدين واستغلال المحاجر,5,2,0,1,8
4524,2022,1,Northern Border Region Office,الأنشطة الإدارية للمكاتب ، وأنشطة الدعم للمكاتب وغير ذلك من أنشطة الدعم للأعمال,37,1,0,0,38
4525,2022,1,Northern Border Region Office,الأنشطة الإيجارية,240,9,0,0,249
4527,2022,1,Northern Border Region Office,الأنشطة الرياضية وأنشطة التسلية والترفيه,33,8,0,0,41
4528,2022,1,Northern Border Region Office,الأنشطة العقارية,28,3,0,0,31
4530,2022,1,Northern Border Region Office,الأنشطة المهنية والعلمية والتقنية الأخرى,6,0,0,0,6
4531,2022,1,Northern Border Region Office,الاتصالات,8,0,0,0,8
4532,2022,1,Northern Border Region Office,التخزين وأنشطة الدعم للنقل,27,4,1,0,32
4533,2022,1,Northern Border Region Office,التعليم,15,20,3,0,38
4535,2022,1,Northern Border Region Office,الصحة البشرية,19,22,4,0,45
4536,2022,1,Northern Border Region Office,الصناعة التحويلية الأخرى,6,1,0,0,7
4538,2022,1,Northern Border Region Office,النقل البري و النقل عبر الأنابيب,318,44,0,0,362
4539,2022,1,Northern Border Region Office,النقل الجوي,0,2,0,1,3
4542,2022,1,Northern Border Region Office,تجارة التجزئة، باستثناء المركبات ذات المحركات والدراجات النارية,1003,124,7,0,1134
4543,2022,1,Northern Border Region Office,تجارة الجملة ، باستثناء المركبات ذات المحركات والدراجات النارية,233,32,1,0,266
4544,2022,1,Northern Border Region Office,تجارة الجملة والتجزئة ، وإصلاح المركبات ذات المحركات والدراجات النارية,494,66,1,0,561
4545,2022,1,Northern Border Region Office,تجميع المياه ومعالجتها وتوصيلها,13,4,0,0,17
4546,2022,1,Northern Border Region Office,تشييد المباني,1303,220,19,4,1546
4548,2022,1,Northern Border Region Office,توصيل الكهرباء والغاز والبخار وتكييف الهواء,4,1,0,0,5
4550,2022,1,Northern Border Region Office,صناعة المركبات ذات المحركات والمركبات المقطورة ونصف المقطورة,9,1,0,0,10
4552,2022,1,Northern Border Region Office,صنع الأثاث,56,6,0,0,62
4553,2022,1,Northern Border Region Office,صنع الحواسيب والمنتجات الإلكترونية والبصرية,13,3,0,0,16
4554,2022,1,Northern Border Region Office,صُنع الخشب ومنتجات الخشب والفلين ، باستثناء الأثاث ، صُنع أصناف من القش ومواد الضفر,50,5,0,0,55
4556,2022,1,Northern Border Region Office,صُنع المشروبات,4,3,0,0,7
4557,2022,1,Northern Border Region Office,صنع المعدات الكهربائية,43,5,0,0,48
4558,2022,1,Northern Border Region Office,صُنع الملبوسات,230,10,0,0,240
4559,2022,1,Northern Border Region Office,صُنع المنتجات الجلدية والمنتجات ذات الصلة,5,3,0,0,8
4560,2022,1,Northern Border Region Office,صنع المنتجات الصيدلانية الأساسية والمستحضرات الصيدلانية,1,1,0,0,2
4561,2022,1,Northern Border Region Office,صُنع المنتجات الغذائية,128,31,0,0,159
4562,2022,1,Northern Border Region Office,صُنع المنسوجات,21,2,0,0,23
4563,2022,1,Northern Border Region Office,صُنع المواد الكيميائية والمنتجات الكيميائية,14,0,0,0,14
4564,2022,1,Northern Border Region Office,صُنع الورق ومنتجات الورق,1,2,0,0,3
4567,2022,1,Northern Border Region Office,صنع منتجات المعادن اللافلزية الأخرى,45,19,0,1,65
4568,2022,1,Northern Border Region Office,صنع منتجات المعادن المشكلة ( باستثناء الآلات والمعدات ),68,5,0,0,73
4569,2022,1,Northern Border Region Office,صيد الأسماك وتربية المائيات,10,0,0,0,10
4570,2022,1,Northern Border Region Office,وكالات السفر ومشغّلو الجولات السياحية وخدمات الحجز والأنشطة المتصلة بها,4,2,0,0,6
4571,2022,1,Riyadh Region Office,أبحاث الإعلان والسوق,597,140,1,0,738
4572,2022,1,Riyadh Region Office,إصلاح أجهزة الحاسوب والسلع الشخصية والمنزلية,956,180,28,6,1170
4573,2022,1,Riyadh Region Office,إصلاح وتركيب الآلات والمعدات,619,116,10,5,750
4574,2022,1,Riyadh Region Office,أنشطة أنتاج الأفلام والبرامج التلفزيونية والتسجيلات الصوتية و نشرالموسيقى,208,85,5,3,301
4575,2022,1,Riyadh Region Office,أنشطة الأمن والتحقيقات,115,43,20,10,188
4576,2022,1,Riyadh Region Office,أنشطة الاستخدام,454,107,19,27,607
4577,2022,1,Riyadh Region Office,أنشطة الاسر المعيشية التي تستخدم أفراداً للعمل المنزلي,17,1,0,0,18
4578,2022,1,Riyadh Region Office,أنشطة البرمجة الحاسوبية والخبرة الاستشارية وما يتصل بها من أنشطة,879,416,54,8,1357
4579,2022,1,Riyadh Region Office,أنشطة البرمجة والإذاعة,13,2,0,0,15
4580,2022,1,Riyadh Region Office,أنشطة البريد ونقل الرسائل والطرود بواسطة مندوبين,146,38,6,0,190
4581,2022,1,Riyadh Region Office,أنشطة التشييد المتخصصة,10597,3230,328,50,14205
4582,2022,1,Riyadh Region Office,أنشطة الخدمات الشخصية الأخرى,6452,1473,117,48,8090
4583,2022,1,Riyadh Region Office,أنشطة الخدمات المالية ، فيما عدا تمويل التأمين وصناديق المعاشات,267,123,21,14,425
4584,2022,1,Riyadh Region Office,أنشطة العمل الاجتماعي، دون إقامة، لكبار السن وذوي الإعاقة,193,165,27,2,387
4585,2022,1,Riyadh Region Office,أنشطة المعالجة وخدمات إدارة النفايات الأخرى,6,2,1,0,9
4586,2022,1,Riyadh Region Office,أنشطة المعمارية والهندسية ، والاختبارات الفنية والتحليل,716,429,97,23,1265
4587,2022,1,Riyadh Region Office,أنشطة المكاتب الرئيسية ، وألأنشطة الاستشارية في مجال الإدارة,923,322,36,7,1288
4588,2022,1,Riyadh Region Office,أنشطة المكتبات ودور المحفوظات، والمتاحف والأنشطة الثقافية الأخرى,94,39,2,0,135
4590,2022,1,Riyadh Region Office,أنشطة المنظمات ذات العضوية,206,49,4,0,259
4591,2022,1,Riyadh Region Office,أنشطة النشر,206,69,4,1,280
4592,2022,1,Riyadh Region Office,أنشطة تقديم الخدمات للمباني وتجميل المواقع,5732,3039,580,127,9478
4593,2022,1,Riyadh Region Office,أنشطة جمع النفايات ومعالجتها وتصريفها ، واسترجاع المواد,42,10,5,6,63
4594,2022,1,Riyadh Region Office,أنشطة خدمات الأطعمة والمشروبات,10853,3612,415,76,14956
4596,2022,1,Riyadh Region Office,أنشطة خدمات دعم التعدين,80,36,5,3,124
4597,2022,1,Riyadh Region Office,أنشطة زراعة المحاصيل والإنتاج الحيواني والصيد والخدمات المتصلة,3314,312,82,21,3729
4598,2022,1,Riyadh Region Office,استخراج النفط الخام والغاز الطبيعي,7,0,0,0,7
4599,2022,1,Riyadh Region Office,الإدارة العامة والدفاع ؛ والضمان الاجتماعي الإلزامي,333,207,44,15,599
4600,2022,1,Riyadh Region Office,الإقامة,647,340,74,10,1071
4601,2022,1,Riyadh Region Office,الأنشطة الإبداعية والفنون وأنشطة الترفيه,114,19,3,1,137
4602,2022,1,Riyadh Region Office,الأنشطة الأخرى للتعدين واستغلال المحاجر,140,65,13,4,222
4603,2022,1,Riyadh Region Office,الأنشطة الإدارية للمكاتب ، وأنشطة الدعم للمكاتب وغير ذلك من أنشطة الدعم للأعمال,915,145,16,4,1080
4604,2022,1,Riyadh Region Office,الأنشطة الإيجارية,55806,1085,33,3,56927
4605,2022,1,Riyadh Region Office,الأنشطة البيطرية,55,47,6,0,108
4606,2022,1,Riyadh Region Office,الأنشطة الرياضية وأنشطة التسلية والترفيه,533,178,21,5,737
4607,2022,1,Riyadh Region Office,الأنشطة العقارية,1209,449,61,8,1727
4608,2022,1,Riyadh Region Office,الأنشطة القانونية وأنشطة المحاسبة,570,226,14,2,812
4609,2022,1,Riyadh Region Office,الأنشطة المساعدة لأنشطة الخدمات المالية وأنشطة التأمين,85,75,14,1,175
4610,2022,1,Riyadh Region Office,الأنشطة المهنية والعلمية والتقنية الأخرى,422,63,3,0,488
4612,2022,1,Riyadh Region Office,الاتصالات,376,162,25,13,576
4613,2022,1,Riyadh Region Office,البحث والتطوير في المجال العلمي,25,12,1,1,39
4614,2022,1,Riyadh Region Office,التخزين وأنشطة الدعم للنقل,1017,260,59,18,1354
4615,2022,1,Riyadh Region Office,التعليم,760,427,167,47,1401
4616,2022,1,Riyadh Region Office,الحراجة وقطع الأخشاب,4,5,2,0,11
4617,2022,1,Riyadh Region Office,الرعاية مع الإقامة,33,17,0,0,50
4618,2022,1,Riyadh Region Office,الصحة البشرية,522,641,197,64,1424
4619,2022,1,Riyadh Region Office,الصرف الصحي,36,16,3,2,57
4620,2022,1,Riyadh Region Office,الصناعة التحويلية الأخرى,200,99,16,4,319
4621,2022,1,Riyadh Region Office,الطباعة واستنساخ وسائط الأعلام المسجّلة,351,205,23,5,584
4622,2022,1,Riyadh Region Office,النقل البري و النقل عبر الأنابيب,10590,756,86,23,11455
4623,2022,1,Riyadh Region Office,النقل الجوي,323,71,32,13,439
4624,2022,1,Riyadh Region Office,النقل المائي,113,15,3,0,131
4625,2022,1,Riyadh Region Office,الهندسة المدنية,331,118,37,14,500
4626,2022,1,Riyadh Region Office,تجارة التجزئة، باستثناء المركبات ذات المحركات والدراجات النارية,20792,6069,747,141,27749
4627,2022,1,Riyadh Region Office,تجارة الجملة ، باستثناء المركبات ذات المحركات والدراجات النارية,11950,5351,705,177,18183
4628,2022,1,Riyadh Region Office,تجارة الجملة والتجزئة ، وإصلاح المركبات ذات المحركات والدراجات النارية,7411,1718,70,8,9207
4629,2022,1,Riyadh Region Office,تجميع المياه ومعالجتها وتوصيلها,124,34,8,0,166
4630,2022,1,Riyadh Region Office,تشييد المباني,11762,4819,1079,342,18002
4631,2022,1,Riyadh Region Office,تعدين الفحم والليغنيت,14,1,1,0,16
4632,2022,1,Riyadh Region Office,تعدين ركازات الفلزات,58,39,0,1,98
4633,2022,1,Riyadh Region Office,تمويل التأمين وإعادة التأمين وصناديق المعاشات التقاعدية باستثناء الضمان الاجتماعي الإلزامي,54,53,15,8,130
4634,2022,1,Riyadh Region Office,توصيل الكهرباء والغاز والبخار وتكييف الهواء,96,69,24,15,204
4635,2022,1,Riyadh Region Office,صناعة الآلات والمعدات غير المصنفة في موضع أخر,220,56,9,2,287
4636,2022,1,Riyadh Region Office,صناعة المركبات ذات المحركات والمركبات المقطورة ونصف المقطورة,105,54,4,1,164
4637,2022,1,Riyadh Region Office,صناعة معدات النقل الأخرى,122,44,8,2,176
4638,2022,1,Riyadh Region Office,صنع الأثاث,1005,388,39,3,1435
4639,2022,1,Riyadh Region Office,صنع الحواسيب والمنتجات الإلكترونية والبصرية,273,119,29,7,428
4640,2022,1,Riyadh Region Office,صُنع الخشب ومنتجات الخشب والفلين ، باستثناء الأثاث ، صُنع أصناف من القش ومواد الضفر,829,255,39,7,1130
4641,2022,1,Riyadh Region Office,صنع الفلزات القاعدية,519,271,69,17,876
4642,2022,1,Riyadh Region Office,صُنع المشروبات,73,38,17,5,133
4643,2022,1,Riyadh Region Office,صنع المعدات الكهربائية,252,118,28,4,402
4644,2022,1,Riyadh Region Office,صُنع الملبوسات,2346,425,23,1,2795
4645,2022,1,Riyadh Region Office,صُنع المنتجات الجلدية والمنتجات ذات الصلة,83,14,1,0,98
4646,2022,1,Riyadh Region Office,صنع المنتجات الصيدلانية الأساسية والمستحضرات الصيدلانية,52,27,7,1,87
4647,2022,1,Riyadh Region Office,صُنع المنتجات الغذائية,1448,555,82,27,2112
4648,2022,1,Riyadh Region Office,صُنع المنسوجات,220,86,12,9,327
4649,2022,1,Riyadh Region Office,صُنع المواد الكيميائية والمنتجات الكيميائية,443,237,39,2,721
4650,2022,1,Riyadh Region Office,صُنع الورق ومنتجات الورق,91,63,9,1,164
4651,2022,1,Riyadh Region Office,صنع فحم الكوك والمنتجات النفطية المكررة,34,12,1,0,47
4653,2022,1,Riyadh Region Office,صنع منتجات المطاط واللدائن,313,196,87,12,608
4654,2022,1,Riyadh Region Office,صنع منتجات المعادن اللافلزية الأخرى,1264,716,107,20,2107
4655,2022,1,Riyadh Region Office,صنع منتجات المعادن المشكلة ( باستثناء الآلات والمعدات ),1117,517,106,19,1759
4656,2022,1,Riyadh Region Office,صيد الأسماك وتربية المائيات,3363,16,1,1,3381
4657,2022,1,Riyadh Region Office,وكالات السفر ومشغّلو الجولات السياحية وخدمات الحجز والأنشطة المتصلة بها,253,104,14,5,376
4658,2022,1,Qassim Region Office,أبحاث الإعلان والسوق,40,9,0,0,49
4659,2022,1,Qassim Region Office,إصلاح أجهزة الحاسوب والسلع الشخصية والمنزلية,297,36,3,0,336
4660,2022,1,Qassim Region Office,إصلاح وتركيب الآلات والمعدات,122,11,0,0,133
4661,2022,1,Qassim Region Office,أنشطة أنتاج الأفلام والبرامج التلفزيونية والتسجيلات الصوتية و نشرالموسيقى,10,1,0,0,11
4663,2022,1,Qassim Region Office,أنشطة الاستخدام,36,12,1,0,49
4664,2022,1,Qassim Region Office,أنشطة الاسر المعيشية التي تستخدم أفراداً للعمل المنزلي,11,0,0,0,11
4665,2022,1,Qassim Region Office,أنشطة البرمجة الحاسوبية والخبرة الاستشارية وما يتصل بها من أنشطة,43,6,0,0,49
4668,2022,1,Qassim Region Office,أنشطة التشييد المتخصصة,3561,561,79,2,4203
4669,2022,1,Qassim Region Office,أنشطة الخدمات الشخصية الأخرى,1401,122,7,1,1531
4670,2022,1,Qassim Region Office,أنشطة الخدمات المالية ، فيما عدا تمويل التأمين وصناديق المعاشات,27,2,0,0,29
4671,2022,1,Qassim Region Office,أنشطة العمل الاجتماعي، دون إقامة، لكبار السن وذوي الإعاقة,57,55,3,0,115
4672,2022,1,Qassim Region Office,أنشطة المعمارية والهندسية ، والاختبارات الفنية والتحليل,222,66,9,0,297
4673,2022,1,Qassim Region Office,أنشطة المكاتب الرئيسية ، وألأنشطة الاستشارية في مجال الإدارة,56,21,1,0,78
4674,2022,1,Qassim Region Office,أنشطة المكتبات ودور المحفوظات، والمتاحف والأنشطة الثقافية الأخرى,22,14,0,0,36
4676,2022,1,Qassim Region Office,أنشطة المنظمات ذات العضوية,36,13,1,0,50
4677,2022,1,Qassim Region Office,أنشطة النشر,16,6,0,0,22
4678,2022,1,Qassim Region Office,أنشطة تقديم الخدمات للمباني وتجميل المواقع,1334,285,57,15,1691
4679,2022,1,Qassim Region Office,أنشطة جمع النفايات ومعالجتها وتصريفها ، واسترجاع المواد,4,6,0,0,10
4680,2022,1,Qassim Region Office,أنشطة خدمات الأطعمة والمشروبات,3607,883,55,3,4548
4681,2022,1,Qassim Region Office,أنشطة خدمات المعلومات,17,2,0,0,19
4682,2022,1,Qassim Region Office,أنشطة خدمات دعم التعدين,9,2,0,0,11
4683,2022,1,Qassim Region Office,أنشطة زراعة المحاصيل والإنتاج الحيواني والصيد والخدمات المتصلة,1621,91,12,5,1729
4684,2022,1,Qassim Region Office,الإدارة العامة والدفاع ؛ والضمان الاجتماعي الإلزامي,32,27,2,0,61
4685,2022,1,Qassim Region Office,الإقامة,116,54,6,1,177
4686,2022,1,Qassim Region Office,الأنشطة الإبداعية والفنون وأنشطة الترفيه,11,2,0,0,13
4687,2022,1,Qassim Region Office,الأنشطة الأخرى للتعدين واستغلال المحاجر,17,3,0,0,20
4688,2022,1,Qassim Region Office,الأنشطة الإدارية للمكاتب ، وأنشطة الدعم للمكاتب وغير ذلك من أنشطة الدعم للأعمال,97,7,3,0,107
4689,2022,1,Qassim Region Office,الأنشطة الإيجارية,1192,59,3,0,1254
4690,2022,1,Qassim Region Office,الأنشطة البيطرية,14,5,1,0,20
4691,2022,1,Qassim Region Office,الأنشطة الرياضية وأنشطة التسلية والترفيه,84,31,0,0,115
4692,2022,1,Qassim Region Office,الأنشطة العقارية,111,16,2,0,129
4693,2022,1,Qassim Region Office,الأنشطة القانونية وأنشطة المحاسبة,42,2,0,0,44
4695,2022,1,Qassim Region Office,الأنشطة المهنية والعلمية والتقنية الأخرى,25,6,0,0,31
4696,2022,1,Qassim Region Office,الاتصالات,86,19,0,0,105
4697,2022,1,Qassim Region Office,البحث والتطوير في المجال العلمي,3,0,0,0,3
4698,2022,1,Qassim Region Office,التخزين وأنشطة الدعم للنقل,127,38,4,0,169
4699,2022,1,Qassim Region Office,التعليم,62,40,18,2,122
4701,2022,1,Qassim Region Office,الرعاية مع الإقامة,9,4,0,0,13
4702,2022,1,Qassim Region Office,الصحة البشرية,47,89,26,4,166
4704,2022,1,Qassim Region Office,الصناعة التحويلية الأخرى,32,7,0,0,39
4705,2022,1,Qassim Region Office,الطباعة واستنساخ وسائط الأعلام المسجّلة,58,26,2,0,86
4706,2022,1,Qassim Region Office,النقل البري و النقل عبر الأنابيب,953,167,17,3,1140
4707,2022,1,Qassim Region Office,النقل الجوي,10,10,0,2,22
4709,2022,1,Qassim Region Office,الهندسة المدنية,53,14,5,0,72
4710,2022,1,Qassim Region Office,تجارة التجزئة، باستثناء المركبات ذات المحركات والدراجات النارية,3704,685,48,7,4444
4711,2022,1,Qassim Region Office,تجارة الجملة ، باستثناء المركبات ذات المحركات والدراجات النارية,1752,575,52,4,2383
4712,2022,1,Qassim Region Office,تجارة الجملة والتجزئة ، وإصلاح المركبات ذات المحركات والدراجات النارية,2394,405,15,2,2816
4713,2022,1,Qassim Region Office,تجميع المياه ومعالجتها وتوصيلها,34,8,0,0,42
4714,2022,1,Qassim Region Office,تشييد المباني,7718,1777,241,41,9777
4716,2022,1,Qassim Region Office,تعدين ركازات الفلزات,37,12,1,0,50
4718,2022,1,Qassim Region Office,توصيل الكهرباء والغاز والبخار وتكييف الهواء,12,4,0,0,16
4719,2022,1,Qassim Region Office,صناعة الآلات والمعدات غير المصنفة في موضع أخر,41,7,2,0,50
4720,2022,1,Qassim Region Office,صناعة المركبات ذات المحركات والمركبات المقطورة ونصف المقطورة,28,7,1,0,36
4721,2022,1,Qassim Region Office,صناعة معدات النقل الأخرى,21,3,0,0,24
4722,2022,1,Qassim Region Office,صنع الأثاث,211,58,7,0,276
4723,2022,1,Qassim Region Office,صنع الحواسيب والمنتجات الإلكترونية والبصرية,49,11,1,0,61
4724,2022,1,Qassim Region Office,صُنع الخشب ومنتجات الخشب والفلين ، باستثناء الأثاث ، صُنع أصناف من القش ومواد الضفر,264,47,2,1,314
4725,2022,1,Qassim Region Office,صنع الفلزات القاعدية,233,40,2,0,275
4726,2022,1,Qassim Region Office,صُنع المشروبات,16,8,4,1,29
4728,2022,1,Qassim Region Office,صُنع الملبوسات,590,72,4,1,667
4730,2022,1,Qassim Region Office,صنع المنتجات الصيدلانية الأساسية والمستحضرات الصيدلانية,5,4,1,0,10
4731,2022,1,Qassim Region Office,صُنع المنتجات الغذائية,441,99,36,6,582
4732,2022,1,Qassim Region Office,صُنع المنسوجات,91,19,1,0,111
4733,2022,1,Qassim Region Office,صُنع المواد الكيميائية والمنتجات الكيميائية,63,15,4,1,83
4734,2022,1,Qassim Region Office,صُنع الورق ومنتجات الورق,8,10,4,0,22
4737,2022,1,Qassim Region Office,صنع منتجات المطاط واللدائن,27,17,11,1,56
4738,2022,1,Qassim Region Office,صنع منتجات المعادن اللافلزية الأخرى,194,71,21,3,289
4739,2022,1,Qassim Region Office,صنع منتجات المعادن المشكلة ( باستثناء الآلات والمعدات ),711,108,7,3,829
4740,2022,1,Qassim Region Office,صيد الأسماك وتربية المائيات,84,2,0,0,86
4741,2022,1,Qassim Region Office,وكالات السفر ومشغّلو الجولات السياحية وخدمات الحجز والأنشطة المتصلة بها,46,15,0,0,61
4742,2022,1,Al-Madinah Al-Munawwarah Region Office,أبحاث الإعلان والسوق,60,7,0,0,67
4743,2022,1,Al-Madinah Al-Munawwarah Region Office,إصلاح أجهزة الحاسوب والسلع الشخصية والمنزلية,173,11,0,0,184
4744,2022,1,Al-Madinah Al-Munawwarah Region Office,إصلاح وتركيب الآلات والمعدات,91,10,0,0,101
4746,2022,1,Al-Madinah Al-Munawwarah Region Office,أنشطة الأمن والتحقيقات,9,2,1,0,12
4747,2022,1,Al-Madinah Al-Munawwarah Region Office,أنشطة الاستخدام,40,11,0,0,51
4749,2022,1,Al-Madinah Al-Munawwarah Region Office,أنشطة البرمجة الحاسوبية والخبرة الاستشارية وما يتصل بها من أنشطة,54,7,0,0,61
4751,2022,1,Al-Madinah Al-Munawwarah Region Office,أنشطة البريد ونقل الرسائل والطرود بواسطة مندوبين,8,1,0,0,9
4752,2022,1,Al-Madinah Al-Munawwarah Region Office,أنشطة التشييد المتخصصة,1827,349,11,0,2187
4753,2022,1,Al-Madinah Al-Munawwarah Region Office,أنشطة الخدمات الشخصية الأخرى,1573,142,2,0,1717
4755,2022,1,Al-Madinah Al-Munawwarah Region Office,أنشطة العمل الاجتماعي، دون إقامة، لكبار السن وذوي الإعاقة,74,35,10,0,119
4756,2022,1,Al-Madinah Al-Munawwarah Region Office,أنشطة المعمارية والهندسية ، والاختبارات الفنية والتحليل,94,57,3,1,155
4757,2022,1,Al-Madinah Al-Munawwarah Region Office,أنشطة المكاتب الرئيسية ، وألأنشطة الاستشارية في مجال الإدارة,62,9,1,0,72
4758,2022,1,Al-Madinah Al-Munawwarah Region Office,أنشطة المكتبات ودور المحفوظات، والمتاحف والأنشطة الثقافية الأخرى,64,18,0,0,82
4759,2022,1,Al-Madinah Al-Munawwarah Region Office,أنشطة المنظمات ذات العضوية,15,4,3,0,22
4760,2022,1,Al-Madinah Al-Munawwarah Region Office,أنشطة النشر,36,13,1,0,50
4761,2022,1,Al-Madinah Al-Munawwarah Region Office,أنشطة تقديم الخدمات للمباني وتجميل المواقع,862,219,17,4,1102
4762,2022,1,Al-Madinah Al-Munawwarah Region Office,أنشطة جمع النفايات ومعالجتها وتصريفها ، واسترجاع المواد,8,1,0,0,9
4763,2022,1,Al-Madinah Al-Munawwarah Region Office,أنشطة خدمات الأطعمة والمشروبات,3639,802,39,1,4481
4764,2022,1,Al-Madinah Al-Munawwarah Region Office,أنشطة خدمات المعلومات,16,3,0,0,19
4766,2022,1,Al-Madinah Al-Munawwarah Region Office,أنشطة زراعة المحاصيل والإنتاج الحيواني والصيد والخدمات المتصلة,784,57,3,0,844
4767,2022,1,Al-Madinah Al-Munawwarah Region Office,الإدارة العامة والدفاع ؛ والضمان الاجتماعي الإلزامي,49,23,2,0,74
4768,2022,1,Al-Madinah Al-Munawwarah Region Office,الإقامة,255,120,31,5,411
4769,2022,1,Al-Madinah Al-Munawwarah Region Office,الأنشطة الإبداعية والفنون وأنشطة الترفيه,4,0,0,0,4
4770,2022,1,Al-Madinah Al-Munawwarah Region Office,الأنشطة الأخرى للتعدين واستغلال المحاجر,27,5,0,0,32
4771,2022,1,Al-Madinah Al-Munawwarah Region Office,الأنشطة الإدارية للمكاتب ، وأنشطة الدعم للمكاتب وغير ذلك من أنشطة الدعم للأعمال,117,11,0,0,128
4772,2022,1,Al-Madinah Al-Munawwarah Region Office,الأنشطة الإيجارية,749,46,3,0,798
4773,2022,1,Al-Madinah Al-Munawwarah Region Office,الأنشطة البيطرية,16,4,0,0,20
4774,2022,1,Al-Madinah Al-Munawwarah Region Office,الأنشطة الرياضية وأنشطة التسلية والترفيه,69,24,1,0,94
4775,2022,1,Al-Madinah Al-Munawwarah Region Office,الأنشطة العقارية,163,21,4,0,188
4776,2022,1,Al-Madinah Al-Munawwarah Region Office,الأنشطة القانونية وأنشطة المحاسبة,49,11,0,0,60
4777,2022,1,Al-Madinah Al-Munawwarah Region Office,الأنشطة المساعدة لأنشطة الخدمات المالية وأنشطة التأمين,12,3,0,0,15
4778,2022,1,Al-Madinah Al-Munawwarah Region Office,الأنشطة المهنية والعلمية والتقنية الأخرى,51,12,1,0,64
4782,2022,1,Al-Madinah Al-Munawwarah Region Office,التخزين وأنشطة الدعم للنقل,219,37,1,2,259
4783,2022,1,Al-Madinah Al-Munawwarah Region Office,التعليم,81,63,24,1,169
4785,2022,1,Al-Madinah Al-Munawwarah Region Office,الرعاية مع الإقامة,12,5,1,0,18
4786,2022,1,Al-Madinah Al-Munawwarah Region Office,الصحة البشرية,44,100,23,5,172
4788,2022,1,Al-Madinah Al-Munawwarah Region Office,الصناعة التحويلية الأخرى,30,14,2,0,46
4789,2022,1,Al-Madinah Al-Munawwarah Region Office,الطباعة واستنساخ وسائط الأعلام المسجّلة,55,14,0,0,69
4790,2022,1,Al-Madinah Al-Munawwarah Region Office,النقل البري و النقل عبر الأنابيب,697,65,1,0,763
4792,2022,1,Al-Madinah Al-Munawwarah Region Office,النقل المائي,11,0,0,0,11
4793,2022,1,Al-Madinah Al-Munawwarah Region Office,الهندسة المدنية,46,5,1,0,52
4794,2022,1,Al-Madinah Al-Munawwarah Region Office,تجارة التجزئة، باستثناء المركبات ذات المحركات والدراجات النارية,5371,973,50,4,6398
4795,2022,1,Al-Madinah Al-Munawwarah Region Office,تجارة الجملة ، باستثناء المركبات ذات المحركات والدراجات النارية,1685,399,29,2,2115
4796,2022,1,Al-Madinah Al-Munawwarah Region Office,تجارة الجملة والتجزئة ، وإصلاح المركبات ذات المحركات والدراجات النارية,1716,225,5,0,1946
4797,2022,1,Al-Madinah Al-Munawwarah Region Office,تجميع المياه ومعالجتها وتوصيلها,31,6,1,0,38
4798,2022,1,Al-Madinah Al-Munawwarah Region Office,تشييد المباني,3272,864,59,20,4215
4799,2022,1,Al-Madinah Al-Munawwarah Region Office,تعدين ركازات الفلزات,20,5,0,0,25
4800,2022,1,Al-Madinah Al-Munawwarah Region Office,تمويل التأمين وإعادة التأمين وصناديق المعاشات التقاعدية باستثناء الضمان الاجتماعي الإلزامي,3,0,0,0,3
4801,2022,1,Al-Madinah Al-Munawwarah Region Office,توصيل الكهرباء والغاز والبخار وتكييف الهواء,18,9,2,0,29
4804,2022,1,Al-Madinah Al-Munawwarah Region Office,صناعة معدات النقل الأخرى,11,5,0,0,16
4805,2022,1,Al-Madinah Al-Munawwarah Region Office,صنع الأثاث,199,37,1,0,237
4806,2022,1,Al-Madinah Al-Munawwarah Region Office,صنع الحواسيب والمنتجات الإلكترونية والبصرية,43,10,0,0,53
4807,2022,1,Al-Madinah Al-Munawwarah Region Office,صُنع الخشب ومنتجات الخشب والفلين ، باستثناء الأثاث ، صُنع أصناف من القش ومواد الضفر,115,17,0,0,132
4808,2022,1,Al-Madinah Al-Munawwarah Region Office,صنع الفلزات القاعدية,89,18,4,1,112
4809,2022,1,Al-Madinah Al-Munawwarah Region Office,صُنع المشروبات,18,14,6,1,39
4810,2022,1,Al-Madinah Al-Munawwarah Region Office,صنع المعدات الكهربائية,75,13,0,0,88
4811,2022,1,Al-Madinah Al-Munawwarah Region Office,صُنع الملبوسات,700,71,2,0,773
4814,2022,1,Al-Madinah Al-Munawwarah Region Office,صُنع المنتجات الغذائية,489,112,6,2,609
4815,2022,1,Al-Madinah Al-Munawwarah Region Office,صُنع المنسوجات,85,19,2,0,106
4816,2022,1,Al-Madinah Al-Munawwarah Region Office,صُنع المواد الكيميائية والمنتجات الكيميائية,41,13,2,0,56
4817,2022,1,Al-Madinah Al-Munawwarah Region Office,صُنع الورق ومنتجات الورق,3,6,1,0,10
4818,2022,1,Al-Madinah Al-Munawwarah Region Office,صنع فحم الكوك والمنتجات النفطية المكررة,2,1,0,0,3
4820,2022,1,Al-Madinah Al-Munawwarah Region Office,صنع منتجات المطاط واللدائن,32,17,4,0,53
4821,2022,1,Al-Madinah Al-Munawwarah Region Office,صنع منتجات المعادن اللافلزية الأخرى,134,54,12,0,200
4822,2022,1,Al-Madinah Al-Munawwarah Region Office,صنع منتجات المعادن المشكلة ( باستثناء الآلات والمعدات ),320,48,5,0,373
4823,2022,1,Al-Madinah Al-Munawwarah Region Office,صيد الأسماك وتربية المائيات,58,2,0,0,60
4824,2022,1,Al-Madinah Al-Munawwarah Region Office,وكالات السفر ومشغّلو الجولات السياحية وخدمات الحجز والأنشطة المتصلة بها,68,15,1,0,84
4825,2022,1,Tabuk Region Office,أبحاث الإعلان والسوق,20,0,1,0,21
4826,2022,1,Tabuk Region Office,إصلاح أجهزة الحاسوب والسلع الشخصية والمنزلية,186,28,0,0,214
4827,2022,1,Tabuk Region Office,إصلاح وتركيب الآلات والمعدات,67,2,0,0,69
4828,2022,1,Tabuk Region Office,أنشطة أنتاج الأفلام والبرامج التلفزيونية والتسجيلات الصوتية و نشرالموسيقى,6,0,0,0,6
4829,2022,1,Tabuk Region Office,أنشطة الأمن والتحقيقات,3,0,0,0,3
4830,2022,1,Tabuk Region Office,أنشطة الاستخدام,21,2,0,1,24
4832,2022,1,Tabuk Region Office,أنشطة البرمجة الحاسوبية والخبرة الاستشارية وما يتصل بها من أنشطة,11,1,0,0,12
4833,2022,1,Tabuk Region Office,أنشطة البرمجة والإذاعة,0,1,0,0,1
4834,2022,1,Tabuk Region Office,أنشطة البريد ونقل الرسائل والطرود بواسطة مندوبين,5,0,0,0,5
4835,2022,1,Tabuk Region Office,أنشطة التشييد المتخصصة,1207,133,3,0,1343
4836,2022,1,Tabuk Region Office,أنشطة الخدمات الشخصية الأخرى,1030,72,1,1,1104
4837,2022,1,Tabuk Region Office,أنشطة الخدمات المالية ، فيما عدا تمويل التأمين وصناديق المعاشات,16,4,0,0,20
4838,2022,1,Tabuk Region Office,أنشطة العمل الاجتماعي، دون إقامة، لكبار السن وذوي الإعاقة,29,12,1,0,42
4839,2022,1,Tabuk Region Office,أنشطة المعمارية والهندسية ، والاختبارات الفنية والتحليل,66,24,1,0,91
4841,2022,1,Tabuk Region Office,أنشطة المكتبات ودور المحفوظات، والمتاحف والأنشطة الثقافية الأخرى,22,7,0,0,29
4842,2022,1,Tabuk Region Office,أنشطة المنظمات ذات العضوية,8,1,0,0,9
4843,2022,1,Tabuk Region Office,أنشطة النشر,8,0,0,0,8
4844,2022,1,Tabuk Region Office,أنشطة تقديم الخدمات للمباني وتجميل المواقع,368,55,6,1,430
4846,2022,1,Tabuk Region Office,أنشطة خدمات الأطعمة والمشروبات,1990,385,24,0,2399
4847,2022,1,Tabuk Region Office,أنشطة خدمات المعلومات,8,2,0,0,10
4849,2022,1,Tabuk Region Office,أنشطة زراعة المحاصيل والإنتاج الحيواني والصيد والخدمات المتصلة,664,35,2,2,703
4850,2022,1,Tabuk Region Office,الإدارة العامة والدفاع ؛ والضمان الاجتماعي الإلزامي,10,8,1,0,19
4851,2022,1,Tabuk Region Office,الإقامة,94,35,3,0,132
4852,2022,1,Tabuk Region Office,الأنشطة الأخرى للتعدين واستغلال المحاجر,7,2,0,0,9
4853,2022,1,Tabuk Region Office,الأنشطة الإدارية للمكاتب ، وأنشطة الدعم للمكاتب وغير ذلك من أنشطة الدعم للأعمال,55,3,1,0,59
4854,2022,1,Tabuk Region Office,الأنشطة الإيجارية,432,6,0,0,438
4855,2022,1,Tabuk Region Office,الأنشطة البيطرية,10,0,0,0,10
4856,2022,1,Tabuk Region Office,الأنشطة الرياضية وأنشطة التسلية والترفيه,60,10,0,0,70
4857,2022,1,Tabuk Region Office,الأنشطة العقارية,56,8,0,0,64
4858,2022,1,Tabuk Region Office,الأنشطة القانونية وأنشطة المحاسبة,11,0,0,0,11
4859,2022,1,Tabuk Region Office,الأنشطة المساعدة لأنشطة الخدمات المالية وأنشطة التأمين,2,0,0,0,2
4860,2022,1,Tabuk Region Office,الأنشطة المهنية والعلمية والتقنية الأخرى,27,1,0,0,28
4861,2022,1,Tabuk Region Office,الاتصالات,18,0,0,0,18
4863,2022,1,Tabuk Region Office,التخزين وأنشطة الدعم للنقل,73,9,0,0,82
4864,2022,1,Tabuk Region Office,التعليم,34,39,17,2,92
4865,2022,1,Tabuk Region Office,الرعاية مع الإقامة,8,0,1,0,9
4866,2022,1,Tabuk Region Office,الصحة البشرية,26,48,10,1,85
4868,2022,1,Tabuk Region Office,الصناعة التحويلية الأخرى,12,1,0,0,13
4869,2022,1,Tabuk Region Office,الطباعة واستنساخ وسائط الأعلام المسجّلة,30,7,0,0,37
4870,2022,1,Tabuk Region Office,النقل البري و النقل عبر الأنابيب,497,69,5,0,571
4871,2022,1,Tabuk Region Office,النقل الجوي,9,3,3,0,15
4872,2022,1,Tabuk Region Office,النقل المائي,12,1,0,0,13
4873,2022,1,Tabuk Region Office,الهندسة المدنية,15,2,0,0,17
4874,2022,1,Tabuk Region Office,تجارة التجزئة، باستثناء المركبات ذات المحركات والدراجات النارية,2231,291,14,1,2537
4875,2022,1,Tabuk Region Office,تجارة الجملة ، باستثناء المركبات ذات المحركات والدراجات النارية,609,108,6,0,723
4876,2022,1,Tabuk Region Office,تجارة الجملة والتجزئة ، وإصلاح المركبات ذات المحركات والدراجات النارية,1056,131,1,0,1188
4877,2022,1,Tabuk Region Office,تجميع المياه ومعالجتها وتوصيلها,39,3,0,0,42
4878,2022,1,Tabuk Region Office,تشييد المباني,2312,359,25,5,2701
4882,2022,1,Tabuk Region Office,صناعة الآلات والمعدات غير المصنفة في موضع أخر,18,2,0,0,20
4883,2022,1,Tabuk Region Office,صناعة المركبات ذات المحركات والمركبات المقطورة ونصف المقطورة,33,1,0,0,34
4884,2022,1,Tabuk Region Office,صناعة معدات النقل الأخرى,3,1,0,0,4
4885,2022,1,Tabuk Region Office,صنع الأثاث,165,19,0,0,184
4886,2022,1,Tabuk Region Office,صنع الحواسيب والمنتجات الإلكترونية والبصرية,38,4,1,0,43
4887,2022,1,Tabuk Region Office,صُنع الخشب ومنتجات الخشب والفلين ، باستثناء الأثاث ، صُنع أصناف من القش ومواد الضفر,92,23,0,0,115
4888,2022,1,Tabuk Region Office,صنع الفلزات القاعدية,24,3,1,0,28
4889,2022,1,Tabuk Region Office,صُنع المشروبات,26,7,1,0,34
4890,2022,1,Tabuk Region Office,صنع المعدات الكهربائية,44,4,0,0,48
4891,2022,1,Tabuk Region Office,صُنع الملبوسات,648,34,0,0,682
4894,2022,1,Tabuk Region Office,صُنع المنتجات الغذائية,217,43,3,2,265
4895,2022,1,Tabuk Region Office,صُنع المنسوجات,44,12,0,0,56
4896,2022,1,Tabuk Region Office,صُنع المواد الكيميائية والمنتجات الكيميائية,22,8,0,0,30
4898,2022,1,Tabuk Region Office,صُنع منتجات التبغ,5,0,0,0,5
4900,2022,1,Tabuk Region Office,صنع منتجات المعادن اللافلزية الأخرى,51,25,1,0,77
4901,2022,1,Tabuk Region Office,صنع منتجات المعادن المشكلة ( باستثناء الآلات والمعدات ),173,36,1,1,211
4902,2022,1,Tabuk Region Office,صيد الأسماك وتربية المائيات,44,9,0,0,53
4903,2022,1,Tabuk Region Office,وكالات السفر ومشغّلو الجولات السياحية وخدمات الحجز والأنشطة المتصلة بها,21,4,0,0,25
4904,2022,1,Jazan Region Office,أبحاث الإعلان والسوق,32,5,0,0,37
4905,2022,1,Jazan Region Office,إصلاح أجهزة الحاسوب والسلع الشخصية والمنزلية,190,9,0,0,199
4906,2022,1,Jazan Region Office,إصلاح وتركيب الآلات والمعدات,184,6,0,0,190
4907,2022,1,Jazan Region Office,أنشطة أنتاج الأفلام والبرامج التلفزيونية والتسجيلات الصوتية و نشرالموسيقى,11,0,0,0,11
4911,2022,1,Jazan Region Office,أنشطة البرمجة الحاسوبية والخبرة الاستشارية وما يتصل بها من أنشطة,14,0,0,0,14
4913,2022,1,Jazan Region Office,أنشطة التشييد المتخصصة,1451,150,6,0,1607
4914,2022,1,Jazan Region Office,أنشطة الخدمات الشخصية الأخرى,1369,77,0,0,1446
4915,2022,1,Jazan Region Office,أنشطة الخدمات المالية ، فيما عدا تمويل التأمين وصناديق المعاشات,26,6,0,0,32
4916,2022,1,Jazan Region Office,أنشطة العمل الاجتماعي، دون إقامة، لكبار السن وذوي الإعاقة,32,29,2,0,63
4918,2022,1,Jazan Region Office,أنشطة المعمارية والهندسية ، والاختبارات الفنية والتحليل,72,22,2,0,96
4919,2022,1,Jazan Region Office,أنشطة المكاتب الرئيسية ، وألأنشطة الاستشارية في مجال الإدارة,28,4,0,0,32
4921,2022,1,Jazan Region Office,أنشطة المنظمات ذات العضوية,32,5,0,0,37
4922,2022,1,Jazan Region Office,أنشطة النشر,19,2,0,0,21
4923,2022,1,Jazan Region Office,أنشطة تقديم الخدمات للمباني وتجميل المواقع,412,77,2,0,491
4925,2022,1,Jazan Region Office,أنشطة خدمات الأطعمة والمشروبات,3588,558,18,0,4164
4926,2022,1,Jazan Region Office,أنشطة خدمات المعلومات,14,2,0,0,16
4927,2022,1,Jazan Region Office,أنشطة خدمات دعم التعدين,10,4,0,0,14
4928,2022,1,Jazan Region Office,أنشطة زراعة المحاصيل والإنتاج الحيواني والصيد والخدمات المتصلة,583,31,1,0,615
4930,2022,1,Jazan Region Office,الإقامة,219,48,5,0,272
4932,2022,1,Jazan Region Office,الأنشطة الأخرى للتعدين واستغلال المحاجر,13,5,0,0,18
4933,2022,1,Jazan Region Office,الأنشطة الإدارية للمكاتب ، وأنشطة الدعم للمكاتب وغير ذلك من أنشطة الدعم للأعمال,48,2,0,0,50
4934,2022,1,Jazan Region Office,الأنشطة الإيجارية,1250,27,1,0,1278
4935,2022,1,Jazan Region Office,الأنشطة البيطرية,7,5,0,0,12
4936,2022,1,Jazan Region Office,الأنشطة الرياضية وأنشطة التسلية والترفيه,50,8,1,0,59
4937,2022,1,Jazan Region Office,الأنشطة العقارية,78,11,0,2,91
4940,2022,1,Jazan Region Office,الأنشطة المهنية والعلمية والتقنية الأخرى,29,2,0,0,31
4942,2022,1,Jazan Region Office,الاتصالات,21,3,0,0,24
4944,2022,1,Jazan Region Office,التخزين وأنشطة الدعم للنقل,83,16,3,1,103
4945,2022,1,Jazan Region Office,التعليم,45,33,4,0,82
4947,2022,1,Jazan Region Office,الرعاية مع الإقامة,9,3,0,0,12
4948,2022,1,Jazan Region Office,الصحة البشرية,46,71,12,2,131
4951,2022,1,Jazan Region Office,الطباعة واستنساخ وسائط الأعلام المسجّلة,16,4,0,0,20
4952,2022,1,Jazan Region Office,النقل البري و النقل عبر الأنابيب,368,33,2,0,403
4955,2022,1,Jazan Region Office,الهندسة المدنية,24,3,2,0,29
4956,2022,1,Jazan Region Office,تجارة التجزئة، باستثناء المركبات ذات المحركات والدراجات النارية,4217,538,18,1,4774
4957,2022,1,Jazan Region Office,تجارة الجملة ، باستثناء المركبات ذات المحركات والدراجات النارية,1447,297,16,0,1760
4958,2022,1,Jazan Region Office,تجارة الجملة والتجزئة ، وإصلاح المركبات ذات المحركات والدراجات النارية,1622,163,5,1,1791
4959,2022,1,Jazan Region Office,تجميع المياه ومعالجتها وتوصيلها,56,6,1,1,64
4960,2022,1,Jazan Region Office,تشييد المباني,2842,428,33,1,3304
4961,2022,1,Jazan Region Office,تعدين ركازات الفلزات,24,6,0,0,30
4963,2022,1,Jazan Region Office,توصيل الكهرباء والغاز والبخار وتكييف الهواء,14,8,1,0,23
4964,2022,1,Jazan Region Office,صناعة الآلات والمعدات غير المصنفة في موضع أخر,39,2,0,0,41
4965,2022,1,Jazan Region Office,صناعة المركبات ذات المحركات والمركبات المقطورة ونصف المقطورة,84,4,0,0,88
4967,2022,1,Jazan Region Office,صنع الأثاث,216,12,0,0,228
4968,2022,1,Jazan Region Office,صنع الحواسيب والمنتجات الإلكترونية والبصرية,40,8,0,0,48
4969,2022,1,Jazan Region Office,صُنع الخشب ومنتجات الخشب والفلين ، باستثناء الأثاث ، صُنع أصناف من القش ومواد الضفر,170,15,0,0,185
4970,2022,1,Jazan Region Office,صنع الفلزات القاعدية,61,12,1,2,76
4971,2022,1,Jazan Region Office,صُنع المشروبات,17,5,3,1,26
4972,2022,1,Jazan Region Office,صنع المعدات الكهربائية,74,5,0,0,79
4973,2022,1,Jazan Region Office,صُنع الملبوسات,442,40,0,0,482
4974,2022,1,Jazan Region Office,صُنع المنتجات الجلدية والمنتجات ذات الصلة,54,1,0,0,55
4976,2022,1,Jazan Region Office,صُنع المنتجات الغذائية,303,73,5,0,381
4978,2022,1,Jazan Region Office,صُنع المواد الكيميائية والمنتجات الكيميائية,38,9,2,0,49
4980,2022,1,Jazan Region Office,صنع فحم الكوك والمنتجات النفطية المكررة,2,0,0,0,2
4982,2022,1,Jazan Region Office,صنع منتجات المطاط واللدائن,11,8,1,0,20
4983,2022,1,Jazan Region Office,صنع منتجات المعادن اللافلزية الأخرى,132,44,14,1,191
4984,2022,1,Jazan Region Office,صنع منتجات المعادن المشكلة ( باستثناء الآلات والمعدات ),501,17,1,0,519
4985,2022,1,Jazan Region Office,صيد الأسماك وتربية المائيات,156,65,4,0,225
4986,2022,1,Jazan Region Office,وكالات السفر ومشغّلو الجولات السياحية وخدمات الحجز والأنشطة المتصلة بها,22,3,0,0,25
4987,2022,1,Hail Region Office,أبحاث الإعلان والسوق,27,5,0,0,32
4988,2022,1,Hail Region Office,إصلاح أجهزة الحاسوب والسلع الشخصية والمنزلية,152,13,0,0,165
4989,2022,1,Hail Region Office,إصلاح وتركيب الآلات والمعدات,34,2,0,0,36
4990,2022,1,Hail Region Office,أنشطة أنتاج الأفلام والبرامج التلفزيونية والتسجيلات الصوتية و نشرالموسيقى,7,0,0,0,7
4991,2022,1,Hail Region Office,أنشطة الأمن والتحقيقات,6,1,0,0,7
4992,2022,1,Hail Region Office,أنشطة الاستخدام,12,3,0,0,15
4994,2022,1,Hail Region Office,أنشطة البرمجة الحاسوبية والخبرة الاستشارية وما يتصل بها من أنشطة,5,4,0,0,9
4996,2022,1,Hail Region Office,أنشطة التشييد المتخصصة,1253,170,2,0,1425
4997,2022,1,Hail Region Office,أنشطة الخدمات الشخصية الأخرى,810,70,1,0,881
4998,2022,1,Hail Region Office,أنشطة الخدمات المالية ، فيما عدا تمويل التأمين وصناديق المعاشات,24,3,0,0,27
4999,2022,1,Hail Region Office,أنشطة العمل الاجتماعي، دون إقامة، لكبار السن وذوي الإعاقة,44,18,0,0,62
5000,2022,1,Hail Region Office,أنشطة المعمارية والهندسية ، والاختبارات الفنية والتحليل,73,18,1,0,92
5001,2022,1,Hail Region Office,أنشطة المكاتب الرئيسية ، وألأنشطة الاستشارية في مجال الإدارة,22,2,0,0,24
5003,2022,1,Hail Region Office,أنشطة المنظمات ذات العضوية,29,4,0,0,33
5004,2022,1,Hail Region Office,أنشطة النشر,38,1,0,0,39
5005,2022,1,Hail Region Office,أنشطة تقديم الخدمات للمباني وتجميل المواقع,365,53,8,1,427
5006,2022,1,Hail Region Office,أنشطة جمع النفايات ومعالجتها وتصريفها ، واسترجاع المواد,2,1,0,0,3
5007,2022,1,Hail Region Office,أنشطة خدمات الأطعمة والمشروبات,1834,292,19,1,2146
5008,2022,1,Hail Region Office,أنشطة خدمات المعلومات,8,1,0,0,9
5010,2022,1,Hail Region Office,أنشطة زراعة المحاصيل والإنتاج الحيواني والصيد والخدمات المتصلة,1488,56,6,1,1551
5011,2022,1,Hail Region Office,الإدارة العامة والدفاع ؛ والضمان الاجتماعي الإلزامي,16,7,0,0,23
5012,2022,1,Hail Region Office,الإقامة,75,20,1,0,96
5014,2022,1,Hail Region Office,الأنشطة الأخرى للتعدين واستغلال المحاجر,31,4,0,0,35
5015,2022,1,Hail Region Office,الأنشطة الإدارية للمكاتب ، وأنشطة الدعم للمكاتب وغير ذلك من أنشطة الدعم للأعمال,67,4,0,0,71
5016,2022,1,Hail Region Office,الأنشطة الإيجارية,918,41,0,0,959
5017,2022,1,Hail Region Office,الأنشطة البيطرية,4,0,0,0,4
5018,2022,1,Hail Region Office,الأنشطة الرياضية وأنشطة التسلية والترفيه,51,19,0,0,70
5019,2022,1,Hail Region Office,الأنشطة العقارية,75,7,0,0,82
5020,2022,1,Hail Region Office,الأنشطة القانونية وأنشطة المحاسبة,10,3,0,0,13
5021,2022,1,Hail Region Office,الأنشطة المهنية والعلمية والتقنية الأخرى,17,0,1,0,18
5022,2022,1,Hail Region Office,الاتصالات,28,2,0,0,30
5023,2022,1,Hail Region Office,التخزين وأنشطة الدعم للنقل,66,17,0,0,83
5024,2022,1,Hail Region Office,التعليم,31,28,4,0,63
5027,2022,1,Hail Region Office,الصحة البشرية,43,62,16,2,123
5029,2022,1,Hail Region Office,الصناعة التحويلية الأخرى,11,2,0,0,13
5030,2022,1,Hail Region Office,الطباعة واستنساخ وسائط الأعلام المسجّلة,41,7,0,0,48
5031,2022,1,Hail Region Office,النقل البري و النقل عبر الأنابيب,567,36,2,0,605
5032,2022,1,Hail Region Office,النقل الجوي,22,5,0,0,27
5034,2022,1,Hail Region Office,الهندسة المدنية,16,8,3,0,27
5035,2022,1,Hail Region Office,تجارة التجزئة، باستثناء المركبات ذات المحركات والدراجات النارية,1836,291,14,0,2141
5036,2022,1,Hail Region Office,تجارة الجملة ، باستثناء المركبات ذات المحركات والدراجات النارية,502,100,9,2,613
5037,2022,1,Hail Region Office,تجارة الجملة والتجزئة ، وإصلاح المركبات ذات المحركات والدراجات النارية,848,159,2,0,1009
5038,2022,1,Hail Region Office,تجميع المياه ومعالجتها وتوصيلها,20,2,1,0,23
5039,2022,1,Hail Region Office,تشييد المباني,2972,560,56,8,3596
5040,2022,1,Hail Region Office,تعدين الفحم والليغنيت,4,0,0,0,4
5042,2022,1,Hail Region Office,توصيل الكهرباء والغاز والبخار وتكييف الهواء,14,5,2,0,21
5043,2022,1,Hail Region Office,صناعة الآلات والمعدات غير المصنفة في موضع أخر,24,3,0,0,27
5044,2022,1,Hail Region Office,صناعة المركبات ذات المحركات والمركبات المقطورة ونصف المقطورة,38,2,0,0,40
5045,2022,1,Hail Region Office,صناعة معدات النقل الأخرى,8,0,0,0,8
5046,2022,1,Hail Region Office,صنع الأثاث,143,20,0,0,163
5047,2022,1,Hail Region Office,صنع الحواسيب والمنتجات الإلكترونية والبصرية,37,4,0,0,41
5048,2022,1,Hail Region Office,صُنع الخشب ومنتجات الخشب والفلين ، باستثناء الأثاث ، صُنع أصناف من القش ومواد الضفر,64,10,1,0,75
5049,2022,1,Hail Region Office,صنع الفلزات القاعدية,89,27,2,0,118
5050,2022,1,Hail Region Office,صُنع المشروبات,8,7,0,0,15
5051,2022,1,Hail Region Office,صنع المعدات الكهربائية,48,3,0,0,51
5052,2022,1,Hail Region Office,صُنع الملبوسات,342,33,0,0,375
5055,2022,1,Hail Region Office,صُنع المنتجات الغذائية,226,36,7,0,269
5056,2022,1,Hail Region Office,صُنع المنسوجات,57,19,0,0,76
5057,2022,1,Hail Region Office,صُنع المواد الكيميائية والمنتجات الكيميائية,102,30,0,0,132
5060,2022,1,Hail Region Office,صنع منتجات المعادن اللافلزية الأخرى,113,41,9,1,164
5061,2022,1,Hail Region Office,صنع منتجات المعادن المشكلة ( باستثناء الآلات والمعدات ),133,33,1,0,167
5062,2022,1,Hail Region Office,صيد الأسماك وتربية المائيات,141,0,0,0,141
5063,2022,1,Hail Region Office,وكالات السفر ومشغّلو الجولات السياحية وخدمات الحجز والأنشطة المتصلة بها,9,3,0,0,12
5064,2022,1,Asir Region Office,أبحاث الإعلان والسوق,54,4,0,0,58
5065,2022,1,Asir Region Office,إصلاح أجهزة الحاسوب والسلع الشخصية والمنزلية,260,25,1,0,286
5066,2022,1,Asir Region Office,إصلاح وتركيب الآلات والمعدات,76,5,1,0,82
5067,2022,1,Asir Region Office,أنشطة أنتاج الأفلام والبرامج التلفزيونية والتسجيلات الصوتية و نشرالموسيقى,15,0,0,0,15
5068,2022,1,Asir Region Office,أنشطة الأمن والتحقيقات,10,5,2,1,18
5069,2022,1,Asir Region Office,أنشطة الاستخدام,49,8,0,1,58
5070,2022,1,Asir Region Office,أنشطة البرمجة الحاسوبية والخبرة الاستشارية وما يتصل بها من أنشطة,19,6,0,0,25
5071,2022,1,Asir Region Office,أنشطة البرمجة والإذاعة,8,3,0,0,11
5073,2022,1,Asir Region Office,أنشطة التشييد المتخصصة,2014,262,9,1,2286
5074,2022,1,Asir Region Office,أنشطة الخدمات الشخصية الأخرى,1352,115,2,2,1471
5076,2022,1,Asir Region Office,أنشطة العمل الاجتماعي، دون إقامة، لكبار السن وذوي الإعاقة,51,41,5,0,97
5077,2022,1,Asir Region Office,أنشطة المعمارية والهندسية ، والاختبارات الفنية والتحليل,139,47,4,0,190
5078,2022,1,Asir Region Office,أنشطة المكاتب الرئيسية ، وألأنشطة الاستشارية في مجال الإدارة,26,2,1,0,29
5079,2022,1,Asir Region Office,أنشطة المكتبات ودور المحفوظات، والمتاحف والأنشطة الثقافية الأخرى,33,17,1,0,51
5080,2022,1,Asir Region Office,أنشطة المنظمات ذات العضوية,25,5,0,0,30
5081,2022,1,Asir Region Office,أنشطة النشر,19,1,1,0,21
5082,2022,1,Asir Region Office,أنشطة تقديم الخدمات للمباني وتجميل المواقع,444,70,6,2,522
5083,2022,1,Asir Region Office,أنشطة جمع النفايات ومعالجتها وتصريفها ، واسترجاع المواد,6,2,0,0,8
5084,2022,1,Asir Region Office,أنشطة خدمات الأطعمة والمشروبات,4231,920,57,4,5212
5085,2022,1,Asir Region Office,أنشطة خدمات المعلومات,18,3,0,0,21
5086,2022,1,Asir Region Office,أنشطة خدمات دعم التعدين,24,5,1,0,30
5087,2022,1,Asir Region Office,أنشطة زراعة المحاصيل والإنتاج الحيواني والصيد والخدمات المتصلة,1370,37,2,0,1409
5088,2022,1,Asir Region Office,الإدارة العامة والدفاع ؛ والضمان الاجتماعي الإلزامي,11,13,1,0,25
5089,2022,1,Asir Region Office,الإقامة,268,81,5,1,355
5091,2022,1,Asir Region Office,الأنشطة الأخرى للتعدين واستغلال المحاجر,24,6,0,0,30
5092,2022,1,Asir Region Office,الأنشطة الإدارية للمكاتب ، وأنشطة الدعم للمكاتب وغير ذلك من أنشطة الدعم للأعمال,123,8,1,1,133
5093,2022,1,Asir Region Office,الأنشطة الإيجارية,1118,77,2,1,1198
5094,2022,1,Asir Region Office,الأنشطة البيطرية,12,6,2,0,20
5095,2022,1,Asir Region Office,الأنشطة الرياضية وأنشطة التسلية والترفيه,93,33,0,0,126
5096,2022,1,Asir Region Office,الأنشطة العقارية,117,19,1,0,137
5097,2022,1,Asir Region Office,الأنشطة القانونية وأنشطة المحاسبة,28,5,0,0,33
5098,2022,1,Asir Region Office,الأنشطة المساعدة لأنشطة الخدمات المالية وأنشطة التأمين,4,0,0,0,4
5099,2022,1,Asir Region Office,الأنشطة المهنية والعلمية والتقنية الأخرى,33,4,2,0,39
5101,2022,1,Asir Region Office,الاتصالات,25,2,0,0,27
5102,2022,1,Asir Region Office,التخزين وأنشطة الدعم للنقل,96,29,3,0,128
5103,2022,1,Asir Region Office,التعليم,38,44,11,1,94
5105,2022,1,Asir Region Office,الصحة البشرية,80,102,39,5,226
5107,2022,1,Asir Region Office,الصناعة التحويلية الأخرى,28,10,1,0,39
5108,2022,1,Asir Region Office,الطباعة واستنساخ وسائط الأعلام المسجّلة,32,13,2,0,47
5109,2022,1,Asir Region Office,النقل البري و النقل عبر الأنابيب,1298,155,9,2,1464
5111,2022,1,Asir Region Office,النقل المائي,12,0,0,0,12
5112,2022,1,Asir Region Office,الهندسة المدنية,43,10,2,0,55
5113,2022,1,Asir Region Office,تجارة التجزئة، باستثناء المركبات ذات المحركات والدراجات النارية,4284,728,42,5,5059
5114,2022,1,Asir Region Office,تجارة الجملة ، باستثناء المركبات ذات المحركات والدراجات النارية,1158,254,18,3,1433
5115,2022,1,Asir Region Office,تجارة الجملة والتجزئة ، وإصلاح المركبات ذات المحركات والدراجات النارية,1936,369,12,0,2317
5116,2022,1,Asir Region Office,تجميع المياه ومعالجتها وتوصيلها,109,25,0,0,134
5117,2022,1,Asir Region Office,تشييد المباني,6183,1312,107,14,7616
5118,2022,1,Asir Region Office,تعدين الفحم والليغنيت,1,0,0,0,1
5119,2022,1,Asir Region Office,تعدين ركازات الفلزات,87,16,0,0,103
5120,2022,1,Asir Region Office,تمويل التأمين وإعادة التأمين وصناديق المعاشات التقاعدية باستثناء الضمان الاجتماعي الإلزامي,1,2,1,0,4
5121,2022,1,Asir Region Office,توصيل الكهرباء والغاز والبخار وتكييف الهواء,8,8,2,1,19
5122,2022,1,Asir Region Office,صناعة الآلات والمعدات غير المصنفة في موضع أخر,42,5,0,0,47
5123,2022,1,Asir Region Office,صناعة المركبات ذات المحركات والمركبات المقطورة ونصف المقطورة,39,4,1,0,44
5124,2022,1,Asir Region Office,صناعة معدات النقل الأخرى,10,0,0,0,10
5125,2022,1,Asir Region Office,صنع الأثاث,279,30,0,0,309
5126,2022,1,Asir Region Office,صنع الحواسيب والمنتجات الإلكترونية والبصرية,71,20,0,0,91
5127,2022,1,Asir Region Office,صُنع الخشب ومنتجات الخشب والفلين ، باستثناء الأثاث ، صُنع أصناف من القش ومواد الضفر,272,56,1,0,329
5128,2022,1,Asir Region Office,صنع الفلزات القاعدية,113,30,0,0,143
5129,2022,1,Asir Region Office,صُنع المشروبات,26,8,1,0,35
5130,2022,1,Asir Region Office,صنع المعدات الكهربائية,52,8,0,0,60
5131,2022,1,Asir Region Office,صُنع الملبوسات,611,58,1,0,670
5132,2022,1,Asir Region Office,صُنع المنتجات الجلدية والمنتجات ذات الصلة,11,3,0,0,14
5133,2022,1,Asir Region Office,صنع المنتجات الصيدلانية الأساسية والمستحضرات الصيدلانية,3,1,0,0,4
5134,2022,1,Asir Region Office,صُنع المنتجات الغذائية,367,106,12,1,486
5135,2022,1,Asir Region Office,صُنع المنسوجات,42,11,2,0,55
5136,2022,1,Asir Region Office,صُنع المواد الكيميائية والمنتجات الكيميائية,52,21,5,0,78
5137,2022,1,Asir Region Office,صُنع الورق ومنتجات الورق,10,5,1,0,16
5140,2022,1,Asir Region Office,صنع منتجات المطاط واللدائن,33,13,2,1,49
5141,2022,1,Asir Region Office,صنع منتجات المعادن اللافلزية الأخرى,182,97,20,2,301
5142,2022,1,Asir Region Office,صنع منتجات المعادن المشكلة ( باستثناء الآلات والمعدات ),417,33,4,0,454
5143,2022,1,Asir Region Office,صيد الأسماك وتربية المائيات,107,15,0,0,122
5144,2022,1,Asir Region Office,وكالات السفر ومشغّلو الجولات السياحية وخدمات الحجز والأنشطة المتصلة بها,22,5,0,0,27
5145,2022,1,Makkah / Jeddah Region Office,أبحاث الإعلان والسوق,293,54,2,0,349
5146,2022,1,Makkah / Jeddah Region Office,إصلاح أجهزة الحاسوب والسلع الشخصية والمنزلية,573,89,7,1,670
5147,2022,1,Makkah / Jeddah Region Office,إصلاح وتركيب الآلات والمعدات,272,61,13,1,347
5148,2022,1,Makkah / Jeddah Region Office,أنشطة أنتاج الأفلام والبرامج التلفزيونية والتسجيلات الصوتية و نشرالموسيقى,101,20,0,0,121
5149,2022,1,Makkah / Jeddah Region Office,أنشطة الأمن والتحقيقات,40,22,9,2,73
5150,2022,1,Makkah / Jeddah Region Office,أنشطة الاستخدام,156,29,7,3,195
5152,2022,1,Makkah / Jeddah Region Office,أنشطة البرمجة الحاسوبية والخبرة الاستشارية وما يتصل بها من أنشطة,350,127,11,3,491
5154,2022,1,Makkah / Jeddah Region Office,أنشطة البريد ونقل الرسائل والطرود بواسطة مندوبين,30,4,0,0,34
5155,2022,1,Makkah / Jeddah Region Office,أنشطة التشييد المتخصصة,5943,1697,145,23,7808
5156,2022,1,Makkah / Jeddah Region Office,أنشطة الخدمات الشخصية الأخرى,3420,536,30,6,3992
5157,2022,1,Makkah / Jeddah Region Office,أنشطة الخدمات المالية ، فيما عدا تمويل التأمين وصناديق المعاشات,103,34,6,2,145
5158,2022,1,Makkah / Jeddah Region Office,أنشطة العمل الاجتماعي، دون إقامة، لكبار السن وذوي الإعاقة,146,134,13,0,293
5159,2022,1,Makkah / Jeddah Region Office,أنشطة المعالجة وخدمات إدارة النفايات الأخرى,2,4,0,0,6
5160,2022,1,Makkah / Jeddah Region Office,أنشطة المعمارية والهندسية ، والاختبارات الفنية والتحليل,431,233,20,7,691
5161,2022,1,Makkah / Jeddah Region Office,أنشطة المكاتب الرئيسية ، وألأنشطة الاستشارية في مجال الإدارة,363,167,2,0,532
5162,2022,1,Makkah / Jeddah Region Office,أنشطة المكتبات ودور المحفوظات، والمتاحف والأنشطة الثقافية الأخرى,62,45,1,2,110
5164,2022,1,Makkah / Jeddah Region Office,أنشطة المنظمات ذات العضوية,35,15,0,0,50
5165,2022,1,Makkah / Jeddah Region Office,أنشطة النشر,91,21,4,0,116
5166,2022,1,Makkah / Jeddah Region Office,أنشطة تقديم الخدمات للمباني وتجميل المواقع,1948,843,97,33,2921
5167,2022,1,Makkah / Jeddah Region Office,أنشطة جمع النفايات ومعالجتها وتصريفها ، واسترجاع المواد,39,8,2,0,49
5168,2022,1,Makkah / Jeddah Region Office,أنشطة خدمات الأطعمة والمشروبات,6987,2080,241,30,9338
5169,2022,1,Makkah / Jeddah Region Office,أنشطة خدمات المعلومات,125,37,4,0,166
5170,2022,1,Makkah / Jeddah Region Office,أنشطة خدمات دعم التعدين,41,23,5,4,73
5171,2022,1,Makkah / Jeddah Region Office,أنشطة زراعة المحاصيل والإنتاج الحيواني والصيد والخدمات المتصلة,634,95,6,2,737
5172,2022,1,Makkah / Jeddah Region Office,استخراج النفط الخام والغاز الطبيعي,2,1,0,0,3
5173,2022,1,Makkah / Jeddah Region Office,الإدارة العامة والدفاع ؛ والضمان الاجتماعي الإلزامي,279,148,16,2,445
5174,2022,1,Makkah / Jeddah Region Office,الإقامة,418,312,36,7,773
5175,2022,1,Makkah / Jeddah Region Office,الأنشطة الإبداعية والفنون وأنشطة الترفيه,63,13,1,0,77
5176,2022,1,Makkah / Jeddah Region Office,الأنشطة الأخرى للتعدين واستغلال المحاجر,55,20,4,1,80
5177,2022,1,Makkah / Jeddah Region Office,الأنشطة الإدارية للمكاتب ، وأنشطة الدعم للمكاتب وغير ذلك من أنشطة الدعم للأعمال,614,66,11,0,691
5178,2022,1,Makkah / Jeddah Region Office,الأنشطة الإيجارية,1228,143,15,2,1388
5179,2022,1,Makkah / Jeddah Region Office,الأنشطة البيطرية,26,15,4,0,45
5180,2022,1,Makkah / Jeddah Region Office,الأنشطة الرياضية وأنشطة التسلية والترفيه,305,103,11,1,420
5181,2022,1,Makkah / Jeddah Region Office,الأنشطة العقارية,720,216,32,1,969
5182,2022,1,Makkah / Jeddah Region Office,الأنشطة القانونية وأنشطة المحاسبة,294,103,7,1,405
5183,2022,1,Makkah / Jeddah Region Office,الأنشطة المساعدة لأنشطة الخدمات المالية وأنشطة التأمين,23,19,7,0,49
5184,2022,1,Makkah / Jeddah Region Office,الأنشطة المهنية والعلمية والتقنية الأخرى,217,31,3,0,251
5186,2022,1,Makkah / Jeddah Region Office,الاتصالات,143,48,4,0,195
5188,2022,1,Makkah / Jeddah Region Office,التخزين وأنشطة الدعم للنقل,463,207,41,12,723
5189,2022,1,Makkah / Jeddah Region Office,التعليم,255,270,87,15,627
5192,2022,1,Makkah / Jeddah Region Office,الصحة البشرية,275,377,129,31,812
5193,2022,1,Makkah / Jeddah Region Office,الصرف الصحي,18,13,3,1,35
5194,2022,1,Makkah / Jeddah Region Office,الصناعة التحويلية الأخرى,105,80,11,3,199
5195,2022,1,Makkah / Jeddah Region Office,الطباعة واستنساخ وسائط الأعلام المسجّلة,212,130,23,2,367
5196,2022,1,Makkah / Jeddah Region Office,النقل البري و النقل عبر الأنابيب,1475,418,62,13,1968
5197,2022,1,Makkah / Jeddah Region Office,النقل الجوي,50,48,17,10,125
5198,2022,1,Makkah / Jeddah Region Office,النقل المائي,74,38,9,4,125
5199,2022,1,Makkah / Jeddah Region Office,الهندسة المدنية,105,46,17,1,169
5200,2022,1,Makkah / Jeddah Region Office,تجارة التجزئة، باستثناء المركبات ذات المحركات والدراجات النارية,12133,3225,276,68,15702
5201,2022,1,Makkah / Jeddah Region Office,تجارة الجملة ، باستثناء المركبات ذات المحركات والدراجات النارية,9266,4501,462,88,14317
5202,2022,1,Makkah / Jeddah Region Office,تجارة الجملة والتجزئة ، وإصلاح المركبات ذات المحركات والدراجات النارية,3586,856,59,19,4520
5203,2022,1,Makkah / Jeddah Region Office,تجميع المياه ومعالجتها وتوصيلها,61,28,2,3,94
5204,2022,1,Makkah / Jeddah Region Office,تشييد المباني,8791,3213,405,103,12512
5205,2022,1,Makkah / Jeddah Region Office,تعدين الفحم والليغنيت,7,3,0,0,10
5206,2022,1,Makkah / Jeddah Region Office,تعدين ركازات الفلزات,34,15,6,3,58
5207,2022,1,Makkah / Jeddah Region Office,تمويل التأمين وإعادة التأمين وصناديق المعاشات التقاعدية باستثناء الضمان الاجتماعي الإلزامي,8,27,10,3,48
5208,2022,1,Makkah / Jeddah Region Office,توصيل الكهرباء والغاز والبخار وتكييف الهواء,52,29,11,7,99
5209,2022,1,Makkah / Jeddah Region Office,صناعة الآلات والمعدات غير المصنفة في موضع أخر,71,22,6,1,100
5210,2022,1,Makkah / Jeddah Region Office,صناعة المركبات ذات المحركات والمركبات المقطورة ونصف المقطورة,74,29,7,0,110
5211,2022,1,Makkah / Jeddah Region Office,صناعة معدات النقل الأخرى,62,20,2,2,86
5212,2022,1,Makkah / Jeddah Region Office,صنع الأثاث,260,106,22,2,390
5213,2022,1,Makkah / Jeddah Region Office,صنع الحواسيب والمنتجات الإلكترونية والبصرية,126,69,15,2,212
5214,2022,1,Makkah / Jeddah Region Office,صُنع الخشب ومنتجات الخشب والفلين ، باستثناء الأثاث ، صُنع أصناف من القش ومواد الضفر,281,70,17,2,370
5215,2022,1,Makkah / Jeddah Region Office,صنع الفلزات القاعدية,100,111,38,7,256
5216,2022,1,Makkah / Jeddah Region Office,صُنع المشروبات,70,40,14,5,129
5217,2022,1,Makkah / Jeddah Region Office,صنع المعدات الكهربائية,154,71,11,2,238
5218,2022,1,Makkah / Jeddah Region Office,صُنع الملبوسات,1112,183,10,2,1307
5219,2022,1,Makkah / Jeddah Region Office,صُنع المنتجات الجلدية والمنتجات ذات الصلة,17,11,1,0,29
5220,2022,1,Makkah / Jeddah Region Office,صنع المنتجات الصيدلانية الأساسية والمستحضرات الصيدلانية,11,11,7,1,30
5221,2022,1,Makkah / Jeddah Region Office,صُنع المنتجات الغذائية,751,411,62,24,1248
5222,2022,1,Makkah / Jeddah Region Office,صُنع المنسوجات,86,40,15,2,143
5223,2022,1,Makkah / Jeddah Region Office,صُنع المواد الكيميائية والمنتجات الكيميائية,229,143,39,4,415
5224,2022,1,Makkah / Jeddah Region Office,صُنع الورق ومنتجات الورق,46,48,11,5,110
5225,2022,1,Makkah / Jeddah Region Office,صنع فحم الكوك والمنتجات النفطية المكررة,13,14,3,0,30
5227,2022,1,Makkah / Jeddah Region Office,صنع منتجات المطاط واللدائن,97,109,48,9,263
5228,2022,1,Makkah / Jeddah Region Office,صنع منتجات المعادن اللافلزية الأخرى,188,107,31,13,339
5229,2022,1,Makkah / Jeddah Region Office,صنع منتجات المعادن المشكلة ( باستثناء الآلات والمعدات ),334,132,44,7,517
5230,2022,1,Makkah / Jeddah Region Office,صيد الأسماك وتربية المائيات,341,54,0,0,395
5231,2022,1,Makkah / Jeddah Region Office,وكالات السفر ومشغّلو الجولات السياحية وخدمات الحجز والأنشطة المتصلة بها,188,89,8,0,285
5232,2022,1,Najran Region Office,أبحاث الإعلان والسوق,13,0,0,0,13
5233,2022,1,Najran Region Office,إصلاح أجهزة الحاسوب والسلع الشخصية والمنزلية,76,5,0,0,81
5234,2022,1,Najran Region Office,إصلاح وتركيب الآلات والمعدات,46,4,0,1,51
5235,2022,1,Najran Region Office,أنشطة أنتاج الأفلام والبرامج التلفزيونية والتسجيلات الصوتية و نشرالموسيقى,3,0,0,0,3
5237,2022,1,Najran Region Office,أنشطة الاستخدام,21,3,0,0,24
5238,2022,1,Najran Region Office,أنشطة الاسر المعيشية التي تستخدم أفراداً للعمل المنزلي,4,0,0,0,4
5239,2022,1,Najran Region Office,أنشطة البرمجة الحاسوبية والخبرة الاستشارية وما يتصل بها من أنشطة,4,1,0,0,5
5241,2022,1,Najran Region Office,أنشطة التشييد المتخصصة,1473,228,11,5,1717
5242,2022,1,Najran Region Office,أنشطة الخدمات الشخصية الأخرى,565,35,0,0,600
5244,2022,1,Najran Region Office,أنشطة العمل الاجتماعي، دون إقامة، لكبار السن وذوي الإعاقة,23,5,0,0,28
5246,2022,1,Najran Region Office,أنشطة المعمارية والهندسية ، والاختبارات الفنية والتحليل,53,18,2,0,73
5247,2022,1,Najran Region Office,أنشطة المكاتب الرئيسية ، وألأنشطة الاستشارية في مجال الإدارة,15,1,0,0,16
5248,2022,1,Najran Region Office,أنشطة المكتبات ودور المحفوظات، والمتاحف والأنشطة الثقافية الأخرى,24,1,0,0,25
5251,2022,1,Najran Region Office,أنشطة النشر,15,5,0,0,20
5252,2022,1,Najran Region Office,أنشطة تقديم الخدمات للمباني وتجميل المواقع,189,32,4,4,229
5253,2022,1,Najran Region Office,أنشطة جمع النفايات ومعالجتها وتصريفها ، واسترجاع المواد,5,0,0,0,5
5254,2022,1,Najran Region Office,أنشطة خدمات الأطعمة والمشروبات,1367,235,15,1,1618
5257,2022,1,Najran Region Office,أنشطة زراعة المحاصيل والإنتاج الحيواني والصيد والخدمات المتصلة,1008,23,3,0,1034
5258,2022,1,Najran Region Office,استخراج النفط الخام والغاز الطبيعي,2,1,0,0,3
5259,2022,1,Najran Region Office,الإدارة العامة والدفاع ؛ والضمان الاجتماعي الإلزامي,54,16,0,0,70
5260,2022,1,Najran Region Office,الإقامة,86,20,2,0,108
5261,2022,1,Najran Region Office,الأنشطة الإبداعية والفنون وأنشطة الترفيه,4,0,0,0,4
5262,2022,1,Najran Region Office,الأنشطة الأخرى للتعدين واستغلال المحاجر,8,0,1,0,9
5263,2022,1,Najran Region Office,الأنشطة الإدارية للمكاتب ، وأنشطة الدعم للمكاتب وغير ذلك من أنشطة الدعم للأعمال,47,1,0,0,48
5264,2022,1,Najran Region Office,الأنشطة الإيجارية,1388,68,1,1,1458
5266,2022,1,Najran Region Office,الأنشطة الرياضية وأنشطة التسلية والترفيه,33,10,0,1,44
5270,2022,1,Najran Region Office,الأنشطة المهنية والعلمية والتقنية الأخرى,24,0,0,0,24
5272,2022,1,Najran Region Office,البحث والتطوير في المجال العلمي,1,0,0,0,1
5273,2022,1,Najran Region Office,التخزين وأنشطة الدعم للنقل,247,65,1,0,313
5274,2022,1,Najran Region Office,التعليم,17,16,6,0,39
5276,2022,1,Najran Region Office,الصحة البشرية,20,54,11,1,86
5278,2022,1,Najran Region Office,الطباعة واستنساخ وسائط الأعلام المسجّلة,8,2,0,0,10
5279,2022,1,Najran Region Office,النقل البري و النقل عبر الأنابيب,871,80,2,1,954
5280,2022,1,Najran Region Office,النقل الجوي,5,3,0,0,8
5281,2022,1,Najran Region Office,النقل المائي,11,0,0,0,11
5282,2022,1,Najran Region Office,الهندسة المدنية,16,4,3,3,26
5283,2022,1,Najran Region Office,تجارة التجزئة، باستثناء المركبات ذات المحركات والدراجات النارية,1701,365,18,2,2086
5284,2022,1,Najran Region Office,تجارة الجملة ، باستثناء المركبات ذات المحركات والدراجات النارية,503,90,10,1,604
5285,2022,1,Najran Region Office,تجارة الجملة والتجزئة ، وإصلاح المركبات ذات المحركات والدراجات النارية,607,106,3,0,716
5286,2022,1,Najran Region Office,تجميع المياه ومعالجتها وتوصيلها,20,4,0,0,24
5287,2022,1,Najran Region Office,تشييد المباني,2463,508,69,13,3053
5289,2022,1,Najran Region Office,تعدين ركازات الفلزات,11,0,1,0,12
5290,2022,1,Najran Region Office,تمويل التأمين وإعادة التأمين وصناديق المعاشات التقاعدية باستثناء الضمان الاجتماعي الإلزامي,2,0,0,0,2
5291,2022,1,Najran Region Office,توصيل الكهرباء والغاز والبخار وتكييف الهواء,4,1,1,0,6
5292,2022,1,Najran Region Office,صناعة الآلات والمعدات غير المصنفة في موضع أخر,14,2,0,0,16
5294,2022,1,Najran Region Office,صناعة معدات النقل الأخرى,12,1,0,0,13
5295,2022,1,Najran Region Office,صنع الأثاث,90,20,1,0,111
5296,2022,1,Najran Region Office,صنع الحواسيب والمنتجات الإلكترونية والبصرية,17,1,0,0,18
5297,2022,1,Najran Region Office,صُنع الخشب ومنتجات الخشب والفلين ، باستثناء الأثاث ، صُنع أصناف من القش ومواد الضفر,80,9,0,0,89
5298,2022,1,Najran Region Office,صنع الفلزات القاعدية,83,10,3,1,97
5299,2022,1,Najran Region Office,صُنع المشروبات,6,1,1,0,8
5300,2022,1,Najran Region Office,صنع المعدات الكهربائية,15,1,0,0,16
5301,2022,1,Najran Region Office,صُنع الملبوسات,319,24,0,0,343
5304,2022,1,Najran Region Office,صُنع المنتجات الغذائية,145,22,1,0,168
5305,2022,1,Najran Region Office,صُنع المنسوجات,38,5,0,0,43
5306,2022,1,Najran Region Office,صُنع المواد الكيميائية والمنتجات الكيميائية,22,4,1,0,27
5307,2022,1,Najran Region Office,صُنع الورق ومنتجات الورق,11,4,1,0,16
5309,2022,1,Najran Region Office,صنع منتجات المعادن اللافلزية الأخرى,66,31,9,1,107
5310,2022,1,Najran Region Office,صنع منتجات المعادن المشكلة ( باستثناء الآلات والمعدات ),175,14,4,0,193
5311,2022,1,Najran Region Office,صيد الأسماك وتربية المائيات,135,1,0,0,136
